"","chr","start","end","center","width"
"1","chr16",53434489,53435297,53434893,808
"2","chr3",37451927,37453047,37452487,1120
"3","chr3",172039703,172040934,172040318,1231
"4","chr1",90724932,90727247,90726089,2315
"5","chr8",42410918,42411241,42411079,323
"6","chr14",68874710,68875103,68874906,393
"7","chr16",28879633,28880547,28880090,914
"8","chr8",41308333,41309621,41308977,1288
"9","chr1",230425357,230426956,230426156,1599
"10","chr15",22838564,22839134,22838849,570
"11","chr9",137103394,137103596,137103495,202
"12","chr19",54189178,54191646,54190412,2468
"13","chr6",25278903,25279662,25279282,759
"14","chr3",129183291,129184135,129183713,844
"15","chr12",123601670,123602468,123602069,798
"16","chr2",23690438,23690699,23690568,261
"17","chr4",153683934,153684900,153684417,966
"18","chr15",59437871,59438539,59438205,668
"19","chr11",2699180,2700857,2700018,1677
"20","chr8",48977827,48978315,48978071,488
"21","chr1",5877097,5877332,5877214,235
"22","chr8",86069424,86069817,86069620,393
"23","chr3",15064785,15065464,15065124,679
"24","chr14",59919553,59920111,59919832,558
"25","chr16",3400716,3401667,3401191,951
"26","chr20",50343627,50343836,50343731,209
"27","chr1",166988983,166989446,166989214,463
"28","chr1",213989165,213989394,213989279,229
"29","chr1",43367143,43367402,43367272,259
"30","chr19",54207238,54207507,54207372,269
"31","chr1",50427796,50428073,50427934,277
"32","chr10",79067007,79070458,79068732,3451
"33","chr1",200042272,200042927,200042599,655
"34","chr1",170661315,170661656,170661485,341
"35","chr2",11343833,11345427,11344630,1594
"36","chr16",89700845,89702474,89701659,1629
"37","chr2",104842715,104845312,104844013,2597
"38","chr2",102736679,102736955,102736817,276
"39","chr12",11648919,11649619,11649269,700
"40","chr14",100708858,100709930,100709394,1072
"41","chr16",46972916,46974118,46973517,1202
"42","chr10",68231136,68231766,68231451,630
"43","chr18",62384636,62385037,62384836,401
"44","chr1",20633371,20634058,20633714,687
"45","chr19",39307146,39308610,39307878,1464
"46","chr21",29018943,29019437,29019190,494
"47","chr17",81702541,81703781,81703161,1240
"48","chr2",237371832,237372126,237371979,294
"49","chr8",19756620,19757796,19757208,1176
"50","chr8",143024258,143024462,143024360,204
"51","chr18",70205285,70206122,70205703,837
"52","chr16",30354885,30355440,30355162,555
"53","chr3",57756198,57757263,57756730,1065
"54","chr10",28668479,28669187,28668833,708
"55","chr8",119416158,119416938,119416548,780
"56","chr2",218033767,218034112,218033939,345
"57","chr4",2261233,2262942,2262087,1709
"58","chr7",128104142,128104502,128104322,360
"59","chr3",52897210,52897824,52897517,614
"60","chr1",1332055,1333606,1332830,1551
"61","chr16",31427570,31428361,31427965,791
"62","chr1",153535948,153536364,153536156,416
"63","chr12",56188924,56189898,56189411,974
"64","chr1",169427383,169427631,169427507,248
"65","chr17",59707393,59707747,59707570,354
"66","chr16",89934863,89935848,89935355,985
"67","chr1",223394339,223394644,223394491,305
"68","chr17",78476214,78476451,78476332,237
"69","chr1",57422291,57424965,57423628,2674
"70","chr1",44029957,44031353,44030655,1396
"71","chr6",31541891,31542119,31542005,228
"72","chr3",197554734,197556257,197555495,1523
"73","chr4",1711540,1713253,1712396,1713
"74","chr3",14124217,14125499,14124858,1282
"75","chr6",145815189,145815428,145815308,239
"76","chr1",8702946,8703521,8703233,575
"77","chr1",151346850,151347069,151346959,219
"78","chr1",201399133,201399904,201399518,771
"79","chr12",113462945,113468637,113465791,5692
"80","chr19",30224642,30224846,30224744,204
"81","chr1",10793837,10796907,10795372,3070
"82","chr1",10697834,10698195,10698014,361
"83","chr3",149812506,149813447,149812976,941
"84","chr1",12540321,12540530,12540425,209
"85","chr17",50840427,50840961,50840694,534
"86","chr10",4825933,4826605,4826269,672
"87","chr17",64505361,64507448,64506404,2087
"88","chr19",17226097,17227059,17226578,962
"89","chr1",44617067,44617613,44617340,546
"90","chr16",2842578,2842809,2842693,231
"91","chr3",108589380,108589757,108589568,377
"92","*",NA,NA,NA,NA
"93","chr7",16399497,16399700,16399598,203
"94","chr16",66552365,66552816,66552590,451
"95","chr6",81751416,81754088,81752752,2672
"96","chr3",36944049,36945550,36944799,1501
"97","chr19",39406601,39408302,39407451,1701
"98","chr2",236120204,236120477,236120340,273
"99","chr4",10018857,10019402,10019129,545
"100","chr17",76671742,76672008,76671875,266
"101","chr10",98268108,98268751,98268429,643
"102","chr22",12097884,12098371,12098127,487
"103","chr22",21045690,21045981,21045835,291
"104","chr2",38750393,38751542,38750967,1149
"105","chr1",16680247,16680656,16680451,409
"106","chr12",132035780,132036402,132036091,622
"107","chr1",34163182,34165375,34164278,2193
"108","chr17",7572598,7574012,7573305,1414
"109","chr9",137788668,137789322,137788995,654
"110","chr21",43982603,43982961,43982782,358
"111","chr6",31158308,31158784,31158546,476
"112","chr6",133952079,133953706,133952892,1627
"113","chr1",15975407,15976177,15975792,770
"114","chr2",105398421,105399427,105398924,1006
"115","chr6",71584669,71585285,71584977,616
"116","chr12",76348129,76348506,76348317,377
"117","chr22",46122574,46122849,46122711,275
"118","chr6",160991345,160992532,160991938,1187
"119","chr4",177442085,177442554,177442319,469
"120","chr3",111071302,111072554,111071928,1252
"121","chr16",75114500,75114966,75114733,466
"122","chr14",68792895,68796183,68794539,3288
"123","chr6",146598898,146599109,146599003,211
"124","chr12",111418092,111418946,111418519,854
"125","chr8",17413094,17413611,17413352,517
"126","chr16",56657777,56658122,56657949,345
"127","chr6",127118120,127118451,127118285,331
"128","chr16",89305573,89307106,89306339,1533
"129","chr6",46687525,46689001,46688263,1476
"130","chr16",69965134,69965874,69965504,740
"131","chr19",35021685,35021905,35021795,220
"132","chr16",3234639,3235558,3235098,919
"133","chr18",63422029,63423124,63422576,1095
"134","chr4",3463072,3463713,3463392,641
"135","chr16",30697953,30699089,30698521,1136
"136","chr16",2519558,2521070,2520314,1512
"137","chr17",18118861,18121554,18120207,2693
"138","chr12",132433158,132433387,132433272,229
"139","chr6",169751255,169752035,169751645,780
"140","chrX",68840335,68840715,68840525,380
"141","chr11",47589586,47590875,47590230,1289
"142","chr8",144125640,144126097,144125868,457
"143","chr13",23466328,23466881,23466604,553
"144","chr4",74444969,74445423,74445196,454
"145","chr2",176164685,176165509,176165097,824
"146","chr2",236163150,236170119,236166634,6969
"147","chr10",110304379,110305101,110304740,722
"148","chr14",66507651,66509517,66508584,1866
"149","chr10",123147767,123151519,123149643,3752
"150","chr16",72093230,72093442,72093336,212
"151","chr12",52069564,52070418,52069991,854
"152","chr1",154501631,154503223,154502427,1592
"153","chr2",26503321,26503842,26503581,521
"154","chr1",160343138,160343548,160343343,410
"155","chr7",149126122,149127136,149126629,1014
"156","chr4",147731697,147732767,147732232,1070
"157","chr1",154182792,154183450,154183121,658
"158","chr13",109869632,109869919,109869775,287
"159","chrX",104566869,104567362,104567115,493
"160","chr15",89496233,89496753,89496493,520
"161","chr7",23597116,23597938,23597527,822
"162","chr4",1766836,1767709,1767272,873
"163","chr13",29503108,29503353,29503230,245
"164","chr1",33276173,33276780,33276476,607
"165","chr9",122213474,122214413,122213943,939
"166","chr8",66428561,66429876,66429218,1315
"167","chr17",21513029,21513243,21513136,214
"168","chr1",43530758,43531829,43531293,1071
"169","chr14",105314002,105315690,105314846,1688
"170","chr4",164956884,164957294,164957089,410
"171","chr19",2944684,2945509,2945096,825
"172","chr14",24051780,24052635,24052207,855
"173","chr19",4047756,4048430,4048093,674
"174","chr19",13255108,13255344,13255226,236
"175","chr6",99349332,99350070,99349701,738
"176","chr2",239527380,239528070,239527725,690
"177","chr19",7519439,7520395,7519917,956
"178","chr14",103138202,103139085,103138643,883
"179","chr11",20601174,20601853,20601513,679
"180","chr8",37736316,37737185,37736750,869
"181","chr1",1908519,1909162,1908840,643
"182","chr1",205210835,205211782,205211308,947
"183","chr11",94128394,94129607,94129000,1213
"184","chr19",55644946,55645177,55645061,231
"185","chr1",153783481,153783859,153783670,378
"186","chr19",51949063,51949290,51949176,227
"187","chr1",179742812,179744816,179743814,2004
"188","chr2",231780603,231781795,231781199,1192
"189","chr16",50024956,50025512,50025234,556
"190","chr1",156845089,156846000,156845544,911
"191","chr12",98745608,98745991,98745799,383
"192","chr5",175773312,175773552,175773432,240
"193","chr14",93347137,93347765,93347451,628
"194","chr5",180352114,180354279,180353196,2165
"195","chr6",27865342,27865628,27865485,286
"196","chr13",60163526,60164151,60163838,625
"197","chr14",61695129,61696513,61695821,1384
"198","chr9",112332869,112334173,112333521,1304
"199","chr1",206909348,206909857,206909602,509
"200","chr3",43105616,43106221,43105918,605
"201","chr10",84328406,84329177,84328791,771
"202","chr8",1012315,1012747,1012531,432
"203","chr18",11980484,11982143,11981313,1659
"204","chr19",50517039,50519539,50518289,2500
"205","chr2",38535972,38536422,38536197,450
"206","chr1",53459518,53460555,53460036,1037
"207","chr4",3253230,3253448,3253339,218
"208","chr1",51878506,51879267,51878886,761
"209","chr19",2269116,2271365,2270240,2249
"210","chrX",72276850,72277377,72277113,527
"211","chrX",81003590,81003994,81003792,404
"212","chr1",45499914,45500377,45500145,463
"213","chr12",119690168,119690486,119690327,318
"214","chr2",131394576,131394867,131394721,291
"215","chr11",61516392,61516675,61516533,283
"216","chr11",61161088,61161790,61161439,702
"217","chr1",109113473,109113716,109113594,243
"218","chr20",19974892,19975390,19975141,498
"219","chr12",15911146,15911600,15911373,454
"220","chr1",50416212,50416431,50416321,219
"221","chr7",44112628,44112906,44112767,278
"222","chr14",22589015,22589453,22589234,438
"223","chr14",56117892,56119516,56118704,1624
"224","chr14",88824574,88825011,88824792,437
"225","chr2",117814536,117815051,117814793,515
"226","chr2",43831626,43832093,43831859,467
"227","chr4",185471420,185472030,185471725,610
"228","chr2",1167330,1168134,1167732,804
"229","chr16",62035217,62036730,62035973,1513
"230","chr2",201780664,201781432,201781048,768
"231","chr16",33516231,33517001,33516616,770
"232","chr1",1406728,1407555,1407141,827
"233","chr13",102845750,102846413,102846081,663
"234","chr1",65147358,65149215,65148286,1857
"235","chr13",110138181,110138659,110138420,478
"236","chr16",1104940,1105319,1105129,379
"237","chr21",46598629,46598878,46598753,249
"238","chr18",51196160,51198055,51197107,1895
"239","chr16",88662700,88664002,88663351,1302
"240","chr2",109128129,109130377,109129253,2248
"241","chr4",1623389,1623766,1623577,377
"242","chr10",97498183,97499763,97498973,1580
"243","chr8",144505007,144509987,144507497,4980
"244","chr19",13961853,13964012,13962932,2159
"245","chr1",45010553,45011350,45010951,797
"246","chr6",10722789,10723376,10723082,587
"247","chr2",55049419,55050908,55050163,1489
"248","chr1",90716540,90718983,90717761,2443
"249","chr2",231463734,231465438,231464586,1704
"250","chr6",30686615,30687624,30687119,1009
"251","chr12",76031063,76032536,76031799,1473
"252","chr2",169827350,169828119,169827734,769
"253","chr3",158103443,158103815,158103629,372
"254","chr4",83455513,83456084,83455798,571
"255","chr16",54291128,54291791,54291459,663
"256","chr4",89110753,89111854,89111303,1101
"257","chr16",11345329,11345910,11345619,581
"258","chrX",48521509,48522249,48521879,740
"259","chr1",9198506,9198897,9198701,391
"260","chr2",218873359,218874066,218873712,707
"261","chr2",20670246,20671520,20670883,1274
"262","chr8",63168115,63169207,63168661,1092
"263","chr2",212537456,212538523,212537989,1067
"264","chr12",49059854,49060979,49060416,1125
"265","chr16",8797465,8798071,8797768,606
"266","chr4",40437804,40438888,40438346,1084
"267","chr14",36657581,36659069,36658325,1488
"268","chr1",152515581,152515794,152515687,213
"269","chr16",3563099,3563545,3563322,446
"270","chr19",46346928,46347421,46347174,493
"271","chr16",85163129,85163386,85163257,257
"272","chr17",77793244,77793471,77793357,227
"273","chr16",49278041,49278397,49278219,356
"274","chr3",14555893,14556144,14556018,251
"275","chr2",216694316,216694761,216694538,445
"276","chrX",154485949,154487036,154486492,1087
"277","chr17",8392581,8393002,8392791,421
"278","chr6",30742530,30744663,30743596,2133
"279","chr17",75778708,75779963,75779335,1255
"280","chr5",667844,668474,668159,630
"281","chr2",192194269,192196086,192195177,1817
"282","chr6",53794456,53796174,53795315,1718
"283","chr22",50280550,50284205,50282377,3655
"284","chr14",20682759,20683065,20682912,306
"285","chr2",218216930,218217574,218217252,644
"286","chr18",24138898,24139586,24139242,688
"287","chr1",143884628,143885489,143885058,861
"288","chr6",15517051,15517326,15517188,275
"289","chr1",153633701,153634498,153634099,797
"290","chr1",227734942,227735730,227735336,788
"291","chrX",130339489,130339971,130339730,482
"292","chr11",17734509,17736739,17735624,2230
"293","chr7",141072558,141074760,141073659,2202
"294","chr15",97960304,97961419,97960861,1115
"295","chr12",132319713,132319983,132319848,270
"296","chr13",94549306,94550039,94549672,733
"297","chr6",39313327,39314439,39313883,1112
"298","chr13",20231877,20232728,20232302,851
"299","chr15",34038368,34039277,34038822,909
"300","chr6",30466252,30466645,30466448,393
"301","chr17",74748289,74749813,74749051,1524
"302","chr6",8063813,8064532,8064172,719
"303","chr17",75917925,75918295,75918110,370
"304","chr16",359984,361491,360737,1507
"305","chr14",61321162,61322749,61321955,1587
"306","chr11",4187218,4187923,4187570,705
"307","chr6",33788286,33789229,33788757,943
"308","chr8",87873943,87874217,87874080,274
"309","chr4",72031847,72032247,72032047,400
"310","chr1",76867426,76868849,76868137,1423
"311","chr1",192808502,192809068,192808785,566
"312","chr7",101088807,101089143,101088975,336
"313","chr1",37764166,37765216,37764691,1050
"314","chr17",62064886,62066155,62065520,1269
"315","chr12",122774349,122774761,122774555,412
"316","chr8",23726473,23727248,23726860,775
"317","chr2",71453428,71454146,71453787,718
"318","chr17",82663965,82664184,82664074,219
"319","chr22",21982551,21982936,21982743,385
"320","chr16",579463,579903,579683,440
"321","chr9",137174340,137174630,137174485,290
"322","chr19",1423753,1424007,1423880,254
"323","chr2",9206254,9207815,9207034,1561
"324","chr7",158455196,158456620,158455908,1424
"325","chr1",64505675,64505921,64505798,246
"326","chr19",7466924,7467783,7467353,859
"327","chr2",85354509,85354840,85354674,331
"328","chr22",21866765,21868077,21867421,1312
"329","chr2",126656120,126656595,126656357,475
"330","chr1",2018972,2020040,2019506,1068
"331","chrX",48598722,48598950,48598836,228
"332","chr1",6451629,6452050,6451839,421
"333","chr9",135086975,135088408,135087691,1433
"334","chr17",7853254,7854334,7853794,1080
"335","chr8",10612285,10612559,10612422,274
"336","chr19",2328365,2329090,2328727,725
"337","chr2",199850665,199851344,199851004,679
"338","chr11",124839326,124840061,124839693,735
"339","chr2",3317292,3317522,3317407,230
"340","chr8",20249921,20250147,20250034,226
"341","chr7",101743274,101743842,101743558,568
"342","chr1",43565615,43566167,43565891,552
"343","chr12",131432941,131434262,131433601,1321
"344","chr16",56730081,56730565,56730323,484
"345","chr10",92290666,92291655,92291160,989
"346","chr8",141226938,141227261,141227099,323
"347","chr13",113152974,113154469,113153721,1495
"348","chr22",29313292,29316024,29314658,2732
"349","chr5",132737003,132737737,132737370,734
"350","chr8",142669341,142670424,142669882,1083
"351","chr7",6577287,6577646,6577466,359
"352","chr19",2474612,2476830,2475721,2218
"353","chr17",79789565,79793557,79791561,3992
"354","chr12",6646835,6647513,6647174,678
"355","chr1",43974470,43975584,43975027,1114
"356","chr17",81890636,81892105,81891370,1469
"357","chr18",158278,159311,158794,1033
"358","chr2",176150220,176150486,176150353,266
"359","chr10",96043114,96044505,96043809,1391
"360","chr2",66425736,66427086,66426411,1350
"361","chr14",23555797,23556368,23556082,571
"362","chr16",35574084,35575503,35574793,1419
"363","chr12",54106343,54107374,54106858,1031
"364","chr6",19691679,19692074,19691876,395
"365","chr11",44726967,44728211,44727589,1244
"366","chr9",131373301,131373773,131373537,472
"367","chr8",143973125,143978137,143975631,5012
"368","chr6",28587086,28587347,28587216,261
"369","chr2",240129781,240129983,240129882,202
"370","chr14",24081108,24081939,24081523,831
"371","chr12",89707659,89710288,89708973,2629
"372","chr4",121380412,121381135,121380773,723
"373","chr1",46448114,46448671,46448392,557
"374","chr15",56918028,56919807,56918917,1779
"375","chr11",55874234,55874644,55874439,410
"376","chr5",171387443,171388651,171388047,1208
"377","chr6",36547218,36547531,36547374,313
"378","chr1",244054972,244055236,244055104,264
"379","chr17",42980445,42981229,42980837,784
"380","chr2",143936763,143937613,143937188,850
"381","chr7",21542825,21543695,21543260,870
"382","chr14",104176836,104177866,104177351,1030
"383","chr18",57352476,57354374,57353425,1898
"384","chr8",76999896,77000821,77000358,925
"385","chr17",42154891,42155245,42155068,354
"386","chrX",150568270,150569173,150568721,903
"387","chr1",41017746,41018021,41017883,275
"388","chr16",1655865,1656243,1656054,378
"389","chr6",49463221,49463423,49463322,202
"390","chr2",8837243,8837659,8837451,416
"391","chr6",7312578,7313423,7313000,845
"392","chr7",146116182,146116992,146116587,810
"393","chr16",31487329,31489243,31488286,1914
"394","chr19",41439785,41439999,41439892,214
"395","chr17",29019835,29020204,29020019,369
"396","chrX",40174986,40177255,40176120,2269
"397","chr1",112706720,112707576,112707148,856
"398","chr1",2402111,2402733,2402422,622
"399","chr6",28281389,28281791,28281590,402
"400","chr14",60091622,60092458,60092040,836
"401","chr2",45611153,45611443,45611298,290
"402","chr15",70585041,70585619,70585330,578
"403","chr17",40089165,40089406,40089285,241
"404","chr1",167121338,167121773,167121555,435
"405","chr17",40219188,40219584,40219386,396
"406","chr8",143916102,143926154,143921128,10052
"407","chr17",78232029,78232299,78232164,270
"408","chr8",19816752,19817777,19817264,1025
"409","chr10",8058421,8058805,8058613,384
"410","chr14",97218722,97219609,97219165,887
"411","chr1",2789460,2790396,2789928,936
"412","chr19",18109954,18110635,18110294,681
"413","chr22",30246448,30246682,30246565,234
"414","chr9",133255614,133256444,133256029,830
"415","chr7",153886232,153888581,153887406,2349
"416","chr1",28328854,28329156,28329005,302
"417","chr8",27463397,27463759,27463578,362
"418","chr15",84816961,84817634,84817297,673
"419","chr2",30447122,30447854,30447488,732
"420","chr2",118774489,118774739,118774614,250
"421","chr6",157592780,157593224,157593002,444
"422","chr1",26161316,26162115,26161715,799
"423","chr17",20155715,20156747,20156231,1032
"424","chr10",132783853,132789145,132786499,5292
"425","chr18",21600088,21601065,21600576,977
"426","chr1",29181464,29182174,29181819,710
"427","chr2",161418650,161419085,161418867,435
"428","chr7",102286212,102287799,102287005,1587
"429","chr2",65055896,65057035,65056465,1139
"430","chrX",151974208,151974899,151974553,691
"431","chr1",230978125,230979127,230978626,1002
"432","chrX",118823652,118823974,118823813,322
"433","chr2",109613329,109615724,109614526,2395
"434","chr7",2592537,2592738,2592637,201
"435","chr17",45160893,45161866,45161379,973
"436","chr2",208124110,208124545,208124327,435
"437","chr8",3022164,3022426,3022295,262
"438","chr12",123972026,123974181,123973103,2155
"439","chr16",1194669,1195128,1194898,459
"440","chr14",37598241,37600002,37599121,1761
"441","chr14",72892081,72894226,72893153,2145
"442","chr10",49131845,49132133,49131989,288
"443","chr13",25095903,25096393,25096148,490
"444","chr16",85636528,85636743,85636635,215
"445","chr3",11017132,11017365,11017248,233
"446","chr12",120495846,120496910,120496378,1064
"447","chr13",29850012,29850804,29850408,792
"448","chr12",132277357,132277604,132277480,247
"449","chr19",40596939,40597240,40597089,301
"450","chr1",173476839,173477966,173477402,1127
"451","chr13",45713147,45714079,45713613,932
"452","chr19",34772743,34773370,34773056,627
"453","chr4",122922207,122922640,122922423,433
"454","chr1",234608530,234611278,234609904,2748
"455","chr12",130138597,130138947,130138772,350
"456","chr19",40529193,40529533,40529363,340
"457","chr1",7827138,7827416,7827277,278
"458","chr15",58987542,58988521,58988031,979
"459","chr4",56655455,56656537,56655996,1082
"460","chr14",100734280,100734592,100734436,312
"461","chr8",143255366,143256415,143255890,1049
"462","chr14",81533407,81534090,81533748,683
"463","chr12",109713522,109714953,109714237,1431
"464","chr1",212514885,212515106,212514995,221
"465","chr6",159968800,159969858,159969329,1058
"466","chr18",36067102,36067702,36067402,600
"467","chr4",1552738,1552951,1552844,213
"468","chr16",6483018,6483982,6483500,964
"469","chr18",50729174,50729989,50729581,815
"470","chr9",113012015,113012335,113012175,320
"471","chr17",55751061,55751377,55751219,316
"472","chr7",108454957,108456714,108455835,1757
"473","chr2",68319207,68319979,68319593,772
"474","chr15",70853656,70854481,70854068,825
"475","chr12",78804284,78804620,78804452,336
"476","chr6",17600151,17601166,17600658,1015
"477","chr7",865971,866249,866110,278
"478","chr7",142854117,142855424,142854770,1307
"479","chr6",110981911,110982282,110982096,371
"480","chr5",66144008,66144936,66144472,928
"481","chr6",43308681,43308921,43308801,240
"482","chr1",8211936,8212142,8212039,206
"483","chr6",35511611,35512377,35511994,766
"484","chr15",28094628,28097296,28095962,2668
"485","chr1",84505661,84506808,84506234,1147
"486","chr12",109309021,109310573,109309797,1552
"487","chr16",88754709,88755232,88754970,523
"488","chr12",94186880,94187098,94186989,218
"489","chr4",169009639,169010456,169010047,817
"490","chr21",43789386,43789999,43789692,613
"491","chr17",28896987,28897855,28897421,868
"492","chr4",42397135,42398785,42397960,1650
"493","chr14",92513382,92514884,92514133,1502
"494","chr1",16612961,16613959,16613460,998
"495","chr17",4966894,4968415,4967654,1521
"496","chr8",26513656,26515314,26514485,1658
"497","chr12",27710700,27711148,27710924,448
"498","chr8",66612372,66613824,66613098,1452
"499","chr15",29569831,29571445,29570638,1614
"500","chr2",218984197,218984742,218984469,545
"501","chr2",127387283,127388321,127387802,1038
"502","chr14",90815883,90816604,90816243,721
"503","chr16",85625136,85625392,85625264,256
"504","chr16",85170992,85171425,85171208,433
"505","chr17",35808874,35809906,35809390,1032
"506","chr16",4271824,4274063,4272943,2239
"507","chr6",37257582,37257924,37257753,342
"508","chr17",77088540,77089003,77088771,463
"509","chr1",53737729,53739637,53738683,1908
"510","chr12",51868947,51869666,51869306,719
"511","chr1",244047732,244049607,244048669,1875
"512","chr16",83968102,83969255,83968678,1153
"513","chr22",27438464,27438669,27438566,205
"514","chr15",43133704,43134065,43133884,361
"515","chrX",31071769,31072213,31071991,444
"516","chr8",143609230,143610099,143609664,869
"517","chr1",85616017,85616350,85616183,333
"518","chr10",102245382,102245835,102245608,453
"519","chr8",104466444,104467112,104466778,668
"520","chr9",135906616,135908479,135907547,1863
"521","chr1",47708822,47710847,47709834,2025
"522","chr16",68264109,68265076,68264592,967
"523","chr10",127195241,127196565,127195903,1324
"524","chr20",43457308,43458682,43457995,1374
"525","chr22",49052017,49052471,49052244,454
"526","chr16",11667885,11669087,11668486,1202
"527","chr12",132801798,132802052,132801925,254
"528","chr12",132379724,132380308,132380016,584
"529","chr2",27663392,27664543,27663967,1151
"530","chr15",40763198,40764589,40763893,1391
"531","chr11",69774058,69775778,69774918,1720
"532","chr19",15401214,15401582,15401398,368
"533","chr20",461886,462721,462303,835
"534","chr13",26253799,26254966,26254382,1167
"535","chr1",231241050,231241497,231241273,447
"536","chr10",112446846,112447562,112447204,716
"537","chr4",54229872,54234164,54232018,4292
"538","chr11",64342350,64342756,64342553,406
"539","chr17",45783318,45785562,45784440,2244
"540","chr8",92965565,92966241,92965903,676
"541","chr19",19260866,19261584,19261225,718
"542","chr1",205774772,205775540,205775156,768
"543","chr6",31682871,31683515,31683193,644
"544","chr17",57861727,57862230,57861978,503
"545","chr1",23177566,23178140,23177853,574
"546","chr3",69084935,69085328,69085131,393
"547","chr1",44405469,44408375,44406922,2906
"548","chr19",44141341,44141916,44141628,575
"549","chr19",12092213,12092688,12092450,475
"550","chr8",64575979,64576559,64576269,580
"551","chr10",124388836,124389506,124389171,670
"552","chr2",43995602,43996593,43996097,991
"553","chr2",71852232,71852480,71852356,248
"554","chrX",48574427,48574934,48574680,507
"555","chr13",110615433,110616431,110615932,998
"556","chr1",19643761,19645429,19644595,1668
"557","chr6",33313335,33314050,33313692,715
"558","chr16",86681392,86681719,86681555,327
"559","chr15",74937441,74938319,74937880,878
"560","chr1",113929343,113930277,113929810,934
"561","chr1",2930491,2930723,2930607,232
"562","chr16",29185216,29185450,29185333,234
"563","chr7",102300501,102301273,102300887,772
"564","chr11",67071447,67071721,67071584,274
"565","chr2",20223327,20226006,20224666,2679
"566","chr7",157017878,157021899,157019888,4021
"567","chr16",71860204,71860491,71860347,287
"568","chr2",179263891,179264936,179264413,1045
"569","chr1",2513916,2514209,2514062,293
"570","chr13",93226992,93228624,93227808,1632
"571","chr19",17390377,17391441,17390909,1064
"572","chr17",35731530,35732316,35731923,786
"573","chr6",53347819,53349245,53348532,1426
"574","chr5",80255550,80256475,80256012,925
"575","chr22",23894070,23895352,23894711,1282
"576","chr16",21519791,21520802,21520296,1011
"577","chr3",188947486,188947763,188947624,277
"578","chr17",49494983,49497954,49496468,2971
"579","chr16",73062989,73063216,73063102,227
"580","chr4",122732430,122732845,122732637,415
"581","chr15",31869961,31871001,31870481,1040
"582","chr16",22373756,22375164,22374460,1408
"583","chr2",9422997,9424153,9423575,1156
"584","chr3",169661649,169663268,169662458,1619
"585","chr19",17795295,17795508,17795401,213
"586","chr10",49538588,49539283,49538935,695
"587","chr14",70808555,70809854,70809204,1299
"588","chr3",61250932,61251553,61251242,621
"589","chr15",99014749,99015941,99015345,1192
"590","chr1",145845532,145845932,145845732,400
"591","chr2",144389556,144389909,144389732,353
"592","chr8",42541092,42542052,42541572,960
"593","chr1",17149207,17149580,17149393,373
"594","chr5",2136683,2137191,2136937,508
"595","chr12",56266658,56267347,56267002,689
"596","chr16",87860753,87860960,87860856,207
"597","chr17",1160648,1161010,1160829,362
"598","chr2",238140747,238141448,238141097,701
"599","chr1",37474122,37474620,37474371,498
"600","chr3",147359328,147359885,147359606,557
"601","chr2",10689598,10690115,10689856,517
"602","chr2",44952120,44953255,44952687,1135
"603","chr19",58084449,58085560,58085004,1111
"604","chr17",80010181,80010683,80010432,502
"605","chr6",34196360,34196749,34196554,389
"606","chr4",186889116,186889581,186889348,465
"607","chr13",41456777,41458531,41457654,1754
"608","chr10",688767,690282,689524,1515
"609","chr21",32727405,32728485,32727945,1080
"610","chr12",56007712,56008036,56007874,324
"611","chr3",172750582,172751055,172750818,473
"612","chr16",85829775,85829995,85829885,220
"613","chr12",123787581,123788038,123787809,457
"614","chr3",191863139,191863511,191863325,372
"615","chrX",48508777,48509354,48509065,577
"616","chr1",2212760,2213058,2212909,298
"617","chr16",30052879,30053357,30053118,478
"618","chr4",10461208,10462065,10461636,857
"619","chr17",81078092,81078734,81078413,642
"620","chr15",41971958,41972663,41972310,705
"621","chr6",44002187,44003185,44002686,998
"622","chr6",35496279,35498492,35497385,2213
"623","chr6",30259543,30260478,30260010,935
"624","chr10",59905898,59907036,59906467,1138
"625","chr16",89964101,89964332,89964216,231
"626","chr1",200147568,200148076,200147822,508
"627","chr2",206765154,206765436,206765295,282
"628","chr8",133569726,133572716,133571221,2990
"629","chr1",32886085,32886796,32886440,711
"630","chr15",90001688,90002679,90002183,991
"631","chr13",72727092,72728016,72727554,924
"632","chr15",96321652,96323558,96322605,1906
"633","chr18",57586312,57586861,57586586,549
"634","chr6",32195515,32196606,32196060,1091
"635","chr1",160083931,160084948,160084439,1017
"636","chr16",30922316,30923444,30922880,1128
"637","chr12",6493882,6494140,6494011,258
"638","chr13",39655606,39656044,39655825,438
"639","chr2",120586974,120587765,120587369,791
"640","chr17",44218493,44222351,44220422,3858
"641","chr18",24397311,24397922,24397616,611
"642","chr18",5542848,5544242,5543545,1394
"643","chr7",42493477,42493684,42493580,207
"644","chr7",143287954,143288717,143288335,763
"645","chr16",10944307,10944906,10944606,599
"646","chr7",151395789,151396111,151395950,322
"647","chr2",85327011,85328291,85327651,1280
"648","chr18",52342007,52342352,52342179,345
"649","chrX",46912128,46913546,46912837,1418
"650","chr1",156291408,156291634,156291521,226
"651","chr16",30748082,30748999,30748540,917
"652","chr1",116667202,116667999,116667600,797
"653","chr18",78390398,78391531,78390964,1133
"654","chr1",226703331,226703680,226703505,349
"655","chr15",57306340,57307115,57306727,775
"656","chr17",39224700,39226110,39225405,1410
"657","chr11",88175075,88175618,88175346,543
"658","chr16",31224204,31224783,31224493,579
"659","chr7",1412781,1413158,1412969,377
"660","chr19",18257672,18258101,18257886,429
"661","chr15",39580326,39581366,39580846,1040
"662","chr15",73926355,73928032,73927193,1677
"663","chr2",200811266,200812583,200811924,1317
"664","chr1",246788912,246789209,246789060,297
"665","chr20",32189953,32190526,32190239,573
"666","chr2",219541641,219542118,219541879,477
"667","chr3",114350878,114351811,114351344,933
"668","chr1",222465419,222465631,222465525,212
"669","chr2",44801816,44802896,44802356,1080
"670","chr4",1539864,1540141,1540002,277
"671","chr6",119077926,119079058,119078492,1132
"672","chr8",58145608,58146855,58146231,1247
"673","chr12",53695427,53695629,53695528,202
"674","chr6",29627521,29628187,29627854,666
"675","chr4",185638877,185639207,185639042,330
"676","chr4",1978853,1979107,1978980,254
"677","chr15",100849527,100850055,100849791,528
"678","chr8",124538970,124539280,124539125,310
"679","chr6",125790391,125791334,125790862,943
"680","chr19",52527643,52528106,52527874,463
"681","chr1",3001801,3002189,3001995,388
"682","chr3",187743680,187744937,187744308,1257
"683","chr15",26891768,26892013,26891890,245
"684","chr12",6766407,6767757,6767082,1350
"685","chr15",55587594,55589030,55588312,1436
"686","chr2",130916113,130916577,130916345,464
"687","chr13",102798527,102800866,102799696,2339
"688","chr6",31889119,31889327,31889223,208
"689","chr16",58733543,58734424,58733983,881
"690","chr20",45311666,45312175,45311920,509
"691","chr3",138915508,138916147,138915827,639
"692","chr6",31665038,31666316,31665677,1278
"693","chr5",159773230,159773685,159773457,455
"694","chr12",52600988,52601528,52601258,540
"695","chr3",147395821,147396692,147396256,871
"696","chr19",47743375,47743857,47743616,482
"697","chr16",19555164,19556066,19555615,902
"698","chr7",75638686,75639633,75639159,947
"699","chr17",45147405,45150249,45148827,2844
"700","chr7",137846379,137847636,137847007,1257
"701","chr2",95207143,95207800,95207471,657
"702","chr12",111310374,111310588,111310481,214
"703","chr12",51847061,51849567,51848314,2506
"704","chr12",57546780,57547078,57546929,298
"705","chr6",39303740,39303982,39303861,242
"706","chr8",1495701,1495920,1495810,219
"707","chr6",17706061,17707108,17706584,1047
"708","chr19",35278974,35279201,35279087,227
"709","chr17",80353873,80354166,80354019,293
"710","chr6",147203677,147204712,147204194,1035
"711","chr15",75578461,75579473,75578967,1012
"712","chr14",20413410,20413611,20413510,201
"713","chr8",144427952,144428762,144428357,810
"714","chr2",191245344,191246214,191245779,870
"715","chr6",132798344,132798663,132798503,319
"716","chrX",101390792,101391119,101390955,327
"717","chr17",3623949,3624201,3624075,252
"718","chr17",50944495,50944918,50944706,423
"719","chr7",155338259,155338802,155338530,543
"720","chr1",6208760,6209528,6209144,768
"721","chr2",119223503,119224242,119223872,739
"722","chrX",126165262,126166453,126165857,1191
"723","chr6",29792169,29793126,29792647,957
"724","chr7",8261401,8262622,8262011,1221
"725","chr17",77280888,77282090,77281489,1202
"726","chr5",141303628,141304206,141303917,578
"727","chr3",38039137,38039696,38039416,559
"728","chr19",29212663,29213424,29213043,761
"729","chr6",169167170,169167515,169167342,345
"730","chr7",100428181,100430379,100429280,2198
"731","chr1",3231281,3231517,3231399,236
"732","chr1",147171891,147172922,147172406,1031
"733","chr1",223081476,223081699,223081587,223
"734","chr6",30171941,30172486,30172213,545
"735","chr12",96907024,96907509,96907266,485
"736","chr16",86931665,86931890,86931777,225
"737","chr1",2443379,2444375,2443877,996
"738","chr10",130014778,130015013,130014895,235
"739","chr16",15949361,15950070,15949715,709
"740","chr15",29115492,29116026,29115759,534
"741","chr6",33454269,33454753,33454511,484
"742","chr8",1841813,1842102,1841957,289
"743","chr1",145927161,145927504,145927332,343
"744","chr17",49035894,49036128,49036011,234
"745","chr1",16980056,16980868,16980462,812
"746","chr6",33199994,33200938,33200466,944
"747","chr17",7548833,7549228,7549030,395
"748","chr7",87627642,87629128,87628385,1486
"749","chr12",31323783,31326448,31325115,2665
"750","chrX",49269182,49270737,49269959,1555
"751","chr6",2841539,2842039,2841789,500
"752","chr4",101346478,101348464,101347471,1986
"753","chr3",195953933,195954692,195954312,759
"754","chr16",81095756,81096613,81096184,857
"755","chr6",168078886,168079129,168079007,243
"756","chr10",71850904,71851390,71851147,486
"757","chr19",7533527,7536122,7534824,2595
"758","chr1",108692166,108692539,108692352,373
"759","chr2",27890193,27890897,27890545,704
"760","chr6",31862522,31863171,31862846,649
"761","chr12",11500298,11500841,11500569,543
"762","chr19",10543552,10544366,10543959,814
"763","chr7",23013352,23014383,23013867,1031
"764","chr8",56448026,56448256,56448141,230
"765","chr13",32315396,32315763,32315579,367
"766","chr18",58670979,58671846,58671412,867
"767","chr12",121578265,121580682,121579473,2417
"768","chr7",43729215,43729880,43729547,665
"769","chr7",47581514,47582129,47581821,615
"770","chr19",12696191,12696747,12696469,556
"771","chr8",97277376,97278176,97277776,800
"772","chr17",74776105,74776553,74776329,448
"773","chr17",35578483,35578707,35578595,224
"774","chr6",122789143,122789733,122789438,590
"775","chr19",5690116,5692202,5691159,2086
"776","chr17",29566068,29569060,29567564,2992
"777","chr12",130904718,130905238,130904978,520
"778","chr20",59031990,59032727,59032358,737
"779","chr8",747858,748262,748060,404
"780","chr1",3786900,3787344,3787122,444
"781","chr3",125519652,125520357,125520004,705
"782","chrX",150361273,150365823,150363548,4550
"783","chr4",1009318,1012494,1010906,3176
"784","chr19",7847743,7848009,7847876,266
"785","chr12",44876047,44877052,44876549,1005
"786","chr3",49339907,49340421,49340164,514
"787","chr4",164383176,164384025,164383600,849
"788","chr7",133081749,133082336,133082042,587
"789","chr1",2372720,2372937,2372828,217
"790","chr2",48314377,48315448,48314912,1071
"791","chr15",96344186,96344387,96344286,201
"792","chr16",71289212,71289611,71289411,399
"793","chr1",28235999,28236465,28236232,466
"794","chr1",98661316,98662155,98661735,839
"795","chr2",110204823,110205054,110204938,231
"796","chr16",3457545,3458606,3458075,1061
"797","chr8",143317019,143317221,143317120,202
"798","chr18",3449271,3452362,3450816,3091
"799","chr3",185586034,185586709,185586371,675
"800","chr12",123388650,123390050,123389350,1400
"801","chr19",4954441,4954859,4954650,418
"802","chr8",73971999,73972367,73972183,368
"803","chr7",87345424,87345772,87345598,348
"804","chr4",38663028,38664910,38663969,1882
"805","chr9",35115704,35116449,35116076,745
"806","chr16",4693042,4694355,4693698,1313
"807","chr3",44761360,44762126,44761743,766
"808","chr7",134316455,134317230,134316842,775
"809","chr12",15788784,15789806,15789295,1022
"810","chr15",63277097,63277301,63277199,204
"811","chr19",12668981,12670280,12669630,1299
"812","chr8",142279952,142280281,142280116,329
"813","chr10",133205173,133205580,133205376,407
"814","chr13",112765838,112766070,112765954,232
"815","chr7",9726032,9726586,9726309,554
"816","chr19",7440037,7440300,7440168,263
"817","chr16",88715743,88716109,88715926,366
"818","chr6",42050401,42050866,42050633,465
"819","chr9",71911489,71911763,71911626,274
"820","chr8",84184524,84185012,84184768,488
"821","chr1",39639338,39640035,39639686,697
"822","chr11",3840625,3841766,3841195,1141
"823","chr19",10223942,10224835,10224388,893
"824","chr2",8456777,8457443,8457110,666
"825","chr2",63840758,63841772,63841265,1014
"826","chr6",62285950,62286323,62286136,373
"827","chr1",155308616,155308952,155308784,336
"828","chr1",224615935,224617612,224616773,1677
"829","chr1",229431459,229434937,229433198,3478
"830","chr19",14089708,14091552,14090630,1844
"831","chr2",39665576,39666511,39666043,935
"832","chr20",63767056,63767637,63767346,581
"833","chr8",53877021,53878105,53877563,1084
"834","chr16",89159279,89159787,89159533,508
"835","chrX",139446824,139447142,139446983,318
"836","chr17",78990501,78990780,78990640,279
"837","chrX",69128556,69128932,69128744,376
"838","chr22",50481024,50482044,50481534,1020
"839","chr18",79950769,79952896,79951832,2127
"840","chr1",24929036,24932514,24930775,3478
"841","chr7",2661696,2662110,2661903,414
"842","chr16",88896262,88897043,88896652,781
"843","chr7",158405853,158406215,158406034,362
"844","chr1",31065565,31066091,31065828,526
"845","chr1",228082028,228083800,228082914,1772
"846","chr6",167825383,167827879,167826631,2496
"847","chr2",176128222,176128458,176128340,236
"848","chr10",133393963,133394569,133394266,606
"849","chr10",103192485,103193475,103192980,990
"850","chr7",158863591,158864053,158863822,462
"851","chr6",169139406,169139938,169139672,532
"852","chr16",87985025,87985348,87985186,323
"853","chr12",45728688,45730672,45729680,1984
"854","chr19",36797440,36797821,36797630,381
"855","chr19",55407331,55408448,55407889,1117
"856","chr11",33015660,33016371,33016015,711
"857","chr13",21326286,21326498,21326392,212
"858","chr6",33320956,33321231,33321093,275
"859","chr2",203327932,203328661,203328296,729
"860","chr1",29230708,29231115,29230911,407
"861","chrY",8279836,8280169,8280002,333
"862","chr4",38688687,38688984,38688835,297
"863","chr7",1065623,1066338,1065980,715
"864","chr7",92245467,92246537,92246002,1070
"865","chr4",74933090,74934721,74933905,1631
"866","chr1",111619582,111620215,111619898,633
"867","chr13",112943239,112943973,112943606,734
"868","chr6",26271117,26271360,26271238,243
"869","chr1",39683759,39684341,39684050,582
"870","chr12",68686800,68687372,68687086,572
"871","chr16",7304332,7304607,7304469,275
"872","chr19",56159707,56160250,56159978,543
"873","chr16",3979156,3979412,3979284,256
"874","chr1",245687875,245689212,245688543,1337
"875","chr16",10180086,10183567,10181826,3481
"876","chr10",132879347,132879748,132879547,401
"877","chr12",122980273,122981425,122980849,1152
"878","chr1",151837984,151839208,151838596,1224
"879","chr3",64023207,64023617,64023412,410
"880","chr2",74464832,74465530,74465181,698
"881","chr17",81341162,81346853,81344007,5691
"882","chr2",233476712,233477084,233476898,372
"883","chr6",163972039,163972792,163972415,753
"884","chr20",36605426,36606379,36605902,953
"885","chr1",150281954,150282226,150282090,272
"886","chr7",47052646,47053478,47053062,832
"887","chr4",185016088,185016596,185016342,508
"888","chr17",34578946,34581852,34580399,2906
"889","chr10",101006564,101006936,101006750,372
"890","chr4",54109220,54110035,54109627,815
"891","chr2",219570104,219571259,219570681,1155
"892","chr16",85329510,85329754,85329632,244
"893","chr2",218858979,218860287,218859633,1308
"894","chr4",966717,967048,966882,331
"895","chr2",178112351,178113101,178112726,750
"896","chr1",25246475,25248030,25247252,1555
"897","chrX",44872356,44874107,44873231,1751
"898","chr3",128496369,128498062,128497215,1693
"899","chr16",66924830,66925752,66925291,922
"900","chr16",29811842,29812585,29812213,743
"901","chr19",14162617,14163361,14162989,744
"902","chr2",54723257,54725351,54724304,2094
"903","chr16",89574645,89577007,89575826,2362
"904","chr19",835272,835524,835398,252
"905","chr6",116876926,116877542,116877234,616
"906","chr17",61454362,61455072,61454717,710
"907","chr12",47235251,47235897,47235574,646
"908","chr18",44679018,44680830,44679924,1812
"909","chr3",127915150,127915745,127915447,595
"910","chr13",112785919,112786743,112786331,824
"911","chr3",138834317,138835236,138834776,919
"912","chr10",102713642,102714954,102714298,1312
"913","chr11",123741190,123741837,123741513,647
"914","chr17",44014344,44014580,44014462,236
"915","chr3",49199215,49199895,49199555,680
"916","chr2",1648223,1649629,1648926,1406
"917","chr1",172532770,172533405,172533087,635
"918","chr19",17821142,17821561,17821351,419
"919","chr4",127880731,127881541,127881136,810
"920","chr8",22156591,22157046,22156818,455
"921","chr19",38385430,38388310,38386870,2880
"922","chr1",226976038,226976536,226976287,498
"923","chr16",87382977,87384632,87383804,1655
"924","chr4",82428900,82431306,82430103,2406
"925","chr22",29766847,29767117,29766982,270
"926","chr6",165660394,165664264,165662329,3870
"927","chr17",36808073,36808733,36808403,660
"928","chr5",141374087,141374385,141374236,298
"929","chr6",33417901,33418485,33418193,584
"930","chr1",36149254,36149861,36149557,607
"931","chr19",4558351,4558567,4558459,216
"932","chr2",176092326,176093551,176092938,1225
"933","chr16",3879482,3881650,3880566,2168
"934","chr16",2297281,2297635,2297458,354
"935","chr17",19713770,19714111,19713940,341
"936","chr16",24729345,24730481,24729913,1136
"937","chr7",27739947,27740982,27740464,1035
"938","chr2",238231455,238232018,238231736,563
"939","chr10",119165273,119166046,119165659,773
"940","chr2",108786451,108787110,108786780,659
"941","chr17",79810010,79816043,79813026,6033
"942","chr5",178525109,178525737,178525423,628
"943","chr19",49766375,49767248,49766811,873
"944","chr17",7237802,7239752,7238777,1950
"945","chr15",40925591,40930982,40928286,5391
"946","chr4",165207233,165208103,165207668,870
"947","chr1",248873209,248873811,248873510,602
"948","chr2",171922223,171922789,171922506,566
"949","chr2",161160372,161160820,161160596,448
"950","chr1",32901191,32901721,32901456,530
"951","chr2",45650039,45652546,45651292,2507
"952","chr7",27113568,27114168,27113868,600
"953","chr12",54030826,54031389,54031107,563
"954","chr2",11155454,11155880,11155667,426
"955","chr1",153990751,153991034,153990892,283
"956","chrX",13652967,13653487,13653227,520
"957","chr6",30326392,30327294,30326843,902
"958","chr9",135499548,135501425,135500486,1877
"959","chr19",13932832,13933398,13933115,566
"960","chr1",39900923,39902541,39901732,1618
"961","chrX",30308322,30309551,30308936,1229
"962","chr6",168517916,168518222,168518069,306
"963","chr8",122780130,122782847,122781488,2717
"964","chr2",241890848,241891078,241890963,230
"965","chr10",129838834,129839046,129838940,212
"966","chr19",43935048,43935460,43935254,412
"967","chr22",18023653,18024646,18024149,993
"968","chr1",1354327,1355746,1355036,1419
"969","chr22",17418807,17419240,17419023,433
"970","chr12",69585285,69585944,69585614,659
"971","chr3",49802670,49803758,49803214,1088
"972","chr2",62456987,62457417,62457202,430
"973","chr1",235866287,235867297,235866792,1010
"974","chr2",1476986,1477859,1477422,873
"975","chr16",1959402,1960082,1959742,680
"976","chrX",101552810,101553065,101552937,255
"977","chr15",83011255,83011780,83011517,525
"978","chr1",157045504,157046163,157045833,659
"979","chr1",52032780,52033833,52033306,1053
"980","chr19",49337930,49338371,49338150,441
"981","chr5",65102872,65103389,65103130,517
"982","chr4",26028798,26029070,26028934,272
"983","chr16",48365819,48366129,48365974,310
"984","chr17",3845844,3846484,3846164,640
"985","chr18",3879202,3880087,3879644,885
"986","chr1",113904832,113905402,113905117,570
"987","chr2",121736532,121737343,121736937,811
"988","chr17",9904750,9905022,9904886,272
"989","chr11",2268874,2271702,2270288,2828
"990","chr5",176809760,176811080,176810420,1320
"991","chr15",78640845,78641479,78641162,634
"992","chr1",151047735,151048151,151047943,416
"993","chr6",152302144,152302345,152302244,201
"994","chr11",66257439,66258782,66258110,1343
"995","chr5",14871757,14872262,14872009,505
"996","chr1",46167017,46167260,46167138,243
"997","chr7",99543143,99543528,99543335,385
"998","chr6",109381695,109382890,109382292,1195
"999","chr17",57849851,57850737,57850294,886
"1000","chr6",127120408,127120615,127120511,207
"1001","chr1",209784376,209784822,209784599,446
"1002","chr10",42475747,42476386,42476066,639
"1003","chr2",47520852,47521922,47521387,1070
"1004","chr5",173616120,173616892,173616506,772
"1005","chr5",140114348,140114956,140114652,608
"1006","chr1",45550731,45551022,45550876,291
"1007","chr7",150407616,150408442,150408029,826
"1008","chr10",68827160,68828452,68827806,1292
"1009","chr2",28566692,28567066,28566879,374
"1010","chr1",7961241,7962166,7961703,925
"1011","chr3",113514816,113515247,113515031,431
"1012","chr5",14664138,14665106,14664622,968
"1013","chr3",14947105,14948477,14947791,1372
"1014","chr16",57726079,57726331,57726205,252
"1015","chr1",171784276,171784489,171784382,213
"1016","chr15",45198747,45199054,45198900,307
"1017","chr17",38869484,38870851,38870167,1367
"1018","chr17",42675957,42677325,42676641,1368
"1019","chr7",101154251,101155198,101154724,947
"1020","chr18",26863236,26863446,26863341,210
"1021","chr16",1978986,1980709,1979847,1723
"1022","chr19",2226194,2228343,2227268,2149
"1023","chr7",92528173,92529091,92528632,918
"1024","chr4",8440706,8441386,8441046,680
"1025","chr19",40348273,40348826,40348549,553
"1026","chr2",222424203,222425294,222424748,1091
"1027","chr17",79981692,79981894,79981793,202
"1028","chr1",247007566,247008132,247007849,566
"1029","chr5",134632524,134633032,134632778,508
"1030","chr17",73192268,73193319,73192793,1051
"1031","chr11",69817265,69819942,69818603,2677
"1032","chr1",235648541,235650766,235649653,2225
"1033","chr6",169577122,169577798,169577460,676
"1034","chr7",101362618,101364162,101363390,1544
"1035","chr7",157078360,157078603,157078481,243
"1036","chr1",44806007,44806646,44806326,639
"1037","chr20",25081125,25082292,25081708,1167
"1038","chr1",6026184,6026434,6026309,250
"1039","chr10",25933992,25935093,25934542,1101
"1040","chr2",74391626,74392164,74391895,538
"1041","chr4",185018068,185021593,185019830,3525
"1042","chr6",169452220,169452585,169452402,365
"1043","chr6",75085164,75085372,75085268,208
"1044","chr12",2876812,2877473,2877142,661
"1045","chr6",93418501,93419959,93419230,1458
"1046","chr12",120580925,120581566,120581245,641
"1047","chr18",26546816,26551174,26548995,4358
"1048","chr19",34497843,34498046,34497944,203
"1049","chr1",66925197,66925426,66925311,229
"1050","chr16",85027576,85027935,85027755,359
"1051","chr1",184036225,184037632,184036928,1407
"1052","chr16",15135258,15137188,15136223,1930
"1053","chr8",47737204,47739091,47738147,1887
"1054","chr16",66402674,66403176,66402925,502
"1055","chr22",39994480,39995486,39994983,1006
"1056","chr1",147080779,147081028,147080903,249
"1057","chr13",25371855,25372815,25372335,960
"1058","chr19",407204,409511,408357,2307
"1059","chr8",58659044,58659967,58659505,923
"1060","chr1",55039387,55040342,55039864,955
"1061","chr8",92101828,92103751,92102789,1923
"1062","chr6",33248326,33249686,33249006,1360
"1063","chr11",57324397,57325357,57324877,960
"1064","chr1",42924164,42924880,42924522,716
"1065","chr21",36059825,36060852,36060338,1027
"1066","chr4",105895258,105896612,105895935,1354
"1067","chr20",37095547,37096241,37095894,694
"1068","chr12",38138226,38138813,38138519,587
"1069","chr1",161079556,161079947,161079751,391
"1070","chr6",32853072,32854593,32853832,1521
"1071","chr22",42513969,42514241,42514105,272
"1072","chr9",120868828,120869394,120869111,566
"1073","chr5",167858534,167858862,167858698,328
"1074","chr16",69311187,69311875,69311531,688
"1075","chr8",143809567,143809856,143809711,289
"1076","chr10",132404764,132406111,132405437,1347
"1077","chr10",23173295,23174960,23174127,1665
"1078","chr1",202348529,202349068,202348798,539
"1079","chr7",101217016,101217748,101217382,732
"1080","chr20",63319994,63320197,63320095,203
"1081","chrX",54529995,54530526,54530260,531
"1082","chr1",232986181,232986390,232986285,209
"1083","chr5",2111722,2112370,2112046,648
"1084","chr2",117858999,117860587,117859793,1588
"1085","chr1",35120730,35120990,35120860,260
"1086","chr3",154428558,154429176,154428867,618
"1087","chr5",134874197,134874814,134874505,617
"1088","chr15",101294738,101295741,101295239,1003
"1089","chr8",51408602,51409661,51409131,1059
"1090","chr1",65792757,65793235,65792996,478
"1091","chr12",12266745,12267607,12267176,862
"1092","chr9",127699264,127699560,127699412,296
"1093","chr12",75330049,75330426,75330237,377
"1094","chr13",96994140,96994483,96994311,343
"1095","chr16",1826112,1827632,1826872,1520
"1096","chr17",32518885,32519684,32519284,799
"1097","chr11",108008774,108009672,108009223,898
"1098","chr4",188659146,188659608,188659377,462
"1099","chr13",78609286,78609745,78609515,459
"1100","chr6",32968119,32969015,32968567,896
"1101","chr18",14997381,15000543,14998962,3162
"1102","chr19",53647822,53648987,53648404,1165
"1103","chr22",50577824,50578591,50578207,767
"1104","chr17",81448466,81448757,81448611,291
"1105","chr9",113410023,113410810,113410416,787
"1106","chr6",42911541,42911885,42911713,344
"1107","chr6",33116963,33117218,33117090,255
"1108","chr16",72008448,72008989,72008718,541
"1109","chr16",86377548,86377851,86377699,303
"1110","chr17",8326877,8327623,8327250,746
"1111","chr22",44916338,44916595,44916466,257
"1112","chr12",82686883,82687867,82687375,984
"1113","chr17",79777579,79778973,79778276,1394
"1114","chr6",13486092,13488560,13487326,2468
"1115","chr1",154607904,154608321,154608112,417
"1116","chr5",32709804,32714344,32712074,4540
"1117","chr4",55635745,55636498,55636121,753
"1118","chr6",170255785,170256064,170255924,279
"1119","chr5",141399446,141400092,141399769,646
"1120","chr17",44899342,44899750,44899546,408
"1121","chr7",100177110,100177960,100177535,850
"1122","chr5",161547686,161548378,161548032,692
"1123","chr6",27838065,27839075,27838570,1010
"1124","chr16",49283086,49283352,49283219,266
"1125","chr5",37836645,37840624,37838634,3979
"1126","chr13",71865230,71865927,71865578,697
"1127","chr1",93180115,93180914,93180514,799
"1128","chr1",231337519,231338636,231338077,1117
"1129","chr2",119678954,119679434,119679194,480
"1130","chr5",472485,475204,473844,2719
"1131","chr18",62186744,62188019,62187381,1275
"1132","chr16",84144395,84145618,84145006,1223
"1133","chr13",33542420,33543003,33542711,583
"1134","chr1",119006521,119008697,119007609,2176
"1135","chr17",45131980,45133379,45132679,1399
"1136","chr9",70412414,70414268,70413341,1854
"1137","chr10",29735143,29737148,29736145,2005
"1138","chr12",111841888,111842910,111842399,1022
"1139","chr6",41682934,41683844,41683389,910
"1140","chr13",99657950,99658192,99658071,242
"1141","chr16",66578846,66579509,66579177,663
"1142","chr1",149886219,149887920,149887069,1701
"1143","chr1",3139977,3140208,3140092,231
"1144","chr1",114780454,114780841,114780647,387
"1145","chr5",56480777,56481406,56481091,629
"1146","chr16",5239581,5240385,5239983,804
"1147","chr6",131807587,131808423,131808005,836
"1148","chr7",156968184,156968542,156968363,358
"1149","chr7",5781013,5781813,5781413,800
"1150","chr17",60525661,60526355,60526008,694
"1151","chr4",177309696,177310106,177309901,410
"1152","chr5",181052585,181053959,181053272,1374
"1153","chr2",134918202,134919518,134918860,1316
"1154","chr16",81678259,81678730,81678494,471
"1155","chr1",2970024,2970358,2970191,334
"1156","chr17",66301929,66303499,66302714,1570
"1157","chr4",15654741,15656116,15655428,1375
"1158","chr6",43427450,43428156,43427803,706
"1159","chr7",55005269,55005740,55005504,471
"1160","chr16",73065913,73066892,73066402,979
"1161","chr12",109718462,109718717,109718589,255
"1162","chr16",2537776,2538555,2538165,779
"1163","chr18",63970191,63970707,63970449,516
"1164","chr16",27313564,27314374,27313969,810
"1165","chr4",4575277,4575721,4575499,444
"1166","chr2",25276894,25277560,25277227,666
"1167","chr7",128455624,128456143,128455883,519
"1168","chrY",9526071,9526334,9526202,263
"1169","chr3",50260008,50260665,50260336,657
"1170","chr2",209423689,209424074,209423881,385
"1171","chr20",10671925,10674963,10673444,3038
"1172","chr5",73230376,73230670,73230523,294
"1173","chr7",75878848,75879441,75879144,593
"1174","chr6",41371498,41372289,41371893,791
"1175","chr2",232521904,232524451,232523177,2547
"1176","chr6",31795463,31796128,31795795,665
"1177","chr6",31815095,31817413,31816254,2318
"1178","chr11",105610399,105610695,105610547,296
"1179","chr10",94545359,94546136,94545747,777
"1180","chr22",20999958,21000215,21000086,257
"1181","chr3",194140801,194141906,194141353,1105
"1182","chr7",66901979,66902247,66902113,268
"1183","chrX",154377974,154379877,154378925,1903
"1184","chr10",93702403,93702743,93702573,340
"1185","chr20",3234050,3234281,3234165,231
"1186","chr3",71065183,71065670,71065426,487
"1187","chr10",87817724,87818530,87818127,806
"1188","chr3",41198671,41200140,41199405,1469
"1189","chr16",87413026,87413527,87413276,501
"1190","chr1",151281182,151283293,151282237,2111
"1191","chr2",238060393,238061371,238060882,978
"1192","chr19",11597462,11597868,11597665,406
"1193","chr3",133038141,133039051,133038596,910
"1194","chr16",89595391,89595635,89595513,244
"1195","chr1",15524103,15525086,15524594,983
"1196","chr6",35727948,35728379,35728163,431
"1197","chr6",33276900,33277497,33277198,597
"1198","chr3",107927623,107928094,107927858,471
"1199","chr12",11171172,11171732,11171452,560
"1200","chr2",189674300,189674807,189674553,507
"1201","chr2",84905214,84905959,84905586,745
"1202","chr17",48012270,48012485,48012377,215
"1203","chr2",133266375,133266895,133266635,520
"1204","chr19",18224262,18226565,18225413,2303
"1205","chr6",166618842,166619094,166618968,252
"1206","chr7",53035582,53036266,53035924,684
"1207","chr17",63600795,63601319,63601057,524
"1208","chr8",126556431,126558525,126557478,2094
"1209","chr17",7650821,7652020,7651420,1199
"1210","chr4",182142243,182145217,182143730,2974
"1211","chr13",42047609,42049424,42048516,1815
"1212","chr1",16966409,16966620,16966514,211
"1213","chr7",6825879,6826463,6826171,584
"1214","chr2",203238741,203239449,203239095,708
"1215","chr2",3457883,3458092,3457987,209
"1216","chr5",140345945,140346861,140346403,916
"1217","chr1",226083022,226084140,226083581,1118
"1218","chr2",238130887,238131677,238131282,790
"1219","chr8",37694426,37698659,37696542,4233
"1220","chr13",113047519,113047966,113047742,447
"1221","chr21",33229936,33230960,33230448,1024
"1222","chr5",172296738,172297107,172296922,369
"1223","chr8",64798396,64799165,64798780,769
"1224","chr1",52726351,52726756,52726553,405
"1225","chr17",76307397,76308347,76307872,950
"1226","chr16",67199129,67200123,67199626,994
"1227","chr19",3275610,3276041,3275825,431
"1228","chr6",31399699,31400139,31399919,440
"1229","chr3",9809792,9810487,9810139,695
"1230","chr16",10743727,10744339,10744033,612
"1231","chr12",53441557,53441784,53441670,227
"1232","chr16",88650581,88651049,88650815,468
"1233","chr13",40770926,40771434,40771180,508
"1234","chr2",210476457,210476812,210476634,355
"1235","chr7",23299178,23299645,23299411,467
"1236","chr5",136191368,136193290,136192329,1922
"1237","chr2",68157052,68158109,68157580,1057
"1238","chr2",174334735,174337795,174336265,3060
"1239","chr21",41953026,41954280,41953653,1254
"1240","chr17",48908226,48909175,48908700,949
"1241","chr7",99035468,99035681,99035574,213
"1242","chr10",127907124,127907973,127907548,849
"1243","chr16",4350954,4351571,4351262,617
"1244","chr2",43170901,43171137,43171019,236
"1245","chr9",5339026,5339678,5339352,652
"1246","chr7",4808620,4809573,4809096,953
"1247","chr2",199603828,199604235,199604031,407
"1248","chr1",2483759,2484067,2483913,308
"1249","chr13",98474785,98475090,98474937,305
"1250","chr2",208025457,208025670,208025563,213
"1251","chr17",38918607,38918844,38918725,237
"1252","chr10",28722124,28722524,28722324,400
"1253","chr20",54475194,54476454,54475824,1260
"1254","chr1",47996459,47997929,47997194,1470
"1255","chr17",82318331,82319957,82319144,1626
"1256","chr13",78595979,78597096,78596537,1117
"1257","chr9",133579005,133579482,133579243,477
"1258","chr12",130469081,130469284,130469182,203
"1259","chr5",144598666,144598921,144598793,255
"1260","chr1",8423329,8424279,8423804,950
"1261","chr2",62195056,62196932,62195994,1876
"1262","chr1",6071575,6071925,6071750,350
"1263","chr9",136334359,136334772,136334565,413
"1264","chr5",2564383,2564638,2564510,255
"1265","chr16",88870647,88870979,88870813,332
"1266","chr10",24722668,24724887,24723777,2219
"1267","chr2",130727576,130727887,130727731,311
"1268","chr8",9905151,9907238,9906194,2087
"1269","chr3",6861136,6861829,6861482,693
"1270","chr1",161440076,161472713,161456394,32637
"1271","chr10",132977211,132977434,132977322,223
"1272","chr6",163834418,163834648,163834533,230
"1273","chr12",117969057,117969559,117969308,502
"1274","chr3",37860447,37862548,37861497,2101
"1275","chr17",82022323,82023672,82022997,1349
"1276","chr5",102296446,102296669,102296557,223
"1277","chr12",53451884,53452094,53451989,210
"1278","chr13",43879071,43880159,43879615,1088
"1279","chr9",101485965,101487219,101486592,1254
"1280","chr15",36818160,36818577,36818368,417
"1281","chr1",6281076,6281352,6281214,276
"1282","chr2",218710725,218711357,218711041,632
"1283","chr3",48594449,48595468,48594958,1019
"1284","chr2",190534363,190535016,190534689,653
"1285","chr8",134712527,134713212,134712869,685
"1286","chr8",11867550,11868091,11867820,541
"1287","chr6",48068401,48068894,48068647,493
"1288","chr15",96354355,96354817,96354586,462
"1289","chr10",27998389,27999128,27998758,739
"1290","chr22",29311489,29311808,29311648,319
"1291","chr10",130110467,130111622,130111044,1155
"1292","chr8",142834735,142834989,142834862,254
"1293","chr20",1735684,1736007,1735845,323
"1294","chr7",127588509,127588985,127588747,476
"1295","chr2",105329777,105330316,105330046,539
"1296","chr6",139373674,139375441,139374557,1767
"1297","chr1",178542227,178543221,178542724,994
"1298","chr10",123008242,123009381,123008811,1139
"1299","chr18",48408082,48410894,48409488,2812
"1300","chr7",138867915,138868124,138868019,209
"1301","chr17",58324367,58324982,58324674,615
"1302","chr4",121932399,121933014,121932706,615
"1303","chr12",52789929,52790396,52790162,467
"1304","chr6",33271549,33272322,33271935,773
"1305","chr18",5890293,5891518,5890905,1225
"1306","chr1",228754995,228755204,228755099,209
"1307","chr1",237783887,237784148,237784017,261
"1308","chr1",112955364,112955584,112955474,220
"1309","chr12",132618282,132619970,132619126,1688
"1310","chr5",118988152,118988709,118988430,557
"1311","chr6",31899914,31900180,31900047,266
"1312","chr2",80302552,80303721,80303136,1169
"1313","chr17",81888328,81888610,81888469,282
"1314","chr2",23940469,23941008,23940738,539
"1315","chr10",101587922,101588458,101588190,536
"1316","chr12",48969881,48970312,48970096,431
"1317","chr16",569805,570346,570075,541
"1318","chr3",100225260,100225488,100225374,228
"1319","chr22",39685514,39686550,39686032,1036
"1320","chr4",183905100,183907024,183906062,1924
"1321","chr1",161098272,161099011,161098641,739
"1322","chr19",40217197,40218482,40217839,1285
"1323","chr1",59926600,59926911,59926755,311
"1324","chr15",89690299,89690852,89690575,553
"1325","chr1",98045410,98046154,98045782,744
"1326","chr12",3490887,3493842,3492364,2955
"1327","chr2",152334978,152336460,152335719,1482
"1328","chr3",164004262,164004507,164004384,245
"1329","chr6",36959152,36959486,36959319,334
"1330","chr5",151924665,151925263,151924964,598
"1331","chr10",3118696,3118915,3118805,219
"1332","chr12",53944977,53945384,53945180,407
"1333","chr17",80347661,80348187,80347924,526
"1334","chr17",21592840,21593064,21592952,224
"1335","chr5",2008073,2008314,2008193,241
"1336","chr22",30591618,30592397,30592007,779
"1337","chr1",8317724,8318275,8317999,551
"1338","chr5",181234182,181234555,181234368,373
"1339","chr17",69326568,69327696,69327132,1128
"1340","chr13",113363551,113365370,113364460,1819
"1341","chr12",10212770,10213466,10213118,696
"1342","chr10",2501271,2501929,2501600,658
"1343","chr1",12230898,12231142,12231020,244
"1344","chr7",135170223,135170944,135170583,721
"1345","chr12",31073409,31074252,31073830,843
"1346","chr2",235535171,235535381,235535276,210
"1347","chr15",49155142,49155870,49155506,728
"1348","chr12",113471082,113472876,113471979,1794
"1349","chr13",48318499,48319721,48319110,1222
"1350","chr8",109975628,109975843,109975735,215
"1351","chr17",50199516,50201370,50200443,1854
"1352","chr11",31815870,31818265,31817067,2395
"1353","chr3",134650622,134651174,134650898,552
"1354","chr1",1419779,1420620,1420199,841
"1355","chr17",51153325,51153886,51153605,561
"1356","chr4",3291987,3293607,3292797,1620
"1357","chr3",197749391,197750585,197749988,1194
"1358","chr5",140400738,140402523,140401630,1785
"1359","chr1",44674098,44674912,44674505,814
"1360","chr2",17878226,17879653,17878939,1427
"1361","chr12",67648386,67650096,67649241,1710
"1362","chr1",214605565,214606366,214605965,801
"1363","chr15",51971371,51972028,51971699,657
"1364","chr5",142324184,142325458,142324821,1274
"1365","chr8",66925245,66925719,66925482,474
"1366","chr12",55927629,55927844,55927736,215
"1367","chrX",24054400,24055018,24054709,618
"1368","chr6",29649988,29650197,29650092,209
"1369","chr1",42738444,42738652,42738548,208
"1370","chr4",139176097,139178682,139177389,2585
"1371","chr9",97982700,97985486,97984093,2786
"1372","chr4",186298166,186298591,186298378,425
"1373","chr19",14529067,14530228,14529647,1161
"1374","chr14",49620237,49621543,49620890,1306
"1375","chr8",143835842,143836148,143835995,306
"1376","chr12",50166943,50167603,50167273,660
"1377","chr3",23810496,23811017,23810756,521
"1378","chr17",75940800,75941336,75941068,536
"1379","chr5",168579093,168579913,168579503,820
"1380","chr16",5071748,5072191,5071969,443
"1381","chr11",44303325,44303537,44303431,212
"1382","chr1",170664161,170665037,170664599,876
"1383","chrY",23198348,23198730,23198539,382
"1384","chr17",7403887,7405756,7404821,1869
"1385","chr3",67654204,67654582,67654393,378
"1386","chr1",155688041,155689334,155688687,1293
"1387","chr10",46030173,46030750,46030461,577
"1388","chr5",179820784,179821711,179821247,927
"1389","chr6",170159412,170160675,170160043,1263
"1390","chr17",39461278,39461792,39461535,514
"1391","chr1",84620638,84621093,84620865,455
"1392","chr15",36579258,36579696,36579477,438
"1393","chr1",1222937,1223222,1223079,285
"1394","chr8",30911748,30912606,30912177,858
"1395","chr17",44385380,44386211,44385795,831
"1396","chr22",50306986,50307693,50307339,707
"1397","chr3",99817769,99818179,99817974,410
"1398","chr1",23019321,23020184,23019752,863
"1399","chr12",57693748,57694246,57693997,498
"1400","chr14",69483742,69485199,69484470,1457
"1401","chr22",23388095,23388350,23388222,255
"1402","chr1",1723956,1724792,1724374,836
"1403","chr15",99565163,99566860,99566011,1697
"1404","chr19",48899965,48900361,48900163,396
"1405","chr7",124929828,124930145,124929986,317
"1406","chr6",32879721,32880069,32879895,348
"1407","chr12",131560560,131560839,131560699,279
"1408","chr6",126339989,126340241,126340115,252
"1409","chr1",100895032,100895276,100895154,244
"1410","chr3",39406399,39407153,39406776,754
"1411","chr17",41527656,41528347,41528001,691
"1412","chr2",227871514,227871828,227871671,314
"1413","chr8",54453620,54455068,54454344,1448
"1414","chr5",1056206,1056471,1056338,265
"1415","chr1",228315855,228317061,228316458,1206
"1416","chr4",157220252,157220684,157220468,432
"1417","chr2",212831625,212833326,212832475,1701
"1418","chr1",231420935,231422701,231421818,1766
"1419","chr15",51093664,51095006,51094335,1342
"1420","chrY",20575939,20576166,20576052,227
"1421","chr8",144598106,144598312,144598209,206
"1422","chr12",113334828,113335129,113334978,301
"1423","chr2",53786664,53787361,53787012,697
"1424","chr15",67521032,67521843,67521437,811
"1425","chr1",214383822,214384099,214383960,277
"1426","chr12",20369228,20370188,20369708,960
"1427","chr15",67884783,67885077,67884930,294
"1428","chr2",96508114,96508748,96508431,634
"1429","chr1",3434801,3435068,3434934,267
"1430","chr3",142596483,142596725,142596604,242
"1431","chr16",85709879,85710472,85710175,593
"1432","chr2",64653185,64654734,64653959,1549
"1433","chr5",139696957,139697594,139697275,637
"1434","chr1",52552586,52553927,52553256,1341
"1435","chr3",184174667,184175396,184175031,729
"1436","chr16",3263946,3264789,3264367,843
"1437","chr10",120851166,120851540,120851353,374
"1438","chr10",101222545,101230435,101226490,7890
"1439","chr1",89632671,89633733,89633202,1062
"1440","chr11",102109901,102111599,102110750,1698
"1441","chr16",88103639,88103992,88103815,353
"1442","chr17",32927856,32928505,32928180,649
"1443","chr2",113627012,113627556,113627284,544
"1444","chr5",127229305,127229888,127229596,583
"1445","chr7",4745189,4745427,4745308,238
"1446","chr17",7280705,7282368,7281536,1663
"1447","chr1",27635048,27635299,27635173,251
"1448","chr1",112618969,112619949,112619459,980
"1449","chr8",143868743,143869031,143868887,288
"1450","chr1",18630401,18633335,18631868,2934
"1451","chr8",7354965,7355368,7355166,403
"1452","chr21",28992644,28993021,28992832,377
"1453","chr16",3716976,3717934,3717455,958
"1454","chr9",108855040,108855864,108855452,824
"1455","chr6",26595818,26596093,26595955,275
"1456","chr12",48818023,48818859,48818441,836
"1457","chr1",113072969,113073638,113073303,669
"1458","chr8",144416531,144416734,144416632,203
"1459","chr3",194685711,194688316,194687013,2605
"1460","chr1",115837738,115839743,115838740,2005
"1461","chr3",48918377,48919505,48918941,1128
"1462","chr2",37231255,37232056,37231655,801
"1463","chr3",120908033,120908719,120908376,686
"1464","chr1",52632957,52633631,52633294,674
"1465","chr4",129093194,129093744,129093469,550
"1466","chr11",125625338,125625971,125625654,633
"1467","chr3",119034245,119035114,119034679,869
"1468","chr18",11908223,11909083,11908653,860
"1469","chr17",80475707,80478983,80477345,3276
"1470","chr1",186374992,186375716,186375354,724
"1471","chr17",1471922,1472166,1472044,244
"1472","chr7",99465800,99466001,99465900,201
"1473","chr15",40569212,40569916,40569564,704
"1474","chr1",26500185,26501489,26500837,1304
"1475","chr12",109900175,109900786,109900480,611
"1476","chr12",62801877,62802129,62802003,252
"1477","chr1",160419313,160419596,160419454,283
"1478","chr6",25726226,25726494,25726360,268
"1479","chr17",7884961,7885773,7885367,812
"1480","chr12",131004151,131004430,131004290,279
"1481","chr1",101236889,101237189,101237039,300
"1482","chr1",43171832,43172381,43172106,549
"1483","chr13",73058722,73060232,73059477,1510
"1484","chr8",544155,546083,545119,1928
"1485","chr6",125759188,125759637,125759412,449
"1486","chr5",159331466,159331831,159331648,365
"1487","chr18",75087687,75087991,75087839,304
"1488","chr17",1934293,1934565,1934429,272
"1489","chr10",112183525,112183899,112183712,374
"1490","chr2",120654407,120654739,120654573,332
"1491","chr12",48527991,48528346,48528168,355
"1492","chr2",148644102,148645929,148645015,1827
"1493","chr12",45050419,45051603,45051011,1184
"1494","chr6",33007907,33008149,33008028,242
"1495","chr1",26889670,26890554,26890112,884
"1496","chr1",241639881,241640159,241640020,278
"1497","chr3",15427425,15427925,15427675,500
"1498","chr15",30626109,30626362,30626235,253
"1499","chr1",204190470,204190705,204190587,235
"1500","chr4",154416744,154417101,154416922,357
"1501","chr5",43120824,43121903,43121363,1079
"1502","chr6",150865760,150866976,150866368,1216
"1503","chr19",1241620,1242570,1242095,950
"1504","chr1",7704113,7705796,7704954,1683
"1505","chr2",70964964,70965365,70965164,401
"1506","chr2",230990522,230991242,230990882,720
"1507","chr2",46542332,46543649,46542990,1317
"1508","chr10",10266195,10266626,10266410,431
"1509","chr3",33798504,33799179,33798841,675
"1510","chr18",906256,909573,907914,3317
"1511","chr5",68215044,68216558,68215801,1514
"1512","chr2",1937296,1937788,1937542,492
"1513","chr6",90611058,90611500,90611279,442
"1514","chr3",184170027,184170690,184170358,663
"1515","chr7",135211262,135211912,135211587,650
"1516","chr10",23199098,23199614,23199356,516
"1517","chr15",63600590,63601712,63601151,1122
"1518","chr2",36357357,36357839,36357598,482
"1519","chr2",120867415,120867634,120867524,219
"1520","chr1",201023154,201023871,201023512,717
"1521","chr3",132035036,132035295,132035165,259
"1522","chr13",94710898,94713797,94712347,2899
"1523","chr5",123511967,123512914,123512440,947
"1524","chr9",104968219,104968586,104968402,367
"1525","chr1",3358465,3358720,3358592,255
"1526","chr5",25190394,25191004,25190699,610
"1527","chr1",42035184,42036309,42035746,1125
"1528","chr8",48556123,48556435,48556279,312
"1529","chr1",16217188,16217812,16217500,624
"1530","chr1",40316548,40317473,40317010,925
"1531","chr5",150700569,150701141,150700855,572
"1532","chr5",80487816,80488326,80488071,510
"1533","chr16",24255719,24256299,24256009,580
"1534","chr16",2471085,2475928,2473506,4843
"1535","chr4",188796611,188797267,188796939,656
"1536","chr4",103019511,103019794,103019652,283
"1537","chr1",33306545,33307174,33306859,629
"1538","chr5",140786373,140786629,140786501,256
"1539","chr1",13892855,13893242,13893048,387
"1540","chr1",5991535,5993346,5992440,1811
"1541","chr1",45622522,45623470,45622996,948
"1542","chr14",22980677,22982965,22981821,2288
"1543","chr6",17987221,17988174,17987697,953
"1544","chr4",169620100,169620659,169620379,559
"1545","chr7",3300722,3302101,3301411,1379
"1546","chr8",98825233,98825903,98825568,670
"1547","chr5",141681847,141682219,141682033,372
"1548","chr1",232950445,232950849,232950647,404
"1549","chr8",902176,903109,902642,933
"1550","chr1",44417464,44418232,44417848,768
"1551","chr3",57556204,57557517,57556860,1313
"1552","chr13",33015790,33017290,33016540,1500
"1553","chr9",130433206,130434061,130433633,855
"1554","chr1",91404319,91404833,91404576,514
"1555","chr6",2634138,2634711,2634424,573
"1556","chr16",1626041,1626296,1626168,255
"1557","chr2",91477061,91479459,91478260,2398
"1558","chr6",166166485,166169935,166168210,3450
"1559","chr15",82750270,82750840,82750555,570
"1560","chr4",173509235,173509710,173509472,475
"1561","chr4",1235461,1235747,1235604,286
"1562","chr13",43785898,43787560,43786729,1662
"1563","chrX",80574595,80575040,80574817,445
"1564","chr5",139517875,139518390,139518132,515
"1565","chr10",68956182,68956738,68956460,556
"1566","chr6",34035774,34036450,34036112,676
"1567","chr17",31549615,31550508,31550061,893
"1568","chr20",48384939,48385227,48385083,288
"1569","chr13",112994612,112995287,112994949,675
"1570","chr2",97589657,97590761,97590209,1104
"1571","chr6",44256961,44257749,44257355,788
"1572","chr22",38700368,38701749,38701058,1381
"1573","chr6",44151789,44152044,44151916,255
"1574","chr6",148342289,148343079,148342684,790
"1575","chr7",41705580,41705864,41705722,284
"1576","chr20",62142542,62144611,62143576,2069
"1577","chr7",2278603,2279444,2279023,841
"1578","chr20",38723487,38728729,38726108,5242
"1579","chr1",119327603,119327912,119327757,309
"1580","chr4",125314740,125317775,125316257,3035
"1581","chr8",23006811,23007075,23006943,264
"1582","chr14",64338391,64339067,64338729,676
"1583","chr3",120306568,120307394,120306981,826
"1584","chr2",10447701,10449029,10448365,1328
"1585","chr3",170654022,170654294,170654158,272
"1586","chr16",87614480,87615082,87614781,602
"1587","chr13",98176309,98177131,98176720,822
"1588","chr10",89701142,89701858,89701500,716
"1589","chr3",141875644,141877446,141876545,1802
"1590","chr6",31739712,31740559,31740135,847
"1591","chr4",88283800,88284917,88284358,1117
"1592","chrX",153934499,153935471,153934985,972
"1593","chr5",53109439,53109937,53109688,498
"1594","chr19",12774942,12775705,12775323,763
"1595","chr16",86555598,86555907,86555752,309
"1596","chrX",19515209,19515643,19515426,434
"1597","chr1",56477555,56477997,56477776,442
"1598","chr17",48607882,48608087,48607984,205
"1599","chr9",34380891,34381153,34381022,262
"1600","chr17",7260966,7262926,7261946,1960
"1601","chrX",78139334,78139795,78139564,461
"1602","chrX",91778994,91779624,91779309,630
"1603","chr13",112066250,112069268,112067759,3018
"1604","chr17",17722291,17725186,17723738,2895
"1605","chr19",1265855,1269944,1267899,4089
"1606","chr1",3611055,3611514,3611284,459
"1607","chr1",247937023,247937424,247937223,401
"1608","chr6",149456505,149457053,149456779,548
"1609","chr1",38578493,38578861,38578677,368
"1610","chr16",87550753,87551104,87550928,351
"1611","chr16",88856263,88857568,88856915,1305
"1612","chr7",98171468,98171718,98171593,250
"1613","chr7",2241727,2242470,2242098,743
"1614","chr10",124418249,124419293,124418771,1044
"1615","chr6",122610008,122610560,122610284,552
"1616","chr2",29919965,29921684,29920824,1719
"1617","chr2",222311774,222312796,222312285,1022
"1618","chr7",4861705,4862122,4861913,417
"1619","chr15",52783990,52785729,52784859,1739
"1620","chr1",115976525,115976916,115976720,391
"1621","chr14",73633639,73634527,73634083,888
"1622","chr2",178480125,178481030,178480577,905
"1623","chr1",154272234,154272813,154272523,579
"1624","chr10",112949890,112950323,112950106,433
"1625","chr2",178072868,178073180,178073024,312
"1626","chrX",2928154,2929470,2928812,1316
"1627","chr6",116461904,116462515,116462209,611
"1628","chr15",43826876,43827079,43826977,203
"1629","chr8",8701621,8703357,8702489,1736
"1630","chr3",196941824,196943183,196942503,1359
"1631","chr16",70523186,70523583,70523384,397
"1632","chr3",177196449,177198066,177197257,1617
"1633","chr3",72738921,72739265,72739093,344
"1634","chr7",42911617,42912306,42911961,689
"1635","chr5",175478515,175479062,175478788,547
"1636","chr2",9843134,9843772,9843453,638
"1637","chr17",28381206,28381786,28381496,580
"1638","chr2",218659178,218659854,218659516,676
"1639","chr5",65562948,65563456,65563202,508
"1640","chr16",72787241,72787693,72787467,452
"1641","chr2",136423491,136423731,136423611,240
"1642","chr13",30465450,30466079,30465764,629
"1643","chr3",51671046,51672006,51671526,960
"1644","chr5",177599714,177600518,177600116,804
"1645","chr10",1699230,1701931,1700580,2701
"1646","chr15",74175272,74175551,74175411,279
"1647","chr1",230356970,230357199,230357084,229
"1648","chr5",141512694,141513622,141513158,928
"1649","chr13",97432966,97434865,97433915,1899
"1650","chr5",128965107,128965636,128965371,529
"1651","chr7",1713810,1714070,1713940,260
"1652","chr2",172108076,172108514,172108295,438
"1653","chr2",132256372,132258167,132257269,1795
"1654","chr7",127251246,127254151,127252698,2905
"1655","chr5",38257782,38259034,38258408,1252
"1656","chr3",49673535,49674846,49674190,1311
"1657","chr5",172284368,172284579,172284473,211
"1658","chr1",110407270,110407918,110407594,648
"1659","chr13",28659011,28659376,28659193,365
"1660","chr6",167295325,167295783,167295554,458
"1661","chr20",36862598,36864402,36863500,1804
"1662","chr3",58008111,58008977,58008544,866
"1663","chr15",58748882,58750084,58749483,1202
"1664","chr15",37110841,37111066,37110953,225
"1665","chr15",79282488,79282869,79282678,381
"1666","chr22",18149969,18150231,18150100,262
"1667","chr9",137416442,137418005,137417223,1563
"1668","chr5",464772,465551,465161,779
"1669","chr2",238453069,238453316,238453192,247
"1670","chr1",89994840,89995678,89995259,838
"1671","chr5",159916329,159916865,159916597,536
"1672","chr10",61452737,61453251,61452994,514
"1673","chr6",145734760,145735845,145735302,1085
"1674","chr5",848274,848655,848464,381
"1675","chr21",17512488,17513793,17513140,1305
"1676","chr5",37248918,37249681,37249299,763
"1677","chr4",1799394,1799600,1799497,206
"1678","chr22",46626560,46626762,46626661,202
"1679","chr8",130443002,130444039,130443520,1037
"1680","chr6",887605,887908,887756,303
"1681","chr5",151758431,151758857,151758644,426
"1682","chr9",114397859,114398784,114398321,925
"1683","chr3",8767275,8769594,8768434,2319
"1684","chr11",46380318,46382523,46381420,2205
"1685","chr5",140547572,140547906,140547739,334
"1686","chr12",53180241,53181366,53180803,1125
"1687","chr7",1968167,1968633,1968400,466
"1688","chr8",123273969,123275426,123274697,1457
"1689","chr2",5695936,5697511,5696723,1575
"1690","chr16",55479317,55479614,55479465,297
"1691","chr11",114036198,114036610,114036404,412
"1692","chr1",1626669,1634630,1630649,7961
"1693","chr15",25438248,25439268,25438758,1020
"1694","chr14",91233737,91234894,91234315,1157
"1695","chr16",1548951,1549156,1549053,205
"1696","chr8",48514514,48514856,48514685,342
"1697","chr5",154937888,154938370,154938129,482
"1698","chrX",48676202,48676858,48676530,656
"1699","chr2",3180416,3181342,3180879,926
"1700","chr5",135398406,135399571,135398988,1165
"1701","chr1",228037741,228038308,228038024,567
"1702","chr12",131808898,131809271,131809084,373
"1703","chr5",140113138,140113381,140113259,243
"1704","chr9",33263783,33265120,33264451,1337
"1705","chr19",2811640,2811870,2811755,230
"1706","chr12",6606334,6607624,6606979,1290
"1707","chr12",53965874,53966122,53965998,248
"1708","chr16",29987465,29987685,29987575,220
"1709","chr19",1439952,1440424,1440188,472
"1710","chr15",78830625,78832208,78831416,1583
"1711","chr2",186485770,186486882,186486326,1112
"1712","chr12",57475292,57476399,57475845,1107
"1713","chr17",21415338,21416729,21416033,1391
"1714","chr2",39778950,39779323,39779136,373
"1715","chr22",42856647,42857661,42857154,1014
"1716","chr15",44711262,44712147,44711704,885
"1717","chr6",27831212,27831649,27831430,437
"1718","chr8",47260199,47260401,47260300,202
"1719","chr16",72019,72875,72447,856
"1720","chr11",6234538,6234892,6234715,354
"1721","chr11",86244343,86244548,86244445,205
"1722","chr20",62937457,62938564,62938010,1107
"1723","chr7",4114013,4114266,4114139,253
"1724","chr2",241987842,241988101,241987971,259
"1725","chr17",35373970,35374638,35374304,668
"1726","chr5",177426021,177427124,177426572,1103
"1727","chr17",61409366,61413124,61411245,3758
"1728","chr22",43812067,43812555,43812311,488
"1729","chr10",21173199,21174879,21174039,1680
"1730","chr8",116938233,116938720,116938476,487
"1731","chr3",45688252,45688541,45688396,289
"1732","chr4",183504109,183506475,183505292,2366
"1733","chr2",86861693,86862040,86861866,347
"1734","chr5",1155124,1156351,1155737,1227
"1735","chr22",50730599,50731304,50730951,705
"1736","chr14",69259533,69261676,69260604,2143
"1737","chr5",179559512,179559998,179559755,486
"1738","chr3",127135263,127136005,127135634,742
"1739","chr1",243489111,243489461,243489286,350
"1740","chr19",36121440,36122030,36121735,590
"1741","chr7",35036524,35038196,35037360,1672
"1742","chr3",161371838,161372861,161372349,1023
"1743","chr1",227973667,227973875,227973771,208
"1744","chr17",50129299,50130237,50129768,938
"1745","chr17",80215004,80215211,80215107,207
"1746","chr2",106342659,106343070,106342864,411
"1747","chr10",697300,697539,697419,239
"1748","chr6",160362634,160363103,160362868,469
"1749","chr18",79626827,79627050,79626938,223
"1750","chr2",221571010,221574221,221572615,3211
"1751","chr5",73625768,73626702,73626235,934
"1752","chr6",83067552,83067982,83067767,430
"1753","chr5",116576305,116576688,116576496,383
"1754","chr1",240492874,240493420,240493147,546
"1755","chr2",24174776,24175325,24175050,549
"1756","chr3",129278539,129279460,129278999,921
"1757","chr6",22569355,22570476,22569915,1121
"1758","chr2",43068074,43068502,43068288,428
"1759","chr12",3076845,3077802,3077323,957
"1760","chr17",50634689,50635344,50635016,655
"1761","chr5",180389662,180390005,180389833,343
"1762","chr6",169222202,169222425,169222313,223
"1763","chr1",93447912,93448967,93448439,1055
"1764","chr2",218981569,218982415,218981992,846
"1765","chr12",6555259,6556135,6555697,876
"1766","chr1",1162663,1165204,1163933,2541
"1767","chr3",171809827,171810668,171810247,841
"1768","chr3",52487658,52488596,52488127,938
"1769","chr7",99438476,99439269,99438872,793
"1770","chr2",61538271,61538956,61538613,685
"1771","chr1",32335258,32336628,32335943,1370
"1772","chr21",44972149,44972433,44972291,284
"1773","chr7",105301305,105301531,105301418,226
"1774","chr4",153788360,153789675,153789017,1315
"1775","chr3",43994915,43999612,43997263,4697
"1776","chr4",54064074,54064912,54064493,838
"1777","chr2",199468964,199469449,199469206,485
"1778","chr22",29030522,29030855,29030688,333
"1779","chr16",1509964,1510193,1510078,229
"1780","chr20",46030301,46030604,46030452,303
"1781","chr22",50529354,50532339,50530846,2985
"1782","chr17",53757289,53757539,53757414,250
"1783","chr10",75395370,75409842,75402606,14472
"1784","chr6",136549688,136551007,136550347,1319
"1785","chr6",29942425,29943590,29943007,1165
"1786","chr6",101393549,101394029,101393789,480
"1787","chr10",30058670,30059719,30059194,1049
"1788","chr2",174340115,174342825,174341470,2710
"1789","chr6",39934113,39934560,39934336,447
"1790","chr11",65646307,65647732,65647019,1425
"1791","chr2",197515699,197516577,197516138,878
"1792","chr10",77636337,77638737,77637537,2400
"1793","chr15",65029093,65029658,65029375,565
"1794","chr12",32679196,32680044,32679620,848
"1795","chr6",110399856,110400427,110400141,571
"1796","chr13",111956344,111957119,111956731,775
"1797","chr1",157137957,157138853,157138405,896
"1798","chr7",4783875,4784466,4784170,591
"1799","chr8",143593818,143594037,143593927,219
"1800","chr16",86531751,86532255,86532003,504
"1801","chr8",139731956,139732255,139732105,299
"1802","chr19",35533280,35533901,35533590,621
"1803","chr1",89524251,89525427,89524839,1176
"1804","chr22",37018278,37020008,37019143,1730
"1805","chr21",42305765,42306206,42305985,441
"1806","chr8",143840572,143841636,143841104,1064
"1807","chr12",132361740,132362649,132362194,909
"1808","chr17",4536005,4536410,4536207,405
"1809","chr16",50547564,50549554,50548559,1990
"1810","chr22",50600065,50601323,50600694,1258
"1811","chr15",50908061,50909073,50908567,1012
"1812","chr5",146877783,146879012,146878397,1229
"1813","chr7",178517,179127,178822,610
"1814","chr12",108730861,108732188,108731524,1327
"1815","chr3",69013008,69014039,69013523,1031
"1816","chr1",160098913,160099212,160099062,299
"1817","chr6",170288158,170288411,170288284,253
"1818","chr12",123937034,123937616,123937325,582
"1819","chr6",43283933,43284280,43284106,347
"1820","chr13",36345600,36346867,36346233,1267
"1821","chr5",194972,195208,195090,236
"1822","chr6",41028063,41028502,41028282,439
"1823","chr5",126600830,126601408,126601119,578
"1824","chr7",92447385,92447777,92447581,392
"1825","chr8",93700138,93701117,93700627,979
"1826","chr10",86389509,86389981,86389745,472
"1827","chr8",141760551,141760796,141760673,245
"1828","chr2",68655210,68655442,68655326,232
"1829","chr3",14810712,14811587,14811149,875
"1830","chr11",36376403,36377848,36377125,1445
"1831","chr21",41740756,41741788,41741272,1032
"1832","chr1",11648710,11649220,11648965,510
"1833","chr2",8645329,8645538,8645433,209
"1834","chr8",140097738,140100885,140099311,3147
"1835","chr2",217756556,217756775,217756665,219
"1836","chr7",2014425,2014751,2014588,326
"1837","chr5",1856659,1858330,1857494,1671
"1838","chr8",73746218,73747593,73746905,1375
"1839","chr17",3048683,3049079,3048881,396
"1840","chr11",14904925,14906224,14905574,1299
"1841","chr3",152268538,152269536,152269037,998
"1842","chr12",112938380,112938688,112938534,308
"1843","chr7",85185523,85186926,85186224,1403
"1844","chr1",207868517,207869373,207868945,856
"1845","chr7",155456855,155459260,155458057,2405
"1846","chr17",28405794,28406378,28406086,584
"1847","chr17",3866369,3866580,3866474,211
"1848","chr1",211577779,211579835,211578807,2056
"1849","chr1",182839177,182839987,182839582,810
"1850","chr3",12875892,12876517,12876204,625
"1851","chr15",75480463,75480823,75480643,360
"1852","chr12",55830002,55830528,55830265,526
"1853","chr1",1206290,1206770,1206530,480
"1854","chr1",1307020,1309805,1308412,2785
"1855","chr7",158586636,158588529,158587582,1893
"1856","chr16",3611119,3611774,3611446,655
"1857","chr16",88839101,88839342,88839221,241
"1858","chr19",3907691,3908400,3908045,709
"1859","chr2",205684875,205686592,205685733,1717
"1860","chr19",51031962,51032219,51032090,257
"1861","chr6",32154052,32154752,32154402,700
"1862","chr10",102869281,102869722,102869501,441
"1863","chr16",588545,590705,589625,2160
"1864","chr4",6986578,6987646,6987112,1068
"1865","chr10",125158655,125162758,125160706,4103
"1866","chr16",2762265,2762573,2762419,308
"1867","chr5",5303150,5303376,5303263,226
"1868","chr2",70994406,70995169,70994787,763
"1869","chr4",75672451,75673736,75673093,1285
"1870","chr2",48530072,48530646,48530359,574
"1871","chr5",7868750,7869727,7869238,977
"1872","chr7",74606475,74606792,74606633,317
"1873","chr1",17053961,17054227,17054094,266
"1874","chr3",125141710,125142175,125141942,465
"1875","chr7",33108995,33109705,33109350,710
"1876","chr2",130181267,130182773,130182020,1506
"1877","chr4",180057885,180059466,180058675,1581
"1878","chr6",100447897,100448186,100448041,289
"1879","chr6",35920607,35921283,35920945,676
"1880","chr1",33625005,33625254,33625129,249
"1881","chr7",22665204,22665802,22665503,598
"1882","chr1",9039221,9040454,9039837,1233
"1883","chr1",3390505,3390721,3390613,216
"1884","chr16",510061,510281,510171,220
"1885","chr6",156719849,156720204,156720026,355
"1886","chr1",8330142,8330740,8330441,598
"1887","chr12",63668056,63669303,63668679,1247
"1888","chr16",3939005,3939347,3939176,342
"1889","chr19",4831421,4831880,4831650,459
"1890","chr1",6466114,6466361,6466237,247
"1891","chr6",33288762,33289196,33288979,434
"1892","chr16",51134355,51135199,51134777,844
"1893","chr6",52361955,52363208,52362581,1253
"1894","chr8",41646397,41646747,41646572,350
"1895","chr12",117190266,117190683,117190474,417
"1896","chr17",37609037,37609709,37609373,672
"1897","chr10",102132902,102133833,102133367,931
"1898","chr6",16759947,16762754,16761350,2807
"1899","chr1",212699118,212700706,212699912,1588
"1900","chr3",137764122,137765612,137764867,1490
"1901","chr2",27123512,27123898,27123705,386
"1902","chr1",90719599,90720020,90719809,421
"1903","chr7",127585146,127585896,127585521,750
"1904","chr1",1511498,1512825,1512161,1327
"1905","chr4",2535371,2537694,2536532,2323
"1906","chr3",72655172,72655459,72655315,287
"1907","chr6",112362557,112362777,112362667,220
"1908","chr3",129045697,129047212,129046454,1515
"1909","chr10",119029277,119030869,119030073,1592
"1910","chr15",29269290,29269939,29269614,649
"1911","chr6",167173866,167174071,167173968,205
"1912","chr16",12568505,12568820,12568662,315
"1913","chr3",12935466,12936682,12936074,1216
"1914","chr12",51915250,51915553,51915401,303
"1915","chr7",116210316,116210974,116210645,658
"1916","chr4",88007328,88008507,88007917,1179
"1917","chr16",78045855,78046269,78046062,414
"1918","chr2",113502518,113504217,113503367,1699
"1919","chr2",96305387,96305818,96305602,431
"1920","chr17",38747618,38750075,38748846,2457
"1921","chr2",115161160,115163189,115162174,2029
"1922","chr22",26541030,26541537,26541283,507
"1923","chr2",97995270,97996481,97995875,1211
"1924","chr16",57284055,57285052,57284553,997
"1925","chr15",89088315,89088978,89088646,663
"1926","chr12",132029738,132029980,132029859,242
"1927","chr5",135032888,135034242,135033565,1354
"1928","chr5",135834582,135835467,135835024,885
"1929","chr3",160754522,160756699,160755610,2177
"1930","chr1",156499825,156501268,156500546,1443
"1931","chr15",51681336,51681641,51681488,305
"1932","chr5",217921,219013,218467,1092
"1933","chr13",51803685,51804437,51804061,752
"1934","chr2",232605936,232606367,232606151,431
"1935","chr5",150625108,150625422,150625265,314
"1936","chr6",29748691,29749381,29749036,690
"1937","chr3",158097792,158098184,158097988,392
"1938","chr1",2344919,2345218,2345068,299
"1939","chr5",181183053,181183263,181183158,210
"1940","chr11",57499533,57499843,57499688,310
"1941","chr9",98985594,98985801,98985697,207
"1942","chr5",55231491,55231932,55231711,441
"1943","chr12",62190987,62192487,62191737,1500
"1944","chr6",170478661,170478897,170478779,236
"1945","chr5",1930640,1931872,1931256,1232
"1946","chr15",64774717,64776153,64775435,1436
"1947","chr1",66533045,66533377,66533211,332
"1948","chr1",222644125,222644329,222644227,204
"1949","chr13",106493060,106493439,106493249,379
"1950","chr1",155950860,155951107,155950983,247
"1951","chr5",7849832,7851300,7850566,1468
"1952","chr8",11702087,11705447,11703767,3360
"1953","chr1",43272813,43273158,43272985,345
"1954","chr8",100105694,100106465,100106079,771
"1955","chr12",132563718,132564048,132563883,330
"1956","chr3",22372001,22372874,22372437,873
"1957","chr7",157039984,157040267,157040125,283
"1958","chr19",32345447,32345934,32345690,487
"1959","chr2",240915957,240916214,240916085,257
"1960","chr12",110846913,110847217,110847065,304
"1961","chr15",27770200,27770649,27770424,449
"1962","chr12",107760617,107761360,107760988,743
"1963","chr6",33192214,33192555,33192384,341
"1964","chr1",225999102,225999635,225999368,533
"1965","chr22",50010138,50011092,50010615,954
"1966","chr4",26860409,26861616,26861012,1207
"1967","chr10",133186016,133186327,133186171,311
"1968","chr1",2327625,2327887,2327756,262
"1969","chr14",65101736,65103291,65102513,1555
"1970","chr10",42753075,42755464,42754269,2389
"1971","chr15",66497595,66497910,66497752,315
"1972","chr16",71625926,71626844,71626385,918
"1973","chr3",43621677,43622414,43622045,737
"1974","chr3",69541860,69542899,69542379,1039
"1975","chr1",203486687,203486913,203486800,226
"1976","chr6",30720847,30721753,30721300,906
"1977","chr19",57411072,57411698,57411385,626
"1978","chr3",38136511,38137259,38136885,748
"1979","chr6",41408852,41409429,41409140,577
"1980","chr8",1101641,1101896,1101768,255
"1981","chr1",167937204,167937563,167937383,359
"1982","chr3",195725133,195725774,195725453,641
"1983","chr1",182615042,182615410,182615226,368
"1984","chr3",151085209,151087381,151086295,2172
"1985","chr12",118135925,118136926,118136425,1001
"1986","chr1",42766543,42767688,42767115,1145
"1987","chr3",40387105,40387524,40387314,419
"1988","chr16",87720402,87720679,87720540,277
"1989","chr3",120450355,120451672,120451013,1317
"1990","chr17",40863135,40863849,40863492,714
"1991","chr7",23680748,23681058,23680903,310
"1992","chr10",122374479,122375417,122374948,938
"1993","chr15",40594198,40594720,40594459,522
"1994","chr9",98707297,98709872,98708584,2575
"1995","chr2",127106066,127107712,127106889,1646
"1996","chr4",142845787,142847260,142846523,1473
"1997","chr17",72120133,72124301,72122217,4168
"1998","chr8",123768046,123769025,123768535,979
"1999","chr2",151289355,151289805,151289580,450
"2000","chr7",157279108,157280151,157279629,1043
"2001","chr16",27549688,27550239,27549963,551
"2002","chr12",51391503,51392037,51391770,534
"2003","chr20",47951047,47951423,47951235,376
"2004","chr13",49495886,49496583,49496234,697
"2005","chr7",127651593,127652497,127652045,904
"2006","chr21",46097737,46099085,46098411,1348
"2007","chr10",28532260,28534163,28533211,1903
"2008","chr1",94926281,94927560,94926920,1279
"2009","chr6",122399462,122400221,122399841,759
"2010","chr21",46429135,46429476,46429305,341
"2011","chr6",46129957,46130216,46130086,259
"2012","chr7",151303614,151303956,151303785,342
"2013","chr1",33127290,33127554,33127422,264
"2014","chr16",667931,669064,668497,1133
"2015","chr12",117039005,117039301,117039153,296
"2016","chr12",49955296,49955742,49955519,446
"2017","chr18",2846567,2848177,2847372,1610
"2018","chr1",112714263,112715438,112714850,1175
"2019","chr17",15749220,15749824,15749522,604
"2020","chr16",85948046,85948359,85948202,313
"2021","chr1",35707805,35708378,35708091,573
"2022","chr13",112342878,112343403,112343140,525
"2023","chr1",2322284,2323319,2322801,1035
"2024","chr8",27287614,27288084,27287849,470
"2025","chr22",30505255,30505757,30505506,502
"2026","chr15",44288606,44289345,44288975,739
"2027","chr12",114692203,114692437,114692320,234
"2028","chr9",137218177,137218497,137218337,320
"2029","chr3",122912875,122914007,122913441,1132
"2030","chr1",54781069,54781846,54781457,777
"2031","chr8",30095119,30096068,30095593,949
"2032","chr10",6201012,6204494,6202753,3482
"2033","chr7",123557606,123557871,123557738,265
"2034","chr1",204411185,204412031,204411608,846
"2035","chr12",106986780,106987298,106987039,518
"2036","chr3",51941596,51942489,51942042,893
"2037","chr1",47508037,47508680,47508358,643
"2038","chr12",71662988,71664007,71663497,1019
"2039","chr16",66880264,66880879,66880571,615
"2040","chr1",203861379,203861773,203861576,394
"2041","chr22",50582582,50583405,50582993,823
"2042","chr10",124742745,124744451,124743598,1706
"2043","chr5",131945214,131945747,131945480,533
"2044","chr6",163671829,163672081,163671955,252
"2045","chr4",25376852,25377653,25377252,801
"2046","chr1",16955323,16955561,16955442,238
"2047","chr16",64950778,64951005,64950891,227
"2048","chr20",49318302,49319147,49318724,845
"2049","chr2",176097451,176097759,176097605,308
"2050","chr15",64989590,64990037,64989813,447
"2051","chr7",130733126,130734376,130733751,1250
"2052","chr1",53196637,53197143,53196890,506
"2053","chr12",90954027,90954319,90954173,292
"2054","chr2",96144704,96145558,96145131,854
"2055","chr5",1948880,1949113,1948996,233
"2056","chr17",79182746,79184147,79183446,1401
"2057","chr2",239009102,239009361,239009231,259
"2058","chr7",100100550,100102023,100101286,1473
"2059","chr10",35214880,35215093,35214986,213
"2060","chr2",25981685,25982780,25982232,1095
"2061","chr19",49118766,49120378,49119572,1612
"2062","chr16",55330911,55331402,55331156,491
"2063","chr6",31702817,31703497,31703157,680
"2064","chr3",194396818,194398259,194397538,1441
"2065","chr7",150396548,150398141,150397344,1593
"2066","chr19",11738544,11738981,11738762,437
"2067","chr6",36130262,36130844,36130553,582
"2068","chr7",87934027,87935256,87934641,1229
"2069","chr16",20348445,20349176,20348810,731
"2070","chr10",11823126,11823985,11823555,859
"2071","chr18",50298699,50298955,50298827,256
"2072","chr1",37807736,37808730,37808233,994
"2073","chr18",61554218,61554753,61554485,535
"2074","chr5",1068631,1068885,1068758,254
"2075","chr16",87689565,87690494,87690029,929
"2076","chr2",67397240,67397712,67397476,472
"2077","chr12",98644494,98645705,98645099,1211
"2078","chr20",35541788,35542289,35542038,501
"2079","chr12",114667043,114667743,114667393,700
"2080","chr1",201114330,201115439,201114884,1109
"2081","chr1",236064382,236065517,236064949,1135
"2082","chr10",128210294,128211356,128210825,1062
"2083","chr6",168411844,168412058,168411951,214
"2084","chr1",150149505,150150888,150150196,1383
"2085","chr17",3924501,3924843,3924672,342
"2086","chr11",120325096,120325663,120325379,567
"2087","chr1",2073740,2074126,2073933,386
"2088","chr2",176112556,176112812,176112684,256
"2089","chr2",1056280,1057044,1056662,764
"2090","chr5",140174804,140175872,140175338,1068
"2091","chr7",1297469,1297752,1297610,283
"2092","chr19",1118908,1120216,1119562,1308
"2093","chr7",2232375,2233221,2232798,846
"2094","chr12",109111094,109111369,109111231,275
"2095","chr6",117906879,117908648,117907763,1769
"2096","chr5",150656406,150657067,150656736,661
"2097","chr13",99895379,99896657,99896018,1278
"2098","chr5",100900863,100901251,100901057,388
"2099","chr2",106193486,106194719,106194102,1233
"2100","chr16",66270382,66270728,66270555,346
"2101","chr3",9952046,9952452,9952249,406
"2102","chr16",705037,706543,705790,1506
"2103","chr5",138241810,138242282,138242046,472
"2104","chr4",153790921,153791554,153791237,633
"2105","chr4",94757647,94758658,94758152,1011
"2106","chr14",100827230,100828287,100827758,1057
"2107","chr16",87914912,87915159,87915035,247
"2108","chr17",62965964,62967047,62966505,1083
"2109","chr5",179343723,179345793,179344758,2070
"2110","chr11",3378769,3379189,3378979,420
"2111","chr7",97024155,97024668,97024411,513
"2112","chr5",34656018,34657225,34656621,1207
"2113","chr16",2064024,2064243,2064133,219
"2114","chr13",63811586,63811924,63811755,338
"2115","chr1",197200875,197201589,197201232,714
"2116","chr19",51366146,51368333,51367239,2187
"2117","chr4",39366028,39366593,39366310,565
"2118","chr2",44942366,44944745,44943555,2379
"2119","chr10",97849668,97850359,97850013,691
"2120","chr10",63630115,63631075,63630595,960
"2121","chr1",63316723,63324800,63320761,8077
"2122","chr7",5592704,5594924,5593814,2220
"2123","chr12",33438828,33440115,33439471,1287
"2124","chr16",29694877,29695137,29695007,260
"2125","chr1",211133325,211134333,211133829,1008
"2126","chr6",138795809,138796332,138796070,523
"2127","chr2",43224306,43227812,43226059,3506
"2128","chr10",100185814,100186150,100185982,336
"2129","chr22",38426874,38428188,38427531,1314
"2130","chr1",202860933,202861795,202861364,862
"2131","chr1",35031520,35031986,35031753,466
"2132","chr3",49903455,49903897,49903676,442
"2133","chr1",205812742,205813882,205813312,1140
"2134","chr19",9160230,9161242,9160736,1012
"2135","chr12",51047815,51048404,51048109,589
"2136","chr2",46296650,46300001,46298325,3351
"2137","chr1",152188845,152189452,152189148,607
"2138","chr4",187063351,187063608,187063479,257
"2139","chr6",31897120,31897639,31897379,519
"2140","chr13",112755690,112756048,112755869,358
"2141","chr12",42237422,42238817,42238119,1395
"2142","chr4",13523491,13524402,13523946,911
"2143","chr10",88880030,88880866,88880448,836
"2144","chr15",22890657,22890875,22890766,218
"2145","chr17",8745685,8746195,8745940,510
"2146","chr18",31942438,31943614,31943026,1176
"2147","chr10",116627506,116627965,116627735,459
"2148","chr12",116910840,116911366,116911103,526
"2149","chr15",93044872,93045340,93045106,468
"2150","chr1",38804057,38804579,38804318,522
"2151","chr1",16073153,16073496,16073324,343
"2152","chr13",114131923,114133041,114132482,1118
"2153","chr15",64093676,64094123,64093899,447
"2154","chr1",185316197,185317234,185316715,1037
"2155","chr15",80778926,80780879,80779902,1953
"2156","chrX",132956335,132958589,132957462,2254
"2157","chr16",23712949,23713454,23713201,505
"2158","chr15",98852205,98852747,98852476,542
"2159","chr15",66386557,66387625,66387091,1068
"2160","chr6",168212452,168212666,168212559,214
"2161","chr20",62006452,62006806,62006629,354
"2162","chr20",1296243,1296477,1296360,234
"2163","chr3",52154255,52155021,52154638,766
"2164","chr16",726636,729417,728026,2781
"2165","chr5",2180137,2180353,2180245,216
"2166","chr2",113324916,113325198,113325057,282
"2167","chr1",32963930,32965015,32964472,1085
"2168","chr22",33057906,33058468,33058187,562
"2169","chr3",12556892,12557552,12557222,660
"2170","chr17",51166259,51167286,51166772,1027
"2171","chr6",168233026,168233238,168233132,212
"2172","chr7",157568820,157569113,157568966,293
"2173","chr1",159900111,159900353,159900232,242
"2174","chr6",87322439,87322711,87322575,272
"2175","chr6",89411155,89412651,89411903,1496
"2176","chr1",175192764,175193087,175192925,323
"2177","chr2",96760598,96761471,96761034,873
"2178","chr10",50991196,50992005,50991600,809
"2179","chr13",26050587,26052127,26051357,1540
"2180","chr8",48910784,48911004,48910894,220
"2181","chr20",38674170,38674745,38674457,575
"2182","chr7",48035241,48036388,48035814,1147
"2183","chr4",105146039,105146811,105146425,772
"2184","chr4",183097677,183100226,183098951,2549
"2185","chr6",169659141,169659490,169659315,349
"2186","chr4",4385866,4388192,4387029,2326
"2187","chr17",35141877,35142399,35142138,522
"2188","chr1",204073117,204075382,204074249,2265
"2189","chr9",106860143,106860922,106860532,779
"2190","chr9",121074424,121075307,121074865,883
"2191","chr3",173395480,173395891,173395685,411
"2192","chr3",186570459,186570849,186570654,390
"2193","chr19",53768486,53768705,53768595,219
"2194","chr17",58352094,58352545,58352319,451
"2195","chr1",51236095,51236870,51236482,775
"2196","chr16",369860,370736,370298,876
"2197","chr1",161313985,161314217,161314101,232
"2198","chr17",55420882,55422185,55421533,1303
"2199","chr5",958670,959057,958863,387
"2200","chr22",39487510,39489005,39488257,1495
"2201","chr7",91264278,91267368,91265823,3090
"2202","chr22",30289206,30289915,30289560,709
"2203","chr10",11165620,11166017,11165818,397
"2204","chr2",38959636,38960827,38960231,1191
"2205","chr10",72087048,72088475,72087761,1427
"2206","chr1",14801087,14801373,14801230,286
"2207","chr3",123991833,123992261,123992047,428
"2208","chr15",32717329,32719495,32718412,2166
"2209","chr3",101778986,101779804,101779395,818
"2210","chr6",2970852,2971728,2971290,876
"2211","chr6",136921177,136924304,136922740,3127
"2212","chr6",107957705,107958500,107958102,795
"2213","chr22",44701875,44702921,44702398,1046
"2214","chr16",85431440,85431678,85431559,238
"2215","chr1",24744861,24746095,24745478,1234
"2216","chr18",5295432,5297100,5296266,1668
"2217","chr1",232629342,232630784,232630063,1442
"2218","chr1",42957796,42959097,42958446,1301
"2219","chr1",109213842,109214476,109214159,634
"2220","chr8",1493204,1493415,1493309,211
"2221","chr2",128345503,128346713,128346108,1210
"2222","chr13",23888980,23889538,23889259,558
"2223","chr9",136500568,136500835,136500701,267
"2224","chr3",186930385,186931314,186930849,929
"2225","chr1",207751826,207752619,207752222,793
"2226","chr21",45477927,45478244,45478085,317
"2227","chr20",2749351,2750151,2749751,800
"2228","chr6",18154964,18156123,18155543,1159
"2229","chr1",150268647,150269254,150268950,607
"2230","chr9",89604856,89606496,89605676,1640
"2231","chr5",112861152,112861550,112861351,398
"2232","chr1",45490673,45491221,45490947,548
"2233","chr1",205069656,205070025,205069840,369
"2234","chr15",92809110,92809852,92809481,742
"2235","chr1",204151270,204152433,204151851,1163
"2236","chr1",173868034,173868779,173868406,745
"2237","chr17",48527000,48527519,48527259,519
"2238","chr1",6599065,6599445,6599255,380
"2239","chr14",75069122,75069673,75069397,551
"2240","chr6",32584074,32584554,32584314,480
"2241","chr20",31608315,31608782,31608548,467
"2242","chr17",7582967,7584113,7583540,1146
"2243","chr1",155070936,155071446,155071191,510
"2244","chr1",225887450,225887980,225887715,530
"2245","chr1",3267982,3268260,3268121,278
"2246","chr20",63465840,63466901,63466370,1061
"2247","chr5",55307381,55308076,55307728,695
"2248","chr6",84772851,84775000,84773925,2149
"2249","chr3",138608658,138609343,138609000,685
"2250","chr9",113340129,113340437,113340283,308
"2251","chr12",10613356,10613732,10613544,376
"2252","chr19",7680604,7682828,7681716,2224
"2253","chr3",75906608,75907157,75906882,549
"2254","chr15",88621145,88621721,88621433,576
"2255","chr6",29011469,29011722,29011595,253
"2256","chr12",7628407,7628652,7628529,245
"2257","chr1",156245577,156246108,156245842,531
"2258","chr15",34494291,34495937,34495114,1646
"2259","chr14",105180926,105181469,105181197,543
"2260","chr15",84654001,84654464,84654232,463
"2261","chr19",45711751,45712922,45712336,1171
"2262","chr5",15499967,15500814,15500390,847
"2263","chr1",228101968,228103483,228102725,1515
"2264","chr2",10526415,10526639,10526527,224
"2265","chr16",77212047,77213116,77212581,1069
"2266","chr16",74774415,74775088,74774751,673
"2267","chr20",21105498,21106534,21106016,1036
"2268","chr1",3771989,3773120,3772554,1131
"2269","chr17",32142313,32142923,32142618,610
"2270","chr12",132525676,132526018,132525847,342
"2271","chr1",156114695,156115347,156115021,652
"2272","chr12",42144323,42145086,42144704,763
"2273","chr6",33428273,33428519,33428396,246
"2274","chr9",83817039,83818179,83817609,1140
"2275","chr1",3247405,3248079,3247742,674
"2276","chr7",1898102,1898310,1898206,208
"2277","chr7",27095723,27097117,27096420,1394
"2278","chr12",122225507,122226824,122226165,1317
"2279","chr15",84079841,84080533,84080187,692
"2280","chr1",247078277,247078899,247078588,622
"2281","chr7",44123251,44124121,44123686,870
"2282","chr15",40894057,40894471,40894264,414
"2283","chr5",147452997,147454375,147453686,1378
"2284","chr22",50277589,50278227,50277908,638
"2285","chr3",52685487,52686319,52685903,832
"2286","chr5",178232196,178232926,178232561,730
"2287","chr21",25734503,25735900,25735201,1397
"2288","chr18",5237724,5238675,5238199,951
"2289","chr2",3059600,3059900,3059750,300
"2290","chr3",49554145,49555101,49554623,956
"2291","chr20",51003909,51004143,51004026,234
"2292","chr21",44463777,44464024,44463900,247
"2293","chr12",43805827,43806602,43806214,775
"2294","chr5",180831203,180831784,180831493,581
"2295","chr17",41733704,41735237,41734470,1533
"2296","chr1",16137881,16138126,16138003,245
"2297","chr16",19167680,19169122,19168401,1442
"2298","chr14",104604181,104605126,104604653,945
"2299","chr1",29134365,29134660,29134512,295
"2300","chr22",19941573,19941945,19941759,372
"2301","chr22",19523440,19524731,19524085,1291
"2302","chr2",46915327,46916122,46915724,795
"2303","chr5",159971997,159972921,159972459,924
"2304","chr19",19405212,19406574,19405893,1362
"2305","chr11",46366355,46366985,46366670,630
"2306","chr9",117412975,117415218,117414096,2243
"2307","chr4",37826522,37827323,37826922,801
"2308","chr12",131458974,131459216,131459095,242
"2309","chr15",96345729,96346188,96345958,459
"2310","chr14",56794160,56795405,56794782,1245
"2311","chr1",151328046,151328248,151328147,202
"2312","chr15",71215092,71215357,71215224,265
"2313","chr6",31620002,31621247,31620624,1245
"2314","chr5",3187985,3188261,3188123,276
"2315","chr1",156135916,156136380,156136148,464
"2316","chr22",37419764,37420438,37420101,674
"2317","chr12",1529867,1531584,1530725,1717
"2318","chrX",154397754,154398983,154398368,1229
"2319","chr3",122921866,122922508,122922187,642
"2320","chr16",88927729,88928034,88927881,305
"2321","chr2",263400,265238,264319,1838
"2322","chr15",48975794,48976081,48975937,287
"2323","chr7",813323,813593,813458,270
"2324","chr13",24340410,24340962,24340686,552
"2325","chr16",86494665,86495407,86495036,742
"2326","chr1",22647557,22647810,22647683,253
"2327","chr1",29478450,29478727,29478588,277
"2328","chr22",24423569,24424842,24424205,1273
"2329","chr7",57256670,57257168,57256919,498
"2330","chr3",52532993,52534791,52533892,1798
"2331","chr1",228416005,228416866,228416435,861
"2332","chrX",118495167,118495414,118495290,247
"2333","chr9",135768651,135769378,135769014,727
"2334","chr7",139340184,139341552,139340868,1368
"2335","chr7",157838627,157838923,157838775,296
"2336","chr12",75391044,75391461,75391252,417
"2337","chr16",12116798,12117439,12117118,641
"2338","chr4",165112216,165113060,165112638,844
"2339","chr20",41028421,41029772,41029096,1351
"2340","chr16",85373708,85373985,85373846,277
"2341","chr13",87677139,87677630,87677384,491
"2342","chr5",151252871,151253102,151252986,231
"2343","chr13",29339749,29340164,29339956,415
"2344","chr6",142944582,142947654,142946118,3072
"2345","chr3",147390724,147393916,147392320,3192
"2346","chr9",113584120,113584323,113584221,203
"2347","chr10",86711148,86712177,86711662,1029
"2348","chr12",53738364,53738569,53738466,205
"2349","chr13",112832521,112833033,112832777,512
"2350","chr20",40687868,40691347,40689607,3479
"2351","chr3",43690506,43691643,43691074,1137
"2352","chr9",93575758,93577554,93576656,1796
"2353","chr7",6589697,6590222,6589959,525
"2354","chr22",17158591,17159824,17159207,1233
"2355","chr18",79420182,79420841,79420511,659
"2356","chr15",67254451,67255072,67254761,621
"2357","chr10",95907486,95908221,95907853,735
"2358","chr10",6579945,6580680,6580312,735
"2359","chr6",25991953,25992936,25992444,983
"2360","chr16",4261694,4261941,4261817,247
"2361","chr5",151080525,151081303,151080914,778
"2362","chr6",10384732,10385259,10384995,527
"2363","chr6",31729752,31730468,31730110,716
"2364","chr17",83031183,83031516,83031349,333
"2365","chr12",93377689,93378419,93378054,730
"2366","chr8",143803099,143803933,143803516,834
"2367","chr1",109548417,109548968,109548692,551
"2368","chr7",45888403,45889063,45888733,660
"2369","chr6",33688189,33688461,33688325,272
"2370","chr7",78040353,78040740,78040546,387
"2371","chr7",69597388,69600051,69598719,2663
"2372","chr7",4775388,4775911,4775649,523
"2373","chr20",61936662,61937037,61936849,375
"2374","chrX",72018478,72018825,72018651,347
"2375","chr1",198159017,198159234,198159125,217
"2376","chr8",649904,650309,650106,405
"2377","chr12",121399577,121400593,121400085,1016
"2378","chr7",77536619,77538020,77537319,1401
"2379","chr2",47690749,47691275,47691012,526
"2380","chr8",139618853,139619089,139618971,236
"2381","chr16",554801,555348,555074,547
"2382","chr3",127029817,127030048,127029932,231
"2383","chr5",537188,537407,537297,219
"2384","chr2",236211335,236211614,236211474,279
"2385","chr15",32167965,32168463,32168214,498
"2386","chr1",869818,870248,870033,430
"2387","chr5",26669439,26669795,26669617,356
"2388","chr2",3786225,3786728,3786476,503
"2389","chr22",38080829,38082875,38081852,2046
"2390","chr6",108848265,108848900,108848582,635
"2391","chr1",27365921,27366752,27366336,831
"2392","chr10",73647655,73647948,73647801,293
"2393","chr2",102355658,102356136,102355897,478
"2394","chr1",147084765,147085129,147084947,364
"2395","chr8",143878509,143878812,143878660,303
"2396","chr4",53365541,53366153,53365847,612
"2397","chr11",12673867,12675434,12674650,1567
"2398","chr8",141620027,141620368,141620197,341
"2399","chr1",54200148,54200586,54200367,438
"2400","chr1",19596847,19597508,19597177,661
"2401","chrX",118495823,118496506,118496164,683
"2402","chr1",31644609,31645360,31644984,751
"2403","chr8",106215557,106215779,106215668,222
"2404","chr10",132793919,132794376,132794147,457
"2405","chr3",55486198,55488316,55487257,2118
"2406","chr5",178130549,178131392,178130970,843
"2407","chr3",129001022,129002402,129001712,1380
"2408","chr4",109301814,109303101,109302457,1287
"2409","chr17",39627061,39627666,39627363,605
"2410","chr7",102689503,102690207,102689855,704
"2411","chr1",178094118,178094711,178094414,593
"2412","chr19",11479577,11482828,11481202,3251
"2413","chr2",219229250,219229975,219229612,725
"2414","chr1",228457406,228458733,228458069,1327
"2415","chr16",87602149,87603678,87602913,1529
"2416","chr1",159171412,159171928,159171670,516
"2417","chr1",247451393,247451642,247451517,249
"2418","chr19",54527024,54527284,54527154,260
"2419","chr10",100996949,101000041,100998495,3092
"2420","chr11",47565296,47566056,47565676,760
"2421","chr1",950976,951222,951099,246
"2422","chr7",148698338,148699910,148699124,1572
"2423","chr10",62374030,62374661,62374345,631
"2424","chr7",157731465,157734049,157732757,2584
"2425","chr1",3062711,3064194,3063452,1483
"2426","chr17",49763670,49764183,49763926,513
"2427","chrX",154411398,154412338,154411868,940
"2428","chr5",83313,85415,84364,2102
"2429","chr6",29887518,29888788,29888153,1270
"2430","chr1",2456230,2456647,2456438,417
"2431","chr12",120640358,120641680,120641019,1322
"2432","chr1",26787627,26788201,26787914,574
"2433","chr9",127396495,127396778,127396636,283
"2434","chr1",34885430,34886253,34885841,823
"2435","chr1",33036600,33037118,33036859,518
"2436","chr18",8659445,8659674,8659559,229
"2437","chr16",85284143,85284397,85284270,254
"2438","chr6",29553333,29554056,29553694,723
"2439","chr16",1370169,1370441,1370305,272
"2440","chr7",157414240,157414654,157414447,414
"2441","chr16",28950592,28951470,28951031,878
"2442","chr3",146160643,146161500,146161071,857
"2443","chr8",72536424,72537490,72536957,1066
"2444","chr3",179071517,179072039,179071778,522
"2445","chr14",64772604,64772948,64772776,344
"2446","chrX",24464899,24465830,24465364,931
"2447","chr15",40357854,40358901,40358377,1047
"2448","chr15",96416111,96417301,96416706,1190
"2449","chrX",118973506,118973986,118973746,480
"2450","chr6",139028818,139029603,139029210,785
"2451","chr11",121023980,121024373,121024176,393
"2452","chr1",197921348,197921694,197921521,346
"2453","chr22",21657276,21658227,21657751,951
"2454","chr1",36224158,36224486,36224322,328
"2455","chr22",22223264,22223519,22223391,255
"2456","chr10",110007329,110008597,110007963,1268
"2457","chr10",12348803,12350590,12349696,1787
"2458","chr9",122217050,122217320,122217185,270
"2459","chr11",706182,706534,706358,352
"2460","chr1",193059091,193060141,193059616,1050
"2461","chr6",33161514,33161941,33161727,427
"2462","chrX",46545199,46545730,46545464,531
"2463","chr8",22108974,22109816,22109395,842
"2464","chr6",44312982,44313461,44313221,479
"2465","chr3",53130190,53130682,53130436,492
"2466","chr17",56597512,56597871,56597691,359
"2467","chr9",133428446,133430116,133429281,1670
"2468","chr6",110874180,110876373,110875276,2193
"2469","chr17",76948663,76948889,76948776,226
"2470","chr8",11679258,11681533,11680395,2275
"2471","chr1",207644966,207645607,207645286,641
"2472","chr9",32550561,32552534,32551547,1973
"2473","chr1",217138125,217138431,217138278,306
"2474","chr2",3387631,3388729,3388180,1098
"2475","chr9",18438558,18438804,18438681,246
"2476","chrX",46446814,46447403,46447108,589
"2477","chr8",31639009,31640830,31639919,1821
"2478","chr15",50182125,50182989,50182557,864
"2479","chr8",973762,973974,973868,212
"2480","chr1",93680765,93681948,93681356,1183
"2481","chr17",19362090,19363131,19362610,1041
"2482","chr8",48923428,48923672,48923550,244
"2483","chr13",83879529,83879762,83879645,233
"2484","chr5",112418780,112420525,112419652,1745
"2485","chr1",231039316,231041263,231040289,1947
"2486","chr1",27773117,27773520,27773318,403
"2487","chr5",160421772,160422106,160421939,334
"2488","chr2",239275072,239275301,239275186,229
"2489","chrX",49163465,49163969,49163717,504
"2490","chr19",45498588,45499428,45499008,840
"2491","chr5",172959890,172960099,172959994,209
"2492","chr15",73684218,73684914,73684566,696
"2493","chr8",144730254,144730604,144730429,350
"2494","chrX",15854092,15855639,15854865,1547
"2495","chr16",89541890,89542130,89542010,240
"2496","chr6",151493845,151494392,151494118,547
"2497","chr17",47896099,47896888,47896493,789
"2498","chr15",55318887,55319410,55319148,523
"2499","chr22",45413017,45414072,45413544,1055
"2500","chrX",35625753,35626200,35625976,447
"2501","chr1",56578429,56579444,56578936,1015
"2502","chr10",124461674,124462171,124461922,497
"2503","chr6",31806698,31807085,31806891,387
"2504","chr17",68259051,68259415,68259233,364
"2505","chr8",99013153,99013771,99013462,618
"2506","chr22",50044921,50045150,50045035,229
"2507","chr16",641597,642700,642148,1103
"2508","chr7",45920538,45921748,45921143,1210
"2509","chr2",100103923,100105423,100104673,1500
"2510","chr7",50793693,50793941,50793817,248
"2511","chr21",42668712,42668919,42668815,207
"2512","chr21",33019854,33020348,33020101,494
"2513","chr10",7787625,7788554,7788089,929
"2514","chr1",205227663,205228124,205227893,461
"2515","chr1",112674853,112675475,112675164,622
"2516","chr18",13725980,13727371,13726675,1391
"2517","chr10",129888101,129888331,129888216,230
"2518","chr16",1019294,1020214,1019754,920
"2519","chr9",129336844,129337337,129337090,493
"2520","chr1",156591884,156592088,156591986,204
"2521","chr5",136356709,136357354,136357031,645
"2522","chr13",45120387,45120831,45120609,444
"2523","chr4",8625063,8625332,8625197,269
"2524","chr6",159129050,159129350,159129200,300
"2525","chr18",34493480,34494407,34493943,927
"2526","chr3",188153690,188154014,188153852,324
"2527","chr3",183162489,183162934,183162711,445
"2528","chr20",20366809,20369961,20368385,3152
"2529","chr7",1384188,1384417,1384302,229
"2530","chr4",89836857,89837719,89837288,862
"2531","chr4",102500934,102502072,102501503,1138
"2532","chr4",173506740,173507041,173506890,301
"2533","chr3",9862647,9863127,9862887,480
"2534","chr17",50478643,50479148,50478895,505
"2535","chr3",138434427,138435779,138435103,1352
"2536","chr5",157459961,157460432,157460196,471
"2537","chr6",30955431,30955786,30955608,355
"2538","chr6",127475141,127476211,127475676,1070
"2539","chr7",70789908,70791000,70790454,1092
"2540","chr6",32521965,32522351,32522158,386
"2541","chr5",73909485,73909895,73909690,410
"2542","chr7",3043507,3043847,3043677,340
"2543","chr17",39617670,39618338,39618004,668
"2544","chr17",44324133,44325898,44325015,1765
"2545","chr7",4308076,4308386,4308231,310
"2546","chrX",77785517,77786239,77785878,722
"2547","chr15",84715608,84716594,84716101,986
"2548","chr6",166455270,166455742,166455506,472
"2549","chr10",44292857,44293121,44292989,264
"2550","chr5",109409225,109410050,109409637,825
"2551","chr6",87701424,87702450,87701937,1026
"2552","chr1",100132574,100133198,100132886,624
"2553","chr8",48870128,48870711,48870419,583
"2554","chr4",145936182,145937930,145937056,1748
"2555","chr4",7192400,7193740,7193070,1340
"2556","chr9",5628570,5629743,5629156,1173
"2557","chr17",1574753,1574965,1574859,212
"2558","chr3",11154215,11154866,11154540,651
"2559","chr1",2408437,2408807,2408622,370
"2560","chr6",30103448,30103651,30103549,203
"2561","chr16",67846775,67847613,67847194,838
"2562","chr1",143654586,143654841,143654713,255
"2563","chr16",1364416,1364850,1364633,434
"2564","chr1",203007200,203007900,203007550,700
"2565","chr3",113885016,113885399,113885207,383
"2566","chr9",6757336,6758872,6758104,1536
"2567","chr19",54102677,54103282,54102979,605
"2568","chr6",114342164,114343695,114342929,1531
"2569","chr20",63652163,63653410,63652786,1247
"2570","chr1",3478137,3478627,3478382,490
"2571","chr8",17800657,17801812,17801234,1155
"2572","chr1",75125132,75125669,75125400,537
"2573","chr20",59191341,59192841,59192091,1500
"2574","chr3",196287377,196288233,196287805,856
"2575","chrY",19502595,19503177,19502886,582
"2576","chr3",169812087,169812647,169812367,560
"2577","chr13",33349793,33350644,33350218,851
"2578","chr6",165827022,165827388,165827205,366
"2579","chr20",3820114,3820899,3820506,785
"2580","chrX",43882053,43882581,43882317,528
"2581","chr14",67619560,67620240,67619900,680
"2582","chr1",46301753,46303364,46302558,1611
"2583","chr16",57735684,57736061,57735872,377
"2584","chr10",102461226,102461530,102461378,304
"2585","chr15",98421378,98422140,98421759,762
"2586","chr8",26576856,26577936,26577396,1080
"2587","chr8",133296323,133297902,133297112,1579
"2588","chr1",179877744,179877971,179877857,227
"2589","chr10",123891304,123891937,123891620,633
"2590","chr6",160090904,160091433,160091168,529
"2591","chr17",31094577,31095460,31095018,883
"2592","chr6",32079038,32079317,32079177,279
"2593","chr5",36151395,36152277,36151836,882
"2594","chr16",1361891,1362367,1362129,476
"2595","chr17",4710105,4710642,4710373,537
"2596","chrX",13378769,13379375,13379072,606
"2597","chr2",3651069,3651285,3651177,216
"2598","chr8",54457868,54459965,54458916,2097
"2599","chr7",140435564,140435820,140435692,256
"2600","chr5",80035105,80035665,80035385,560
"2601","chr1",234478190,234479226,234478708,1036
"2602","chr16",1610053,1615094,1612573,5041
"2603","chr1",9822953,9824609,9823781,1656
"2604","chr1",95234120,95234586,95234353,466
"2605","chr22",50437075,50437330,50437202,255
"2606","chr5",10307408,10307801,10307604,393
"2607","chr4",10456505,10457729,10457117,1224
"2608","chr5",43066296,43066909,43066602,613
"2609","chr16",30091495,30092374,30091934,879
"2610","chr7",5387824,5389406,5388615,1582
"2611","chr11",8262555,8263485,8263020,930
"2612","chr6",41372929,41374805,41373867,1876
"2613","chr17",27293973,27294704,27294338,731
"2614","chr8",142739050,142739892,142739471,842
"2615","chr8",86514331,86515044,86514687,713
"2616","chr1",201468391,201469520,201468955,1129
"2617","chr1",13748772,13749963,13749367,1191
"2618","chr10",132922468,132922750,132922609,282
"2619","chr3",72446702,72447701,72447201,999
"2620","chr15",88912958,88913599,88913278,641
"2621","chr7",142796879,142797564,142797221,685
"2622","chr20",17968112,17969365,17968738,1253
"2623","chr4",37977081,37977974,37977527,893
"2624","chr16",51149788,51156349,51153068,6561
"2625","chr1",43969737,43970442,43970089,705
"2626","chr13",110642328,110642553,110642440,225
"2627","chr1",34176781,34177423,34177102,642
"2628","chr4",145618901,145619504,145619202,603
"2629","chr5",136080515,136080786,136080650,271
"2630","chr7",2460270,2460492,2460381,222
"2631","chr5",176596776,176597650,176597213,874
"2632","chr7",150047313,150049380,150048346,2067
"2633","chr17",79839186,79845282,79842234,6096
"2634","chr16",3119352,3120289,3119820,937
"2635","chr4",41935081,41935607,41935344,526
"2636","chr20",59932700,59934462,59933581,1762
"2637","chr20",45946182,45946383,45946282,201
"2638","chr2",235959008,235959262,235959135,254
"2639","chr5",3305473,3305896,3305684,423
"2640","chr3",66037698,66039920,66038809,2222
"2641","chr7",99504531,99505345,99504938,814
"2642","chr1",44103319,44103727,44103523,408
"2643","chr17",46818434,46819659,46819046,1225
"2644","chr4",110611491,110612235,110611863,744
"2645","chr15",58864846,58865260,58865053,414
"2646","chr14",95534339,95535528,95534933,1189
"2647","chr6",99606810,99607112,99606961,302
"2648","chr6",149963546,149965379,149964462,1833
"2649","chr6",30127396,30127833,30127614,437
"2650","chr16",186075,187284,186679,1209
"2651","chr6",29827776,29828817,29828296,1041
"2652","chrX",48071268,48071776,48071522,508
"2653","chr15",69414177,69415013,69414595,836
"2654","chr4",1289462,1290543,1290002,1081
"2655","chr8",42271171,42271623,42271397,452
"2656","chr10",103602792,103603070,103602931,278
"2657","chr13",36999136,36999475,36999305,339
"2658","chr5",55530782,55530998,55530890,216
"2659","chr5",177022498,177023114,177022806,616
"2660","chr5",142770034,142771267,142770650,1233
"2661","chr8",118111735,118112224,118111979,489
"2662","chr22",22508305,22508902,22508603,597
"2663","chr5",5139328,5140828,5140078,1500
"2664","chr7",516891,523208,520049,6317
"2665","chr14",35826221,35826824,35826522,603
"2666","chr6",111872632,111873651,111873141,1019
"2667","chr9",136526651,136527057,136526854,406
"2668","chr17",78839978,78841356,78840667,1378
"2669","chr22",29205558,29206302,29205930,744
"2670","chr10",129962905,129973432,129968168,10527
"2671","chr17",76353070,76354575,76353822,1505
"2672","chr19",42253343,42255318,42254330,1975
"2673","chr3",50364672,50365511,50365091,839
"2674","chr13",112968423,112969346,112968884,923
"2675","chr15",84570204,84571130,84570667,926
"2676","chr10",1048397,1049654,1049025,1257
"2677","chr10",68560373,68561065,68560719,692
"2678","chrX",53434231,53434516,53434373,285
"2679","chr21",45509311,45510297,45509804,986
"2680","chr10",103493434,103494671,103494052,1237
"2681","chr16",85633303,85633543,85633423,240
"2682","chr7",154892692,154892920,154892806,228
"2683","chr18",15197651,15198310,15197980,659
"2684","chr8",74984293,74984881,74984587,588
"2685","chr10",123666014,123667126,123666570,1112
"2686","chr15",55196544,55197096,55196820,552
"2687","chr16",3305020,3306012,3305516,992
"2688","chr6",4254622,4255075,4254848,453
"2689","chr14",90331820,90332225,90332022,405
"2690","chr10",131676018,131676255,131676136,237
"2691","chr18",904577,905697,905137,1120
"2692","chr13",42991938,42992372,42992155,434
"2693","chr5",141878857,141879251,141879054,394
"2694","chr1",46718730,46719411,46719070,681
"2695","chr4",182917897,182918133,182918015,236
"2696","chr15",40038790,40039362,40039076,572
"2697","chr8",143944647,143945046,143944846,399
"2698","chr1",46603943,46604507,46604225,564
"2699","chr1",88462600,88463077,88462838,477
"2700","chr2",19989827,19990468,19990147,641
"2701","chr17",39667440,39668736,39668088,1296
"2702","chr7",127587704,127588278,127587991,574
"2703","chr8",70034655,70035064,70034859,409
"2704","chr9",35748656,35749280,35748968,624
"2705","chr16",84505278,84505509,84505393,231
"2706","chr6",41779772,41780934,41780353,1162
"2707","chr5",123098183,123099856,123099019,1673
"2708","chr17",40191281,40191659,40191470,378
"2709","chr12",55966683,55967125,55966904,442
"2710","chr21",46036357,46036616,46036486,259
"2711","chr6",116370664,116371705,116371184,1041
"2712","chr6",70667682,70668475,70668078,793
"2713","chr13",27968084,27969407,27968745,1323
"2714","chr4",65670354,65670956,65670655,602
"2715","chr2",241686546,241687305,241686925,759
"2716","chr13",99894918,99895177,99895047,259
"2717","chr16",33058893,33059993,33059443,1100
"2718","chr11",20387209,20388235,20387722,1026
"2719","chr20",25696064,25697148,25696606,1084
"2720","chr17",74274162,74274373,74274267,211
"2721","chr4",8097098,8097347,8097222,249
"2722","chrX",130060032,130060728,130060380,696
"2723","chr2",174326138,174327395,174326766,1257
"2724","chr6",35687830,35689079,35688454,1249
"2725","chr1",225923942,225924852,225924397,910
"2726","chr6",40599527,40599841,40599684,314
"2727","chr22",18970583,18971208,18970895,625
"2728","chr3",184381535,184381794,184381664,259
"2729","chr15",36887315,36887581,36887448,266
"2730","chr3",69739332,69740057,69739694,725
"2731","chr16",84819742,84820108,84819925,366
"2732","chr8",123041817,123042493,123042155,676
"2733","chr6",128929968,128930174,128930071,206
"2734","chr19",36528017,36528909,36528463,892
"2735","chr7",102478756,102479158,102478957,402
"2736","chr8",142121293,142121507,142121400,214
"2737","chr8",141285119,141285780,141285449,661
"2738","chr5",149271580,149272209,149271894,629
"2739","chr4",39480360,39480575,39480467,215
"2740","chr16",85462548,85463288,85462918,740
"2741","chr13",43023368,43023720,43023544,352
"2742","chr16",564792,565095,564943,303
"2743","chr22",17792913,17793156,17793034,243
"2744","chr16",50741714,50742718,50742216,1004
"2745","chr17",81695820,81696025,81695922,205
"2746","chr8",1944069,1944281,1944175,212
"2747","chr4",109559671,109560904,109560287,1233
"2748","chr5",134738393,134738804,134738598,411
"2749","chr4",4865659,4867784,4866721,2125
"2750","chr8",8891142,8893968,8892555,2826
"2751","chr5",36690105,36690556,36690330,451
"2752","chr12",106773984,106774969,106774476,985
"2753","chr10",67764085,67764500,67764292,415
"2754","chr5",1467716,1468148,1467932,432
"2755","chr4",10115951,10117328,10116639,1377
"2756","chr1",213979871,213980325,213980098,454
"2757","chr6",3258813,3259504,3259158,691
"2758","chr5",112921283,112922213,112921748,930
"2759","chr10",61903127,61903540,61903333,413
"2760","chr8",95268616,95269519,95269067,903
"2761","chr5",17275260,17275889,17275574,629
"2762","chr10",114043324,114045709,114044516,2385
"2763","chr13",26012149,26012753,26012451,604
"2764","chr2",219001611,219003332,219002471,1721
"2765","chr20",64178517,64179018,64178767,501
"2766","chr7",7182389,7183343,7182866,954
"2767","chr13",97975805,97977136,97976470,1331
"2768","chr3",197627235,197628294,197627764,1059
"2769","chr16",1455975,1456201,1456088,226
"2770","chr16",57185574,57186671,57186122,1097
"2771","chr16",31214687,31216943,31215815,2256
"2772","chr12",3752902,3753440,3753171,538
"2773","chr4",113760913,113761730,113761321,817
"2774","chr2",148887967,148888265,148888116,298
"2775","chr17",15341388,15341809,15341598,421
"2776","chr7",44082257,44083063,44082660,806
"2777","chr19",15432101,15433083,15432592,982
"2778","chr12",132955864,132956393,132956128,529
"2779","chr6",1598855,1599167,1599011,312
"2780","chr10",14603753,14604706,14604229,953
"2781","chr18",657401,658745,658073,1344
"2782","chr12",9064732,9065119,9064925,387
"2783","chr10",50152853,50153175,50153014,322
"2784","chr22",38461568,38461855,38461711,287
"2785","chr21",42496168,42496790,42496479,622
"2786","chr16",88067867,88068305,88068086,438
"2787","chr3",64267857,64268143,64268000,286
"2788","chr6",7590166,7590693,7590429,527
"2789","chr5",77645223,77646063,77645643,840
"2790","chr2",106269662,106270282,106269972,620
"2791","chr3",138928829,138929252,138929040,423
"2792","chr3",139934588,139936273,139935430,1685
"2793","chr17",10638164,10638477,10638320,313
"2794","chr16",28924811,28925715,28925263,904
"2795","chr17",78378362,78379120,78378741,758
"2796","chr7",5351692,5351941,5351816,249
"2797","chr2",95525223,95525629,95525426,406
"2798","chr6",101402753,101403098,101402925,345
"2799","chr10",132597737,132597977,132597857,240
"2800","chr4",7800464,7800713,7800588,249
"2801","chr17",80198377,80198603,80198490,226
"2802","chr3",183427639,183429002,183428320,1363
"2803","chr4",154740526,154740832,154740679,306
"2804","chr13",50081145,50082272,50081708,1127
"2805","chr22",18749385,18750335,18749860,950
"2806","chr17",48624918,48626804,48625861,1886
"2807","chr16",22190067,22191470,22190768,1403
"2808","chr2",209771620,209772211,209771915,591
"2809","chr11",57646927,57647191,57647059,264
"2810","chr12",132257423,132257891,132257657,468
"2811","chr12",101830521,101830879,101830700,358
"2812","chr5",176619292,176620640,176619966,1348
"2813","chr19",5977429,5978805,5978117,1376
"2814","chr8",142975005,142975218,142975111,213
"2815","chr6",56542666,56543128,56542897,462
"2816","chr22",29553489,29553835,29553662,346
"2817","chrX",154478589,154479477,154479033,888
"2818","chr12",46267271,46269625,46268448,2354
"2819","chr19",52171074,52171602,52171338,528
"2820","chr2",6865032,6866209,6865620,1177
"2821","chr4",154781188,154782176,154781682,988
"2822","chr18",48761535,48761769,48761652,234
"2823","chr8",21787396,21790333,21788864,2937
"2824","chr7",65981784,65982353,65982068,569
"2825","chr6",26055939,26056570,26056254,631
"2826","chr12",66235225,66235624,66235424,399
"2827","chr7",128031105,128032800,128031952,1695
"2828","chr8",12951289,12952353,12951821,1064
"2829","chr10",104121691,104122189,104121940,498
"2830","chr17",82960342,82961382,82960862,1040
"2831","chr4",123397152,123398843,123397997,1691
"2832","chr17",18634896,18635500,18635198,604
"2833","chr5",74865711,74866891,74866301,1180
"2834","chr2",191013882,191014527,191014204,645
"2835","chr1",50332995,50333864,50333429,869
"2836","chr4",80196983,80197449,80197216,466
"2837","chr17",2049625,2059334,2054479,9709
"2838","chr20",57708835,57710339,57709587,1504
"2839","chr9",122904835,122905525,122905180,690
"2840","chr6",42142166,42142786,42142476,620
"2841","chr3",47356321,47356655,47356488,334
"2842","chr17",5419187,5420396,5419791,1209
"2843","chr6",30489592,30490398,30489995,806
"2844","chr9",136866200,136866754,136866477,554
"2845","chr17",36948521,36949457,36948989,936
"2846","chr16",14301747,14303218,14302482,1471
"2847","chr2",950000,951600,950800,1600
"2848","chr10",14959273,14959841,14959557,568
"2849","chr8",27879560,27879772,27879666,212
"2850","chr10",50674886,50675106,50674996,220
"2851","chr7",57629711,57629947,57629829,236
"2852","chr2",10960905,10961362,10961133,457
"2853","chr13",45417839,45418417,45418128,578
"2854","chr1",8325835,8326108,8325971,273
"2855","chr7",128890575,128891302,128890938,727
"2856","chr6",166783861,166784323,166784092,462
"2857","chr10",31318298,31321165,31319731,2867
"2858","chrX",24693513,24694167,24693840,654
"2859","chr7",151044008,151044211,151044109,203
"2860","chr2",29115117,29116043,29115580,926
"2861","chr3",52705521,52706410,52705965,889
"2862","chr8",49909710,49910300,49910005,590
"2863","chrX",120561088,120561373,120561230,285
"2864","chr7",106659956,106661127,106660541,1171
"2865","chr20",885185,885421,885303,236
"2866","chr16",29862597,29863195,29862896,598
"2867","chr8",143321096,143322586,143321841,1490
"2868","chrX",153687601,153689195,153688398,1594
"2869","chrX",10158280,10158842,10158561,562
"2870","chr12",92928566,92929722,92929144,1156
"2871","chr15",39919760,39921243,39920501,1483
"2872","chr2",177392499,177393164,177392831,665
"2873","chr7",128937764,128938702,128938233,938
"2874","chr22",21001489,21002535,21002012,1046
"2875","chr18",79495680,79496046,79495863,366
"2876","chr8",23246262,23246974,23246618,712
"2877","chr8",144755147,144755849,144755498,702
"2878","chr7",2700334,2700783,2700558,449
"2879","chr16",28845883,28846818,28846350,935
"2880","chr12",46831129,46831881,46831505,752
"2881","chr6",131062291,131063532,131062911,1241
"2882","chr17",46770942,46772546,46771744,1604
"2883","chr17",80210504,80211147,80210825,643
"2884","chr3",121749245,121749731,121749488,486
"2885","chr9",126514292,126514679,126514485,387
"2886","chr7",56115884,56116472,56116178,588
"2887","chr22",44330736,44332058,44331397,1322
"2888","chr13",112894339,112894813,112894576,474
"2889","chr7",87600235,87600574,87600404,339
"2890","chr2",10419590,10420168,10419879,578
"2891","chrX",75522930,75523282,75523106,352
"2892","chr12",106580634,106581173,106580903,539
"2893","chr10",13347205,13348940,13348072,1735
"2894","chr22",37677030,37677405,37677217,375
"2895","chr17",44557465,44559483,44558474,2018
"2896","chr8",1561684,1563569,1562626,1885
"2897","chr9",122225464,122228807,122227135,3343
"2898","chr15",77419283,77420145,77419714,862
"2899","chr18",54269341,54269962,54269651,621
"2900","chr17",77957808,77959870,77958839,2062
"2901","chr16",31873721,31874279,31874000,558
"2902","chr12",117189845,117190064,117189954,219
"2903","chr10",13161436,13161790,13161613,354
"2904","chr6",43509483,43510815,43510149,1332
"2905","chrX",119574330,119575073,119574701,743
"2906","chr15",64162691,64163378,64163034,687
"2907","chr1",205268984,205269418,205269201,434
"2908","chr16",69762261,69762666,69762463,405
"2909","chr11",116835765,116836194,116835979,429
"2910","chr2",127664145,127664608,127664376,463
"2911","chr2",153477935,153478944,153478439,1009
"2912","chr8",142510206,142511313,142510759,1107
"2913","chr7",157002661,157006700,157004680,4039
"2914","chr8",102238525,102239848,102239186,1323
"2915","chr17",80544950,80545283,80545116,333
"2916","chr2",231530052,231530626,231530339,574
"2917","chr16",23510259,23510578,23510418,319
"2918","chr15",81000452,81003268,81001860,2816
"2919","chr5",10760724,10761813,10761268,1089
"2920","chr10",75431303,75431813,75431558,510
"2921","chr13",48532275,48533327,48532801,1052
"2922","chr15",38072794,38073127,38072960,333
"2923","chr12",131122206,131122454,131122330,248
"2924","chr12",122078287,122079301,122078794,1014
"2925","chr8",839976,840798,840387,822
"2926","chr6",31958712,31959163,31958937,451
"2927","chr2",239400083,239402225,239401154,2142
"2928","chr11",35618081,35619937,35619009,1856
"2929","chr4",107260,108013,107636,753
"2930","chr16",89152925,89153243,89153084,318
"2931","chr7",152893975,152894275,152894125,300
"2932","chr2",100321317,100322597,100321957,1280
"2933","chr18",31497589,31498563,31498076,974
"2934","chr8",17577139,17577445,17577292,306
"2935","chr7",56064085,56064533,56064309,448
"2936","chr15",45704255,45705206,45704730,951
"2937","chr15",67820903,67821256,67821079,353
"2938","chr10",11017479,11018794,11018136,1315
"2939","chr17",21452642,21453106,21452874,464
"2940","chr5",142012795,142013129,142012962,334
"2941","chr17",4554888,4555689,4555288,801
"2942","chr19",46296796,46297346,46297071,550
"2943","chr4",2058236,2061454,2059845,3218
"2944","chr1",75136313,75137124,75136718,811
"2945","chrX",54999926,55000552,55000239,626
"2946","chr17",2399671,2402190,2400930,2519
"2947","chr7",2646939,2647672,2647305,733
"2948","chr13",110313427,110313876,110313651,449
"2949","chr13",112452023,112452230,112452126,207
"2950","chr18",48948561,48948951,48948756,390
"2951","chr16",81779105,81779957,81779531,852
"2952","chr1",154760346,154760960,154760653,614
"2953","chr16",52545724,52547085,52546404,1361
"2954","chr16",1050626,1050848,1050737,222
"2955","chr11",118607592,118611181,118609386,3589
"2956","chr17",75730157,75730445,75730301,288
"2957","chr4",39697739,39698499,39698119,760
"2958","chr4",6657544,6658060,6657802,516
"2959","chr1",10638242,10640041,10639141,1799
"2960","chr1",933952,934964,934458,1012
"2961","chr1",74198142,74198351,74198246,209
"2962","chr15",88255423,88255783,88255603,360
"2963","chr1",155084711,155085580,155085145,869
"2964","chr7",82442705,82444204,82443454,1499
"2965","chr16",3192622,3192912,3192767,290
"2966","chr10",32980583,32980942,32980762,359
"2967","chr2",1262647,1262889,1262768,242
"2968","chr11",22625160,22625895,22625527,735
"2969","chr6",167976736,167977044,167976890,308
"2970","chr15",62697715,62697993,62697854,278
"2971","chr17",81071654,81071896,81071775,242
"2972","chr22",17628366,17628906,17628636,540
"2973","chr1",209231500,209232128,209231814,628
"2974","chr16",15856982,15857409,15857195,427
"2975","chr3",6862446,6862954,6862700,508
"2976","chr1",1197447,1197838,1197642,391
"2977","chr4",112523025,112523233,112523129,208
"2978","chr4",112510669,112511440,112511054,771
"2979","chr4",6727184,6727473,6727328,289
"2980","chr7",52273772,52274570,52274171,798
"2981","chr17",45316525,45317572,45317048,1047
"2982","chr10",17228431,17230618,17229524,2187
"2983","chr12",75511439,75511738,75511588,299
"2984","chr1",154973761,154974022,154973891,261
"2985","chr1",26169688,26170333,26170010,645
"2986","chr22",46027404,46027822,46027613,418
"2987","chr17",2511767,2512068,2511917,301
"2988","chr17",1908179,1908803,1908491,624
"2989","chr7",136869107,136871447,136870277,2340
"2990","chr16",70679558,70680476,70680017,918
"2991","chr1",41661709,41662961,41662335,1252
"2992","chr15",22786169,22787626,22786897,1457
"2993","chr22",48500563,48500779,48500671,216
"2994","chr12",120317543,120317869,120317706,326
"2995","chr1",10398491,10399940,10399215,1449
"2996","chr1",24902005,24902641,24902323,636
"2997","chr6",125363398,125363719,125363558,321
"2998","chrX",71118430,71119016,71118723,586
"2999","chr7",128270807,128271234,128271020,427
"3000","chr19",3868588,3868839,3868713,251
"3001","chr1",67832688,67833768,67833228,1080
"3002","chr12",53452360,53452822,53452591,462
"3003","chr7",134127252,134127480,134127366,228
"3004","chrX",25002120,25006090,25004105,3970
"3005","chr7",5419560,5429625,5424592,10065
"3006","chr17",82898998,82899476,82899237,478
"3007","chr4",1215977,1216405,1216191,428
"3008","chr16",31529526,31529762,31529644,236
"3009","chr8",47260668,47261499,47261083,831
"3010","chr1",241424301,241424583,241424442,282
"3011","chr22",20354361,20362265,20358313,7904
"3012","chrX",49879303,49879883,49879593,580
"3013","chr16",56682080,56682513,56682296,433
"3014","chr12",34350419,34350679,34350549,260
"3015","chr4",123505714,123506002,123505858,288
"3016","chr2",1282621,1282870,1282745,249
"3017","chr7",67286119,67286346,67286232,227
"3018","chr1",44739651,44740073,44739862,422
"3019","chr18",22200656,22200936,22200796,280
"3020","chr8",882244,882918,882581,674
"3021","chr1",160801893,160802163,160802028,270
"3022","chr22",26589552,26590300,26589926,748
"3023","chr10",132505800,132506642,132506221,842
"3024","chr10",92699497,92699834,92699665,337
"3025","chr1",35573248,35574450,35573849,1202
"3026","chr1",9356067,9356345,9356206,278
"3027","chr3",10115445,10115928,10115686,483
"3028","chr15",100292020,100292414,100292217,394
"3029","chr1",155125958,155127975,155126966,2017
"3030","chr6",5134938,5135561,5135249,623
"3031","chr19",55536036,55536301,55536168,265
"3032","chr20",13220023,13221969,13220996,1946
"3033","chr10",129779186,129779478,129779332,292
"3034","chr1",227317745,227319051,227318398,1306
"3035","chr9",131530638,131531786,131531212,1148
"3036","chr15",89399361,89400622,89399991,1261
"3037","chr3",127822427,127823419,127822923,992
"3038","chr15",42207962,42208363,42208162,401
"3039","chr7",1411484,1411766,1411625,282
"3040","chr17",78040904,78041242,78041073,338
"3041","chr2",233204277,233204776,233204526,499
"3042","chr16",19113814,19115285,19114549,1471
"3043","chrX",107826326,107826971,107826648,645
"3044","chr3",50088819,50089771,50089295,952
"3045","chr16",3023877,3024442,3024159,565
"3046","chr18",78866509,78866769,78866639,260
"3047","chr3",131502760,131503044,131502902,284
"3048","chr1",219173767,219174230,219173998,463
"3049","chr20",25602409,25603017,25602713,608
"3050","chr16",89854510,89854713,89854611,203
"3051","chrX",40145052,40147813,40146432,2761
"3052","chr4",170089792,170090352,170090072,560
"3053","chr3",185152397,185153694,185153045,1297
"3054","chr18",69402697,69402935,69402816,238
"3055","chr2",71068030,71068872,71068451,842
"3056","chrX",78103806,78104482,78104144,676
"3057","chr8",90791428,90791913,90791670,485
"3058","chr2",197309934,197310677,197310305,743
"3059","chr4",7938836,7940126,7939481,1290
"3060","chr6",16327938,16328332,16328135,394
"3061","chr10",93993590,93994444,93994017,854
"3062","chr1",52141728,52142832,52142280,1104
"3063","chr1",174021667,174022711,174022189,1044
"3064","chr7",140478489,140479667,140479078,1178
"3065","chr1",1598951,1600756,1599853,1805
"3066","chr1",28775278,28775557,28775417,279
"3067","chr3",169764550,169765264,169764907,714
"3068","chr16",515420,515781,515600,361
"3069","chr18",79393870,79400806,79397338,6936
"3070","chr2",99140892,99141757,99141324,865
"3071","chr16",75265078,75266288,75265683,1210
"3072","chr1",154571342,154572237,154571789,895
"3073","chr13",40789299,40790183,40789741,884
"3074","chr1",50418556,50425799,50422177,7243
"3075","chr5",52799977,52800191,52800084,214
"3076","chr20",62641925,62643565,62642745,1640
"3077","chr1",166920539,166921412,166920975,873
"3078","chr1",156927407,156928004,156927705,597
"3079","chr10",125027159,125027360,125027259,201
"3080","chr16",56424764,56425836,56425300,1072
"3081","chr17",36601404,36602361,36601882,957
"3082","chr15",64905600,64905864,64905732,264
"3083","chr8",143211238,143211764,143211501,526
"3084","chr17",61927528,61928055,61927791,527
"3085","chr1",63773794,63775108,63774451,1314
"3086","chr16",88634047,88635165,88634606,1118
"3087","chr1",218164438,218165691,218165064,1253
"3088","chr4",122379252,122379650,122379451,398
"3089","chr6",28136679,28136890,28136784,211
"3090","chr1",153260996,153261837,153261416,841
"3091","chr7",66474411,66474766,66474588,355
"3092","chr3",50358916,50359744,50359330,828
"3093","chr18",56638188,56638856,56638522,668
"3094","chr1",3287201,3287889,3287545,688
"3095","chr16",57092132,57093184,57092658,1052
"3096","chr10",128540431,128540730,128540580,299
"3097","chr21",41778048,41778555,41778301,507
"3098","chr13",52159237,52159726,52159481,489
"3099","chr3",190862715,190863069,190862892,354
"3100","chr1",2502147,2502626,2502386,479
"3101","chr5",173243826,173244821,173244323,995
"3102","chr3",46701274,46701596,46701435,322
"3103","chr11",58578200,58579848,58579024,1648
"3104","chr1",64965772,64966931,64966351,1159
"3105","chr20",1803178,1803906,1803542,728
"3106","chr16",84222583,84222856,84222719,273
"3107","chr15",20877684,20879019,20878351,1335
"3108","chr15",92714518,92714992,92714755,474
"3109","chr9",132708667,132709014,132708840,347
"3110","chr16",88784336,88785866,88785101,1530
"3111","chr6",79537192,79537703,79537447,511
"3112","chr11",71522485,71522855,71522670,370
"3113","chr1",248858212,248859220,248858716,1008
"3114","chr6",30690824,30691248,30691036,424
"3115","chr8",143635696,143636628,143636162,932
"3116","chr16",71883520,71884639,71884079,1119
"3117","chr8",144798517,144799349,144798933,832
"3118","chr16",89217354,89218208,89217781,854
"3119","chr6",30061159,30061418,30061288,259
"3120","chr1",2194449,2195203,2194826,754
"3121","chr12",84911421,84911643,84911532,222
"3122","chr8",1297411,1298205,1297808,794
"3123","chr1",168225707,168226601,168226154,894
"3124","chr8",4991446,4995113,4993279,3667
"3125","chr1",109283088,109283585,109283336,497
"3126","chr7",39949323,39952013,39950668,2690
"3127","chr1",43649945,43650638,43650291,693
"3128","chr15",89776352,89777245,89776798,893
"3129","chr12",124566250,124567848,124567049,1598
"3130","chr1",12166819,12167655,12167237,836
"3131","chr6",50845601,50845986,50845793,385
"3132","chr1",243849410,243851290,243850350,1880
"3133","chr6",89145926,89146819,89146372,893
"3134","chr2",218892736,218893279,218893007,543
"3135","chr7",100015481,100016174,100015827,693
"3136","chr12",116276650,116278182,116277416,1532
"3137","chr1",11099330,11100079,11099704,749
"3138","chr12",132189145,132190696,132189920,1551
"3139","chr15",60397550,60398231,60397890,681
"3140","chr19",12801117,12802104,12801610,987
"3141","chr6",33204512,33205046,33204779,534
"3142","chr15",41416709,41417753,41417231,1044
"3143","chr7",155573611,155573975,155573793,364
"3144","chr15",28132625,28132828,28132726,203
"3145","chr9",135119760,135119969,135119864,209
"3146","chr22",49802174,49802737,49802455,563
"3147","chr6",169024137,169025426,169024781,1289
"3148","chr1",85464257,85465485,85464871,1228
"3149","chr11",63613671,63614512,63614091,841
"3150","chr11",130069041,130071020,130070030,1979
"3151","chr7",44999572,45000658,45000115,1086
"3152","chr2",75560591,75561186,75560888,595
"3153","chr10",11463223,11463767,11463495,544
"3154","chr1",212858017,212858777,212858397,760
"3155","chr11",119422636,119423233,119422934,597
"3156","chr6",133242563,133242767,133242665,204
"3157","chr7",106009580,106009787,106009683,207
"3158","chr8",1831454,1831655,1831554,201
"3159","chr20",44310810,44311403,44311106,593
"3160","chr5",148653909,148654517,148654213,608
"3161","chr8",143770607,143772226,143771416,1619
"3162","chr1",39770095,39771518,39770806,1423
"3163","chr5",172187426,172188935,172188180,1509
"3164","chr11",64741961,64746354,64744157,4393
"3165","chrX",19343608,19344361,19343984,753
"3166","chr12",118016586,118016869,118016727,283
"3167","chr12",94459560,94460531,94460045,971
"3168","chr1",54764410,54764696,54764553,286
"3169","chr13",40535352,40535611,40535481,259
"3170","chr8",25184280,25185305,25184792,1025
"3171","chr2",24123120,24123923,24123521,803
"3172","chrX",152698699,152698991,152698845,292
"3173","chr11",35944066,35944904,35944485,838
"3174","chr7",151875676,151878021,151876848,2345
"3175","chr6",112366875,112367528,112367201,653
"3176","chr9",135789035,135789313,135789174,278
"3177","chr8",73448814,73449174,73448994,360
"3178","chr11",66466428,66467493,66466960,1065
"3179","chr6",168535772,168535984,168535878,212
"3180","chr7",757044,757289,757166,245
"3181","chr14",60509014,60511462,60510238,2448
"3182","chr1",10888467,10889109,10888788,642
"3183","chr8",699637,700596,700116,959
"3184","chr10",107914438,107915206,107914822,768
"3185","chr6",159168604,159170287,159169445,1683
"3186","chr7",35694385,35695369,35694877,984
"3187","chr12",7705903,7706189,7706046,286
"3188","chr13",24718607,24718898,24718752,291
"3189","chr1",108559916,108560590,108560253,674
"3190","chr14",64879393,64880628,64880010,1235
"3191","chr18",50193496,50195372,50194434,1876
"3192","chr10",99530268,99530581,99530424,313
"3193","chr1",6454048,6455985,6455016,1937
"3194","chr17",48995458,48998680,48997069,3222
"3195","chr10",125895680,125896969,125896324,1289
"3196","chr2",73737191,73737550,73737370,359
"3197","chr12",132719637,132719909,132719773,272
"3198","chrX",137427117,137427654,137427385,537
"3199","chr7",122316489,122317287,122316888,798
"3200","chr2",1842654,1843136,1842895,482
"3201","chr8",19461519,19461744,19461631,225
"3202","chr17",61456360,61457893,61457126,1533
"3203","chr20",63534121,63534369,63534245,248
"3204","chr7",37447751,37449069,37448410,1318
"3205","chr1",85708358,85708570,85708464,212
"3206","chr1",99969741,99970514,99970127,773
"3207","chr12",108591848,108592051,108591949,203
"3208","chr7",101201769,101202445,101202107,676
"3209","chr4",84965655,84966624,84966139,969
"3210","chr20",5119347,5120220,5119783,873
"3211","chr22",38201778,38202981,38202379,1203
"3212","chr22",41468416,41469439,41468927,1023
"3213","chr8",143815113,143816446,143815779,1333
"3214","chr10",112952356,112952785,112952570,429
"3215","chr12",53295443,53295786,53295614,343
"3216","chr8",6566694,6567367,6567030,673
"3217","chr20",36431654,36431859,36431756,205
"3218","chr19",14433061,14433892,14433476,831
"3219","chr8",798280,798544,798412,264
"3220","chr10",132358247,132358522,132358384,275
"3221","chr21",46129024,46129513,46129268,489
"3222","chr2",236123913,236124212,236124062,299
"3223","chr16",49600667,49600878,49600772,211
"3224","chr1",184386281,184387490,184386885,1209
"3225","chr13",27977377,27978836,27978106,1459
"3226","chr10",15096966,15097852,15097409,886
"3227","chr1",158180830,158181713,158181271,883
"3228","chr2",151827961,151828617,151828289,656
"3229","chr8",52564984,52566067,52565525,1083
"3230","chr12",48782644,48783371,48783007,727
"3231","chr8",65841354,65842715,65842034,1361
"3232","chr4",133150507,133152473,133151490,1966
"3233","chr6",28383345,28383664,28383504,319
"3234","chr2",20446667,20448227,20447447,1560
"3235","chr17",30921829,30922908,30922368,1079
"3236","chr4",1013249,1013500,1013374,251
"3237","chr1",31703936,31704268,31704102,332
"3238","chr3",161104706,161105472,161105089,766
"3239","chr1",29260575,29260900,29260737,325
"3240","chr16",23754648,23755548,23755098,900
"3241","chr8",2561843,2562368,2562105,525
"3242","chr17",31936742,31937496,31937119,754
"3243","chr2",105893071,105893539,105893305,468
"3244","chr3",157542877,157543435,157543156,558
"3245","chr4",17511686,17512358,17512022,672
"3246","chr1",111755419,111756370,111755894,951
"3247","chr1",161725847,161727508,161726677,1661
"3248","chr16",89972122,89973175,89972648,1053
"3249","chr1",234231389,234231750,234231569,361
"3250","chr6",113970247,113971603,113970925,1356
"3251","chr9",137167283,137170412,137168847,3129
"3252","chr16",66830504,66831088,66830796,584
"3253","chr6",153002399,153003185,153002792,786
"3254","chr2",63622750,63623030,63622890,280
"3255","chr8",103298581,103299392,103298986,811
"3256","chr8",89901969,89903112,89902540,1143
"3257","chr11",19116979,19117669,19117324,690
"3258","chr8",94553429,94553783,94553606,354
"3259","chr1",62687709,62688678,62688193,969
"3260","chr10",133201199,133201898,133201548,699
"3261","chr8",97643825,97645002,97644413,1177
"3262","chr8",81686032,81686449,81686240,417
"3263","chr3",183098983,183099667,183099325,684
"3264","chr1",167715042,167715255,167715148,213
"3265","chr2",42169161,42169793,42169477,632
"3266","chr22",20020824,20021143,20020983,319
"3267","chr4",2926326,2926544,2926435,218
"3268","chr2",112481672,112483007,112482339,1335
"3269","chr3",10992557,10993698,10993127,1141
"3270","chr4",8580486,8581637,8581061,1151
"3271","chr16",30761209,30762682,30761945,1473
"3272","chr6",52994767,52994969,52994868,202
"3273","chr2",158968342,158969889,158969115,1547
"3274","chr1",10430143,10431015,10430579,872
"3275","chr19",16495929,16496633,16496281,704
"3276","chr16",85496233,85496522,85496377,289
"3277","chr9",32526146,32526426,32526286,280
"3278","chr1",220748069,220748555,220748312,486
"3279","chr10",133235293,133238573,133236933,3280
"3280","chr8",130357841,130359071,130358456,1230
"3281","chr16",15055347,15056250,15055798,903
"3282","chr17",60599862,60600856,60600359,994
"3283","chr2",131300168,131300523,131300345,355
"3284","chr12",132358785,132359566,132359175,781
"3285","chr17",4498664,4500028,4499346,1364
"3286","chr1",237041826,237043344,237042585,1518
"3287","chr11",43942076,43944498,43943287,2422
"3288","chr1",184664089,184664529,184664309,440
"3289","chr17",18182944,18185046,18183995,2102
"3290","chr4",83284228,83284867,83284547,639
"3291","chr8",127735559,127739033,127737296,3474
"3292","chr17",49191969,49193072,49192520,1103
"3293","chr20",10433628,10434345,10433986,717
"3294","chr1",75796851,75797218,75797034,367
"3295","chr1",224114206,224114770,224114488,564
"3296","chr1",214550761,214552185,214551473,1424
"3297","chr1",239386955,239388039,239387497,1084
"3298","chr18",37394026,37394501,37394263,475
"3299","chr3",86990460,86991366,86990913,906
"3300","chr4",3563584,3565458,3564521,1874
"3301","chr21",44706975,44707185,44707080,210
"3302","chr16",81314745,81315921,81315333,1176
"3303","chr6",98824518,98825138,98824828,620
"3304","chr1",61083081,61083750,61083415,669
"3305","chr8",98939792,98942458,98941125,2666
"3306","chr12",131492923,131493298,131493110,375
"3307","chr2",173354805,173355640,173355222,835
"3308","chr2",19901243,19902306,19901774,1063
"3309","chr22",30425637,30426022,30425829,385
"3310","chr2",161237949,161239684,161238816,1735
"3311","chr4",4852886,4853483,4853184,597
"3312","chr17",32495899,32496192,32496045,293
"3313","chr17",82392314,82392532,82392423,218
"3314","chr22",31107250,31107885,31107567,635
"3315","chr1",225475063,225475339,225475201,276
"3316","chr1",24907937,24908316,24908126,379
"3317","chr2",131657820,131658208,131658014,388
"3318","chr18",36128956,36130273,36129614,1317
"3319","chr1",25543402,25544551,25543976,1149
"3320","chr16",88487946,88488439,88488192,493
"3321","chr16",79589594,79590060,79589827,466
"3322","chr19",10027715,10027940,10027827,225
"3323","chr12",55974099,55974388,55974243,289
"3324","chr22",50269761,50272004,50270882,2243
"3325","chr2",208254154,208254527,208254340,373
"3326","chr2",73291236,73293858,73292547,2622
"3327","chr17",44959798,44960372,44960085,574
"3328","chr6",25139692,25140018,25139855,326
"3329","chr1",202957751,202958568,202958159,817
"3330","chr13",51451555,51453810,51452682,2255
"3331","chr1",94417969,94418846,94418407,877
"3332","chr1",212950305,212951750,212951027,1445
"3333","chr1",69567284,69568812,69568048,1528
"3334","chr6",42929378,42929873,42929625,495
"3335","chr15",41900715,41901057,41900886,342
"3336","chr1",22576309,22576920,22576614,611
"3337","chr1",201170746,201171376,201171061,630
"3338","chr6",138107051,138107679,138107365,628
"3339","chr4",67545275,67545657,67545466,382
"3340","chr5",75510756,75512149,75511452,1393
"3341","chr1",61654202,61654421,61654311,219
"3342","chr2",63044992,63045274,63045133,282
"3343","chr18",13387386,13387687,13387536,301
"3344","chr13",72781565,72782474,72782019,909
"3345","chr17",30824463,30824883,30824673,420
"3346","chr4",182916883,182917717,182917300,834
"3347","chr3",50192997,50194911,50193954,1914
"3348","chr2",40451337,40451577,40451457,240
"3349","chr7",93043475,93043702,93043588,227
"3350","chr1",32013501,32014982,32014241,1481
"3351","chr3",10108066,10108382,10108224,316
"3352","chr22",38272379,38273070,38272724,691
"3353","chr8",101126365,101126880,101126622,515
"3354","chr20",56468319,56468710,56468514,391
"3355","chr6",149450700,149451719,149451209,1019
"3356","chr2",239084086,239084332,239084209,246
"3357","chr14",100883035,100883523,100883279,488
"3358","chr3",12899254,12899635,12899444,381
"3359","chr2",157597287,157597599,157597443,312
"3360","chr3",117996717,117997717,117997217,1000
"3361","chr1",166839104,166840107,166839605,1003
"3362","chr10",87094000,87095741,87094870,1741
"3363","chr5",44808945,44809590,44809267,645
"3364","chr7",43758224,43759241,43758732,1017
"3365","chr7",150368080,150369262,150368671,1182
"3366","chr17",6069995,6071129,6070562,1134
"3367","chr2",71331593,71332395,71331994,802
"3368","chr4",13627621,13628031,13627826,410
"3369","chr16",70473123,70473343,70473233,220
"3370","chr22",43421191,43421450,43421320,259
"3371","chr17",14206880,14207257,14207068,377
"3372","chr11",112290092,112290478,112290285,386
"3373","chr1",3530885,3531495,3531190,610
"3374","chr6",32838507,32838892,32838699,385
"3375","chr11",70270131,70271391,70270761,1260
"3376","chr22",42283457,42283917,42283687,460
"3377","chr3",195259603,195260546,195260074,943
"3378","chr6",12749645,12750025,12749835,380
"3379","chr4",159102635,159103983,159103309,1348
"3380","chr9",130712478,130713514,130712996,1036
"3381","chr19",3097566,3097795,3097680,229
"3382","chr1",853483,853831,853657,348
"3383","chr12",120086882,120087295,120087088,413
"3384","chrX",119150556,119151102,119150829,546
"3385","chr20",4686181,4687228,4686704,1047
"3386","chr7",116862373,116863102,116862737,729
"3387","chr21",38822720,38822925,38822822,205
"3388","chr2",159286096,159287056,159286576,960
"3389","chr4",151099318,151099958,151099638,640
"3390","chr10",35607590,35608324,35607957,734
"3391","chr8",61713997,61714952,61714474,955
"3392","chr6",32087290,32087824,32087557,534
"3393","chr1",36176155,36176860,36176507,705
"3394","chr16",89421352,89421750,89421551,398
"3395","chr12",6534095,6535441,6534768,1346
"3396","chr19",6530815,6531541,6531178,726
"3397","chr6",104859244,104860041,104859642,797
"3398","chr12",124426697,124426918,124426807,221
"3399","chr4",140426888,140427803,140427345,915
"3400","chr20",56343980,56344301,56344140,321
"3401","chr3",50567474,50567928,50567701,454
"3402","chr6",27495397,27495600,27495498,203
"3403","chr3",87089075,87089396,87089235,321
"3404","chr3",134373415,134374899,134374157,1484
"3405","chr8",143486745,143488502,143487623,1757
"3406","chr5",177116899,177117227,177117063,328
"3407","chr12",121626271,121627236,121626753,965
"3408","chr1",3022069,3022479,3022274,410
"3409","chr17",41648488,41648746,41648617,258
"3410","chr20",51800773,51802506,51801639,1733
"3411","chr16",89042478,89042722,89042600,244
"3412","chr10",118754516,118755596,118755056,1080
"3413","chr4",744636,747729,746182,3093
"3414","chr10",84194443,84195547,84194995,1104
"3415","chr6",108164467,108170083,108167275,5616
"3416","chr19",37370789,37371331,37371060,542
"3417","chr17",44363154,44364029,44363591,875
"3418","chr6",154733052,154734269,154733660,1217
"3419","chr7",100088917,100089216,100089066,299
"3420","chr10",131075393,131075612,131075502,219
"3421","chr6",46734999,46735579,46735289,580
"3422","chr3",11272203,11272451,11272327,248
"3423","chrX",47623643,47623965,47623804,322
"3424","chr6",71288403,71289406,71288904,1003
"3425","chr20",62216253,62216662,62216457,409
"3426","chr4",134944225,134944430,134944327,205
"3427","chr4",152935960,152938093,152937026,2133
"3428","chr1",244461199,244461618,244461408,419
"3429","chr12",107317826,107320330,107319078,2504
"3430","chr16",56635125,56635815,56635470,690
"3431","chr17",42577426,42577947,42577686,521
"3432","chr17",14069313,14069768,14069540,455
"3433","chr13",51251561,51251908,51251734,347
"3434","chr17",60677264,60678119,60677691,855
"3435","chr1",109619842,109620094,109619968,252
"3436","chr3",124886212,124887882,124887047,1670
"3437","chr1",2134928,2135227,2135077,299
"3438","chr21",39380161,39380899,39380530,738
"3439","chr12",203425,204165,203795,740
"3440","chr4",87422525,87423007,87422766,482
"3441","chr20",36815513,36816184,36815848,671
"3442","chr1",35191866,35192723,35192294,857
"3443","chr7",80134477,80135573,80135025,1096
"3444","chr7",1115667,1117809,1116738,2142
"3445","chr12",122500644,122501097,122500870,453
"3446","chr7",5513580,5513886,5513733,306
"3447","chr15",72229790,72231897,72230843,2107
"3448","chr1",148317536,148317864,148317700,328
"3449","chr3",125374824,125375521,125375172,697
"3450","chr6",52576628,52577588,52577108,960
"3451","chr1",23568013,23568574,23568293,561
"3452","chr10",50622712,50625395,50624053,2683
"3453","chr1",35718647,35719185,35718916,538
"3454","chr16",9090289,9092832,9091560,2543
"3455","chr3",150545822,150546820,150546321,998
"3456","chr4",183398411,183399045,183398728,634
"3457","chr8",23402929,23404354,23403641,1425
"3458","chr18",47930113,47931653,47930883,1540
"3459","chr10",123154115,123155210,123154662,1095
"3460","chr1",17696986,17697297,17697141,311
"3461","chr12",49706659,49707804,49707231,1145
"3462","chr1",27725634,27726491,27726062,857
"3463","chr21",31557614,31559704,31558659,2090
"3464","chr1",111448682,111449580,111449131,898
"3465","chr7",1452137,1452339,1452238,202
"3466","chr1",223363500,223365286,223364393,1786
"3467","chr1",54356317,54356660,54356488,343
"3468","chr20",36305883,36307292,36306587,1409
"3469","chr1",58249600,58250423,58250011,823
"3470","chr16",84052261,84052510,84052385,249
"3471","chr1",22953060,22954076,22953568,1016
"3472","chr1",103525470,103526291,103525880,821
"3473","chr12",89351391,89354367,89352879,2976
"3474","chr7",6447675,6448119,6447897,444
"3475","chr8",143359700,143360268,143359984,568
"3476","chr20",1466291,1467084,1466687,793
"3477","chr1",210292364,210292867,210292615,503
"3478","chrX",107449451,107450493,107449972,1042
"3479","chr1",1398691,1400222,1399456,1531
"3480","chr12",106302424,106303421,106302922,997
"3481","chr1",118987196,118988089,118987642,893
"3482","chr6",42104294,42104963,42104628,669
"3483","chr12",38163526,38163891,38163708,365
"3484","chr15",63833315,63834466,63833890,1151
"3485","chr1",156728319,156729124,156728721,805
"3486","chr11",101129215,101129706,101129460,491
"3487","chr1",180154420,180155449,180154934,1029
"3488","chr6",32971498,32973177,32972337,1679
"3489","chr3",113211590,113212659,113212124,1069
"3490","chr12",55707428,55708174,55707801,746
"3491","chr3",9396261,9398076,9397168,1815
"3492","chr3",49411428,49412532,49411980,1104
"3493","chr7",10779678,10780083,10779880,405
"3494","chr10",124916551,124917643,124917097,1092
"3495","chr17",77528507,77529070,77528788,563
"3496","chr1",165235264,165236270,165235767,1006
"3497","chr20",32357844,32359230,32358537,1386
"3498","chr14",23365226,23366738,23365982,1512
"3499","chr12",124660899,124661123,124661011,224
"3500","chr1",114510439,114511643,114511041,1204
"3501","chr3",65549009,65549669,65549339,660
"3502","chr6",47308719,47310087,47309403,1368
"3503","chr21",46393336,46393547,46393441,211
"3504","chr18",78796716,78797309,78797012,593
"3505","chr7",134458363,134459311,134458837,948
"3506","chr19",709227,709990,709608,763
"3507","chr3",122794879,122795630,122795254,751
"3508","chr1",32500543,32500962,32500752,419
"3509","chr2",168890209,168890495,168890352,286
"3510","chr6",28923174,28924236,28923705,1062
"3511","chr1",150515560,150515940,150515750,380
"3512","chr16",1964163,1965450,1964806,1287
"3513","chr6",29956424,29956756,29956590,332
"3514","chr17",78104598,78105034,78104816,436
"3515","chr14",101065306,101066047,101065676,741
"3516","chr20",20452461,20452685,20452573,224
"3517","chr6",33298525,33299805,33299165,1280
"3518","chr4",80386317,80386798,80386557,481
"3519","chr1",2172837,2173047,2172942,210
"3520","chr1",207496292,207496670,207496481,378
"3521","chr12",132400174,132400443,132400308,269
"3522","chr6",31728117,31728953,31728535,836
"3523","chr8",140549065,140549269,140549167,204
"3524","chr4",1578323,1578728,1578525,405
"3525","chr12",119988743,119990262,119989502,1519
"3526","chr18",74597281,74598728,74598004,1447
"3527","chr1",67429452,67431143,67430297,1691
"3528","chr7",6158864,6159100,6158982,236
"3529","chr13",114281279,114282559,114281919,1280
"3530","chr1",27006102,27006491,27006296,389
"3531","chr8",41797357,41798466,41797911,1109
"3532","chr21",44886593,44886880,44886736,287
"3533","chr17",6455094,6455635,6455364,541
"3534","chr6",6546137,6546997,6546567,860
"3535","chr8",141723905,141724153,141724029,248
"3536","chr1",202806875,202808599,202807737,1724
"3537","chr1",203128105,203128368,203128236,263
"3538","chr6",28814080,28814525,28814302,445
"3539","chr7",39413916,39414692,39414304,776
"3540","chr17",18971371,18971574,18971472,203
"3541","chr14",102928060,102930733,102929396,2673
"3542","chr3",148991289,148992282,148991785,993
"3543","chr20",2872253,2873989,2873121,1736
"3544","chr8",1235092,1235445,1235268,353
"3545","chr16",85972589,85974081,85973335,1492
"3546","chr20",63707307,63708922,63708114,1615
"3547","chr1",22600652,22601049,22600850,397
"3548","chr5",177303030,177304129,177303579,1099
"3549","chr1",149927733,149928001,149927867,268
"3550","chr16",84312870,84313325,84313097,455
"3551","chr21",42234736,42235355,42235045,619
"3552","chr10",114821572,114822675,114822123,1103
"3553","chr10",18140196,18141291,18140743,1095
"3554","chr5",73380293,73382594,73381443,2301
"3555","chr1",185156718,185157573,185157145,855
"3556","chrX",153662134,153662710,153662422,576
"3557","chr4",78939059,78939591,78939325,532
"3558","chr17",16386763,16387014,16386888,251
"3559","chr9",67858013,67859742,67858877,1729
"3560","chr8",141253928,141254216,141254072,288
"3561","chr17",47970703,47971457,47971080,754
"3562","chr10",3317822,3318756,3318289,934
"3563","chr1",180228984,180235840,180232412,6856
"3564","chr11",75768417,75769127,75768772,710
"3565","chr8",104223156,104223751,104223453,595
"3566","chr1",151070394,151071095,151070744,701
"3567","chr3",39051978,39052534,39052256,556
"3568","chr8",76682020,76682625,76682322,605
"3569","chr13",28138039,28139316,28138677,1277
"3570","chr16",56625195,56625748,56625471,553
"3571","chr8",102653929,102656633,102655281,2704
"3572","chr18",50878765,50879613,50879189,848
"3573","chr12",131661159,131662265,131661712,1106
"3574","chr8",1200825,1201237,1201031,412
"3575","chr1",16644360,16644997,16644678,637
"3576","chr17",82814916,82815127,82815021,211
"3577","chr3",62318839,62319105,62318972,266
"3578","chr4",22515233,22516425,22515829,1192
"3579","chr1",236395159,236395850,236395504,691
"3580","chr4",139279910,139280295,139280102,385
"3581","chr1",27547906,27548127,27548016,221
"3582","chr2",174343687,174344348,174344017,661
"3583","chr2",232502756,232503867,232503311,1111
"3584","chr12",59595870,59596726,59596298,856
"3585","chr6",155314084,155314748,155314416,664
"3586","chr3",111674480,111674697,111674588,217
"3587","chr7",132575715,132577768,132576741,2053
"3588","chrX",119852721,119853289,119853005,568
"3589","chr17",81715495,81715737,81715616,242
"3590","chr16",74406753,74407493,74407123,740
"3591","chrX",38220438,38220897,38220667,459
"3592","chr4",90838888,90839116,90839002,228
"3593","chr10",129896410,129896669,129896539,259
"3594","chr17",14300851,14304385,14302618,3534
"3595","chr22",39532298,39533066,39532682,768
"3596","chr12",126726232,126727105,126726668,873
"3597","chr6",108294757,108295194,108294975,437
"3598","chr6",31631742,31631984,31631863,242
"3599","chr12",104215619,104216394,104216006,775
"3600","chr3",126541645,126542513,126542079,868
"3601","chr16",11249399,11249888,11249643,489
"3602","chr1",233361961,233362171,233362066,210
"3603","chr12",26195327,26196197,26195762,870
"3604","chr13",113671539,113672127,113671833,588
"3605","chr6",166412339,166412951,166412645,612
"3606","chr22",33919853,33922649,33921251,2796
"3607","chr13",94601560,94602315,94601937,755
"3608","chr16",55655686,55656983,55656334,1297
"3609","chr12",21941020,21942423,21941721,1403
"3610","chr13",30906135,30906968,30906551,833
"3611","chr3",194672079,194672649,194672364,570
"3612","chr6",77462514,77464375,77463444,1861
"3613","chr3",196568470,196569419,196568944,949
"3614","chr16",869858,870117,869987,259
"3615","chr4",153344455,153345242,153344848,787
"3616","chr16",4183244,4184726,4183985,1482
"3617","chr22",48980583,48980848,48980715,265
"3618","chr16",66844269,66845169,66844719,900
"3619","chr3",170870147,170870481,170870314,334
"3620","chr12",5432044,5433807,5432925,1763
"3621","chr15",47184172,47185302,47184737,1130
"3622","chr12",114403048,114403258,114403153,210
"3623","chr20",46011649,46012571,46012110,922
"3624","chr17",44970179,44970586,44970382,407
"3625","chr12",95858777,95859251,95859014,474
"3626","chr6",44152603,44152832,44152717,229
"3627","chr16",2183796,2184125,2183960,329
"3628","chr6",170022990,170024453,170023721,1463
"3629","chr10",12129226,12130039,12129632,813
"3630","chr1",121183931,121187361,121185646,3430
"3631","chr10",69248516,69248722,69248619,206
"3632","chr3",143119043,143121996,143120519,2953
"3633","chr20",2558487,2559046,2558766,559
"3634","chr2",84290590,84290827,84290708,237
"3635","chr20",49219246,49219530,49219388,284
"3636","chr3",59049680,59050218,59049949,538
"3637","chr1",85576546,85577252,85576899,706
"3638","chr19",34254313,34255299,34254806,986
"3639","chr4",52658797,52660060,52659428,1263
"3640","chr7",155491323,155491661,155491492,338
"3641","chr10",100986776,100987744,100987260,968
"3642","chr16",28822583,28824552,28823567,1969
"3643","chr3",31531810,31533790,31532800,1980
"3644","chr2",186693889,186694285,186694087,396
"3645","chr8",125429229,125431310,125430269,2081
"3646","chr12",122183101,122183491,122183296,390
"3647","chr6",2988621,2989315,2988968,694
"3648","chr13",27924089,27924909,27924499,820
"3649","chr8",9150548,9151843,9151195,1295
"3650","chr9",136515515,136515767,136515641,252
"3651","chr1",8324327,8324659,8324493,332
"3652","chr15",51341527,51342121,51341824,594
"3653","chr17",66191594,66192468,66192031,874
"3654","chr22",31496050,31497111,31496580,1061
"3655","chr17",8118732,8118988,8118860,256
"3656","chr6",31180592,31180800,31180696,208
"3657","chr13",80339022,80339326,80339174,304
"3658","chr16",3045599,3047032,3046315,1433
"3659","chr7",122143892,122144609,122144250,717
"3660","chr7",73738386,73739386,73738886,1000
"3661","chr3",126212892,126213692,126213292,800
"3662","chr1",14598114,14599497,14598805,1383
"3663","chr2",196639467,196639834,196639650,367
"3664","chr10",129867752,129868051,129867901,299
"3665","chr22",49671007,49671336,49671171,329
"3666","chr11",804827,805608,805217,781
"3667","chr7",38311319,38311730,38311524,411
"3668","chr6",28104686,28105148,28104917,462
"3669","chr2",168455907,168457112,168456509,1205
"3670","chr13",38349820,38350276,38350048,456
"3671","chr7",131555754,131557088,131556421,1334
"3672","chr2",134009794,134010120,134009957,326
"3673","chr2",150485228,150486677,150485952,1449
"3674","chr16",74666407,74667107,74666757,700
"3675","chr6",105402606,105403382,105402994,776
"3676","chr3",100709225,100709825,100709525,600
"3677","chr20",57407575,57408018,57407796,443
"3678","chr6",170136273,170137703,170136988,1430
"3679","chr10",133021172,133022395,133021783,1223
"3680","chr8",1098559,1098873,1098716,314
"3681","chr11",8911026,8911747,8911386,721
"3682","chr6",33322593,33323310,33322951,717
"3683","chr7",54664086,54664786,54664436,700
"3684","chr16",66549333,66550232,66549782,899
"3685","chr12",26832549,26833588,26833068,1039
"3686","chr4",795037,795950,795493,913
"3687","chr22",41091257,41093155,41092206,1898
"3688","chr10",70815757,70816546,70816151,789
"3689","chr22",27796805,27802604,27799704,5799
"3690","chr12",54033241,54034925,54034083,1684
"3691","chr4",37890171,37891693,37890932,1522
"3692","chr1",52365731,52366388,52366059,657
"3693","chr18",76979306,76979510,76979408,204
"3694","chr5",139701416,139701617,139701516,201
"3695","chr3",128879333,128879860,128879596,527
"3696","chr16",83965279,83965534,83965406,255
"3697","chr17",81294567,81295667,81295117,1100
"3698","chr11",59898106,59898384,59898245,278
"3699","chr13",51583920,51585099,51584509,1179
"3700","chr6",158999433,159000261,158999847,828
"3701","chr4",1001694,1003753,1002723,2059
"3702","chr8",141903062,141903292,141903177,230
"3703","chr5",96807399,96808182,96807790,783
"3704","chr6",32095756,32097267,32096511,1511
"3705","chr6",135054611,135055003,135054807,392
"3706","chrX",34656390,34657610,34657000,1220
"3707","chr6",33391320,33392198,33391759,878
"3708","chr10",5888951,5890674,5889812,1723
"3709","chrX",140510940,140511417,140511178,477
"3710","chr4",186190785,186192132,186191458,1347
"3711","chr8",100145419,100145987,100145703,568
"3712","chr3",159763157,159765234,159764195,2077
"3713","chr16",3674343,3674848,3674595,505
"3714","chr7",27103562,27103860,27103711,298
"3715","chr1",15152723,15154975,15153849,2252
"3716","chr9",127802584,127803287,127802935,703
"3717","chr20",45416012,45416507,45416259,495
"3718","chrX",48475841,48476648,48476244,807
"3719","chr16",20741324,20741958,20741641,634
"3720","chr2",241149000,241150915,241149957,1915
"3721","chr22",23772987,23773280,23773133,293
"3722","chr6",1392814,1393935,1393374,1121
"3723","chr10",43350810,43351127,43350968,317
"3724","chr3",18443620,18445541,18444580,1921
"3725","chr10",125228007,125228757,125228382,750
"3726","chr8",38756896,38757718,38757307,822
"3727","chr10",21494269,21497491,21495880,3222
"3728","chr7",159030487,159031625,159031056,1138
"3729","chr2",176136493,176137055,176136774,562
"3730","chr3",47418124,47418537,47418330,413
"3731","chr15",51829619,51830255,51829937,636
"3732","chr5",497724,498315,498019,591
"3733","chr6",10837865,10838682,10838273,817
"3734","chr4",169270206,169271693,169270949,1487
"3735","chr16",46688652,46690195,46689423,1543
"3736","chrX",104013183,104013877,104013530,694
"3737","chr3",134250189,134251167,134250678,978
"3738","chr5",112707382,112707974,112707678,592
"3739","chr3",195872153,195872521,195872337,368
"3740","chr17",62627181,62628582,62627881,1401
"3741","chrX",46573619,46575467,46574543,1848
"3742","chr7",139108367,139109862,139109114,1495
"3743","chr8",2008760,2009011,2008885,251
"3744","chr3",74614355,74614970,74614662,615
"3745","chr5",170232826,170233225,170233025,399
"3746","chr22",39649530,39649956,39649743,426
"3747","chr13",109782266,109787833,109785049,5567
"3748","chrX",55488647,55489111,55488879,464
"3749","chr8",100157933,100158599,100158266,666
"3750","chr12",8180192,8180597,8180394,405
"3751","chrX",105822341,105823117,105822729,776
"3752","chr4",173500196,173500408,173500302,212
"3753","chr22",20298795,20300107,20299451,1312
"3754","chr11",20156062,20157278,20156670,1216
"3755","chr16",48496624,48496898,48496761,274
"3756","chr10",133062826,133065035,133063930,2209
"3757","chr15",26771745,26773873,26772809,2128
"3758","chr17",79832067,79835247,79833657,3180
"3759","chr16",55832735,55833086,55832910,351
"3760","chr16",30122899,30123505,30123202,606
"3761","chr18",78726313,78726864,78726588,551
"3762","chr16",71425878,71426435,71426156,557
"3763","chr17",19377687,19379228,19378457,1541
"3764","chr3",113838721,113838953,113838837,232
"3765","chr5",168262222,168262733,168262477,511
"3766","chr3",10816002,10816762,10816382,760
"3767","chr19",10289168,10294699,10291933,5531
"3768","chr17",70168772,70169579,70169175,807
"3769","chr17",79047659,79048407,79048033,748
"3770","chr9",35814652,35815122,35814887,470
"3771","chr7",140062181,140063445,140062813,1264
"3772","chr7",98981816,98982017,98981916,201
"3773","chr9",116154083,116154896,116154489,813
"3774","chr10",127397032,127397302,127397167,270
"3775","chr7",29884266,29884648,29884457,382
"3776","chr3",128426414,128426813,128426613,399
"3777","chr6",28863905,28864357,28864131,452
"3778","chr2",156329045,156329843,156329444,798
"3779","chr17",28728169,28729038,28728603,869
"3780","chr7",30771247,30771934,30771590,687
"3781","chr12",121095768,121096120,121095944,352
"3782","chr10",7818298,7819144,7818721,846
"3783","chrX",134544565,134545171,134544868,606
"3784","chrX",132022790,132023747,132023268,957
"3785","chr8",123416365,123417185,123416775,820
"3786","chr12",13101115,13101697,13101406,582
"3787","chr17",8288546,8289177,8288861,631
"3788","chr1",226308660,226309800,226309230,1140
"3789","chr10",479779,480101,479940,322
"3790","chrX",69503888,69506131,69505009,2243
"3791","chr11",46385354,46385891,46385622,537
"3792","chr3",181726621,181727212,181726916,591
"3793","chr8",66712373,66713189,66712781,816
"3794","chr3",100334604,100335109,100334856,505
"3795","chr3",195837876,195838146,195838011,270
"3796","chr9",93945834,93946205,93946019,371
"3797","chr17",1048506,1048838,1048672,332
"3798","chr2",176079359,176083718,176081538,4359
"3799","chr3",71583860,71584066,71583963,206
"3800","chr5",179805532,179807595,179806563,2063
"3801","chr17",75720943,75721767,75721355,824
"3802","chr18",31101357,31102396,31101876,1039
"3803","chr10",7171880,7172141,7172010,261
"3804","chr3",53891411,53892147,53891779,736
"3805","chr18",57434732,57441621,57438176,6889
"3806","chr16",84617354,84618247,84617800,893
"3807","chr6",11537304,11538696,11538000,1392
"3808","chr1",43591084,43591508,43591296,424
"3809","chr17",61462001,61462473,61462237,472
"3810","chr16",75647366,75648681,75648023,1315
"3811","chr8",24955432,24956785,24956108,1353
"3812","chr7",1952279,1952487,1952383,208
"3813","chr5",181160685,181161234,181160959,549
"3814","chr5",138337691,138338639,138338165,948
"3815","chr10",91632910,91633390,91633150,480
"3816","chr18",5196244,5197390,5196817,1146
"3817","chr8",56993141,56993893,56993517,752
"3818","chr14",22829775,22830104,22829939,329
"3819","chr13",75480716,75482663,75481689,1947
"3820","chr20",59577225,59577792,59577508,567
"3821","chr6",1310833,1313985,1312409,3152
"3822","chr6",168048390,168048669,168048529,279
"3823","chr3",124032807,124034352,124033579,1545
"3824","chr3",192916520,192918178,192917349,1658
"3825","chr10",15719424,15720102,15719763,678
"3826","chr16",28746638,28747479,28747058,841
"3827","chr17",43938475,43938701,43938588,226
"3828","chr10",79684407,79684718,79684562,311
"3829","chr10",129466684,129467446,129467065,762
"3830","chr16",89279055,89282113,89280584,3058
"3831","chr20",62952539,62952870,62952704,331
"3832","chr8",1701273,1701593,1701433,320
"3833","chr20",46689052,46689819,46689435,767
"3834","chr21",35886893,35887304,35887098,411
"3835","chr6",42259343,42259750,42259546,407
"3836","chr8",48396503,48396981,48396742,478
"3837","chr3",12967148,12967875,12967511,727
"3838","chr22",35399863,35400657,35400260,794
"3839","chr12",113077359,113078165,113077762,806
"3840","chr8",303718,305462,304590,1744
"3841","chr13",36819076,36819955,36819515,879
"3842","chr17",60391619,60392542,60392080,923
"3843","chr7",104328430,104329511,104328970,1081
"3844","chr6",26026932,26027398,26027165,466
"3845","chr17",75405136,75405907,75405521,771
"3846","chr6",89080418,89082062,89081240,1644
"3847","chr2",131827539,131830710,131829124,3171
"3848","chrX",68693457,68694292,68693874,835
"3849","chr9",32572998,32573229,32573113,231
"3850","chr17",60150700,60151000,60150850,300
"3851","chr15",60591099,60593151,60592125,2052
"3852","chr6",73299097,73299733,73299415,636
"3853","chr17",48678203,48678644,48678423,441
"3854","chr9",969597,971047,970322,1450
"3855","chr15",88467213,88468001,88467607,788
"3856","chr20",46210156,46210565,46210360,409
"3857","chr16",68698155,68698403,68698279,248
"3858","chr3",138115006,138115750,138115378,744
"3859","chr10",35336121,35337612,35336866,1491
"3860","chr12",48329540,48330093,48329816,553
"3861","chr4",48830790,48831552,48831171,762
"3862","chr16",8621559,8621867,8621713,308
"3863","chr3",13548914,13549508,13549211,594
"3864","chr12",57006084,57006688,57006386,604
"3865","chr2",113198766,113199465,113199115,699
"3866","chr13",52195421,52195743,52195582,322
"3867","chr3",140682617,140683144,140682880,527
"3868","chr9",85522694,85523070,85522882,376
"3869","chr8",19237446,19237866,19237656,420
"3870","chr21",44801473,44802541,44802007,1068
"3871","chr16",28497916,28498188,28498052,272
"3872","chr6",71419805,71421053,71420429,1248
"3873","chr10",133098472,133098979,133098725,507
"3874","chr13",24745530,24748117,24746823,2587
"3875","chr9",104747625,104748487,104748056,862
"3876","chr15",94231386,94231750,94231568,364
"3877","chr17",43545236,43546797,43546016,1561
"3878","chr4",47032410,47032923,47032666,513
"3879","chr15",42079436,42079644,42079540,208
"3880","chr8",54621243,54621473,54621358,230
"3881","chr11",102047342,102047762,102047552,420
"3882","chrX",114584406,114584980,114584693,574
"3883","chr16",88803372,88804184,88803778,812
"3884","chr12",101738975,101739637,101739306,662
"3885","chr15",74365697,74366233,74365965,536
"3886","chr16",4624705,4625210,4624957,505
"3887","chr3",16264629,16265479,16265054,850
"3888","chr2",108533874,108534845,108534359,971
"3889","chr5",154477478,154479553,154478515,2075
"3890","chr1",47444040,47445348,47444694,1308
"3891","chr15",36880272,36880817,36880544,545
"3892","chr12",108129184,108129696,108129440,512
"3893","chr10",68527203,68527639,68527421,436
"3894","chr9",137254753,137255880,137255316,1127
"3895","chrX",136766871,136768019,136767445,1148
"3896","chr12",109093302,109093554,109093428,252
"3897","chr12",109477326,109477833,109477579,507
"3898","chr7",54933183,54933396,54933289,213
"3899","chrX",40832707,40833193,40832950,486
"3900","chr17",13600512,13602242,13601377,1730
"3901","chr7",1275414,1276285,1275849,871
"3902","chr15",76311222,76311685,76311453,463
"3903","chr17",19003596,19004930,19004263,1334
"3904","chr17",78425360,78425685,78425522,325
"3905","chr19",38831624,38831934,38831779,310
"3906","chr6",73653479,73654283,73653881,804
"3907","chr17",75587757,75590256,75589006,2499
"3908","chr15",29821502,29823012,29822257,1510
"3909","chr16",28740761,28741011,28740886,250
"3910","chr3",4492728,4493683,4493205,955
"3911","chr16",58025476,58027573,58026524,2097
"3912","chr21",41808938,41809152,41809045,214
"3913","chr12",29149042,29150021,29149531,979
"3914","chr22",19765789,19767490,19766639,1701
"3915","chr13",112842982,112843347,112843164,365
"3916","chr2",236567668,236568620,236568144,952
"3917","chr6",65787782,65788140,65787961,358
"3918","chr10",79981472,79982537,79982004,1065
"3919","chr20",63428038,63428253,63428145,215
"3920","chr15",78751082,78751296,78751189,214
"3921","chr2",132009790,132010364,132010077,574
"3922","chr10",132546029,132546276,132546152,247
"3923","chr1",2585958,2587453,2586705,1495
"3924","chr7",120950530,120951274,120950902,744
"3925","chr3",184335777,184336475,184336126,698
"3926","chr16",7653809,7654088,7653948,279
"3927","chr16",49635660,49636527,49636093,867
"3928","chrX",37348984,37349554,37349269,570
"3929","chr2",11610640,11610946,11610793,306
"3930","chr10",3781597,3781825,3781711,228
"3931","chr16",89911154,89911443,89911298,289
"3932","chr11",65538464,65541031,65539747,2567
"3933","chr21",42587365,42590371,42588868,3006
"3934","chr16",47037476,47038259,47037867,783
"3935","chr4",55793460,55793978,55793719,518
"3936","chr20",63546877,63547772,63547324,895
"3937","chrX",40090119,40090723,40090421,604
"3938","chr6",30213156,30214410,30213783,1254
"3939","chr16",89389739,89390362,89390050,623
"3940","chr11",59560664,59561034,59560849,370
"3941","chr17",28250467,28250864,28250665,397
"3942","chr8",104329985,104330330,104330157,345
"3943","chr16",3589091,3589305,3589198,214
"3944","chr3",58237374,58238637,58238005,1263
"3945","chr5",127029931,127031558,127030744,1627
"3946","chr7",740602,740964,740783,362
"3947","chr3",48428821,48429980,48429400,1159
"3948","chr20",18587792,18588448,18588120,656
"3949","chr16",71894958,71896050,71895504,1092
"3950","chr15",90871426,90872280,90871853,854
"3951","chr3",23945160,23946530,23945845,1370
"3952","chr7",1009285,1009488,1009386,203
"3953","chr1",110606361,110607564,110606962,1203
"3954","chrX",153400689,153401194,153400941,505
"3955","chr22",37518761,37519876,37519318,1115
"3956","chr2",149329949,149330978,149330463,1029
"3957","chr7",76400330,76400565,76400447,235
"3958","chr3",128617563,128618270,128617916,707
"3959","chr13",57632392,57634796,57633594,2404
"3960","chr11",47642025,47642779,47642402,754
"3961","chr13",36214277,36214901,36214589,624
"3962","chr1",183022669,183024235,183023452,1566
"3963","chr2",197804355,197805430,197804892,1075
"3964","chr19",9936148,9936802,9936475,654
"3965","chr22",46044513,46045253,46044883,740
"3966","chr2",48755482,48755746,48755614,264
"3967","chr22",49826470,49828021,49827245,1551
"3968","chr16",1524514,1524985,1524749,471
"3969","chr12",27244049,27244713,27244381,664
"3970","chr22",39661936,39662839,39662387,903
"3971","chr2",98346410,98347724,98347067,1314
"3972","chr4",6663944,6664362,6664153,418
"3973","chr3",194133910,194135329,194134619,1419
"3974","chr20",58179621,58180049,58179835,428
"3975","chr15",52295156,52295975,52295565,819
"3976","chr16",30980507,30980808,30980657,301
"3977","chr15",68817369,68821662,68819515,4293
"3978","chr1",114669618,114670364,114669991,746
"3979","chr17",19014955,19015255,19015105,300
"3980","chr16",88697202,88697560,88697381,358
"3981","chr3",12841035,12841574,12841304,539
"3982","chr16",12261156,12262132,12261644,976
"3983","chr22",50194278,50194612,50194445,334
"3984","chr17",7306905,7308421,7307663,1516
"3985","chr9",37903633,37904478,37904055,845
"3986","chr6",158516253,158516459,158516356,206
"3987","chr6",10747594,10747885,10747739,291
"3988","chr10",69408649,69409196,69408922,547
"3989","chr10",63465110,63466127,63465618,1017
"3990","chr15",89371132,89371830,89371481,698
"3991","chr17",21284240,21285131,21284685,891
"3992","chr5",159051370,159051622,159051496,252
"3993","chr3",99876125,99876457,99876291,332
"3994","chr12",50763715,50765059,50764387,1344
"3995","chr11",69443381,69443776,69443578,395
"3996","chr3",127604614,127605195,127604904,581
"3997","chr2",229713346,229715265,229714305,1919
"3998","chr16",31042189,31042479,31042334,290
"3999","chr15",40511381,40511996,40511688,615
"4000","chr7",38975943,38976329,38976136,386
"4001","chr11",61429449,61430225,61429837,776
"4002","chr1",1242505,1242827,1242666,322
"4003","chr3",75618626,75619916,75619271,1290
"4004","chr11",74311383,74311658,74311520,275
"4005","chr11",72726631,72726960,72726795,329
"4006","chr17",17042070,17043107,17042588,1037
"4007","chrY",19076562,19078119,19077340,1557
"4008","chr11",117233009,117233225,117233117,216
"4009","chr5",178986295,178986730,178986512,435
"4010","chr16",67806372,67807203,67806787,831
"4011","chr1",40838059,40838764,40838411,705
"4012","chr3",42501328,42503032,42502180,1704
"4013","chr1",240207559,240208226,240207892,667
"4014","chr2",132415959,132416796,132416377,837
"4015","chr3",101676132,101677252,101676692,1120
"4016","chr11",64877957,64879094,64878525,1137
"4017","chr10",93566472,93567351,93566911,879
"4018","chr1",228406110,228407012,228406561,902
"4019","chr18",79637556,79638898,79638227,1342
"4020","chr7",6164501,6164891,6164696,390
"4021","chr4",3522522,3522735,3522628,213
"4022","chr15",74725845,74726995,74726420,1150
"4023","chr10",38094272,38095034,38094653,762
"4024","chr12",51269620,51270627,51270123,1007
"4025","chr17",34581988,34582274,34582131,286
"4026","chr5",139198181,139198517,139198349,336
"4027","chr5",2038413,2038835,2038624,422
"4028","chr15",22927861,22928065,22927963,204
"4029","chr7",98400785,98401372,98401078,587
"4030","chr9",116687194,116687488,116687341,294
"4031","chr6",70955657,70957429,70956543,1772
"4032","chr3",125055402,125056185,125055793,783
"4033","chrX",130165458,130166131,130165794,673
"4034","chrX",154805091,154805660,154805375,569
"4035","chr11",64917127,64917354,64917240,227
"4036","chrX",70289794,70290112,70289953,318
"4037","chr3",12810017,12810324,12810170,307
"4038","chr15",29103438,29104087,29103762,649
"4039","chr13",32311287,32311525,32311406,238
"4040","chr18",48949962,48952994,48951478,3032
"4041","chr17",75631462,75631744,75631603,282
"4042","chr7",157910162,157910799,157910480,637
"4043","chr4",39044566,39045448,39045007,882
"4044","chr3",149656922,149658541,149657731,1619
"4045","chr20",46513361,46513698,46513529,337
"4046","chr6",133663983,133664322,133664152,339
"4047","chrY",13703608,13703899,13703753,291
"4048","chr4",80335886,80336116,80336001,230
"4049","chr10",32957343,32958779,32958061,1436
"4050","chr3",24829183,24830600,24829891,1417
"4051","chr6",13813711,13814714,13814212,1003
"4052","chr5",42924112,42924568,42924340,456
"4053","chr2",228181241,228181837,228181539,596
"4054","chr10",133008229,133008433,133008331,204
"4055","chr10",49115139,49115690,49115414,551
"4056","chr19",17101669,17102522,17102095,853
"4057","chr18",78856616,78857519,78857067,903
"4058","chr14",20460998,20461307,20461152,309
"4059","chr15",35545925,35546314,35546119,389
"4060","chr17",6651512,6652266,6651889,754
"4061","chr5",1054504,1054765,1054634,261
"4062","chr7",130051120,130051486,130051303,366
"4063","chr22",17171373,17172088,17171730,715
"4064","chr2",176637713,176638365,176638039,652
"4065","chr15",23686412,23687451,23686931,1039
"4066","chr2",218996205,218996520,218996362,315
"4067","chr6",34887827,34888111,34887969,284
"4068","chr4",46389886,46390555,46390220,669
"4069","chr17",12665350,12666018,12665684,668
"4070","chr11",122655570,122656771,122656170,1201
"4071","chr15",75842970,75844184,75843577,1214
"4072","chr2",26847434,26850054,26848744,2620
"4073","chr13",114013049,114013333,114013191,284
"4074","chr3",115658420,115658940,115658680,520
"4075","chr7",92133781,92135053,92134417,1272
"4076","chr3",73624079,73625224,73624651,1145
"4077","chr2",195656831,195658226,195657528,1395
"4078","chr6",87407989,87408645,87408317,656
"4079","chr2",131105183,131105871,131105527,688
"4080","chr11",560382,561669,561025,1287
"4081","chr3",184711578,184712119,184711848,541
"4082","chr16",4614005,4616781,4615393,2776
"4083","chr20",37527620,37528267,37527943,647
"4084","chr12",5945183,5945566,5945374,383
"4085","chrX",49123494,49123916,49123705,422
"4086","chr17",78802072,78802379,78802225,307
"4087","chr2",4003059,4003262,4003160,203
"4088","chr16",1541812,1542106,1541959,294
"4089","chr4",152534956,152536691,152535823,1735
"4090","chr8",23163543,23164075,23163809,532
"4091","chr1",244834721,244835840,244835280,1119
"4092","chr3",5187273,5188505,5187889,1232
"4093","chr14",79861671,79861988,79861829,317
"4094","chr16",69754566,69755081,69754823,515
"4095","chr6",4776923,4777316,4777119,393
"4096","chr2",96861752,96861967,96861859,215
"4097","chr22",46070096,46072648,46071372,2552
"4098","chr17",19977363,19978320,19977841,957
"4099","chr15",31325560,31328705,31327132,3145
"4100","chr16",3142180,3142668,3142424,488
"4101","chr17",76226799,76227051,76226925,252
"4102","chr10",3458140,3458384,3458262,244
"4103","chr18",8784149,8784585,8784367,436
"4104","chr6",31493909,31494376,31494142,467
"4105","chr2",74754625,74754845,74754735,220
"4106","chr4",168480199,168480574,168480386,375
"4107","chr11",17276232,17277147,17276689,915
"4108","chr5",180809992,180811209,180810600,1217
"4109","chr15",75335909,75336336,75336122,427
"4110","chr8",141000341,141001808,141001074,1467
"4111","chr13",27424449,27425041,27424745,592
"4112","chr20",61895024,61895279,61895151,255
"4113","chr15",81134158,81134361,81134259,203
"4114","chr17",75077218,75077846,75077532,628
"4115","chr3",129428386,129428774,129428580,388
"4116","chr22",42869984,42870277,42870130,293
"4117","chr10",59708852,59710241,59709546,1389
"4118","chr10",484773,485159,484966,386
"4119","chr17",12973953,12974456,12974204,503
"4120","chr6",159232201,159234365,159233283,2164
"4121","chr22",37745754,37746992,37746373,1238
"4122","chr5",154038623,154039109,154038866,486
"4123","chr11",112074334,112074727,112074530,393
"4124","chr6",169790015,169790616,169790315,601
"4125","chr15",56365279,56365685,56365482,406
"4126","chr12",2004177,2004715,2004446,538
"4127","chr6",29016641,29016878,29016759,237
"4128","chr17",50149151,50151175,50150163,2024
"4129","chr5",15927979,15928409,15928194,430
"4130","chr7",592199,592498,592348,299
"4131","chr2",86788851,86791059,86789955,2208
"4132","chr16",30782395,30783947,30783171,1552
"4133","chr16",8674399,8674762,8674580,363
"4134","chr8",141442145,141442410,141442277,265
"4135","chr3",50154538,50155697,50155117,1159
"4136","chr9",129568691,129569399,129569045,708
"4137","chr16",54281690,54290692,54286191,9002
"4138","chr5",1344430,1345354,1344892,924
"4139","chr17",82496776,82497756,82497266,980
"4140","chr17",7417052,7417626,7417339,574
"4141","chr12",132585248,132585515,132585381,267
"4142","chr11",67401145,67401982,67401563,837
"4143","chr2",25340440,25342735,25341587,2295
"4144","chr6",46491141,46491520,46491330,379
"4145","chr18",76490794,76496530,76493662,5736
"4146","chr5",34929296,34930336,34929816,1040
"4147","chr11",2005503,2005786,2005644,283
"4148","chr4",44447369,44449116,44448242,1747
"4149","chr6",152982273,152983838,152983055,1565
"4150","chr5",98772974,98774603,98773788,1629
"4151","chr16",68244967,68245533,68245250,566
"4152","chr15",65791501,65792587,65792044,1086
"4153","chr17",81527979,81529265,81528622,1286
"4154","chr5",63959217,63959580,63959398,363
"4155","chr2",128317623,128320065,128318844,2442
"4156","chr12",133129942,133131008,133130475,1066
"4157","chr13",98142144,98143987,98143065,1843
"4158","chr16",31074203,31074727,31074465,524
"4159","chr2",240560165,240561368,240560766,1203
"4160","chr2",6495817,6496028,6495922,211
"4161","chr11",44310764,44311207,44310985,443
"4162","chr7",43869297,43869879,43869588,582
"4163","chr11",394257,394619,394438,362
"4164","chr15",96361493,96361821,96361657,328
"4165","chr7",87219595,87220708,87220151,1113
"4166","chr10",102418771,102419791,102419281,1020
"4167","chr11",2132803,2133110,2132956,307
"4168","chr12",93467428,93467763,93467595,335
"4169","chr2",20650952,20651413,20651182,461
"4170","chrX",15737928,15738513,15738220,585
"4171","chr16",396949,397649,397299,700
"4172","chr12",121792997,121794453,121793725,1456
"4173","chr20",37289585,37289858,37289721,273
"4174","chr13",52652247,52652929,52652588,682
"4175","chr22",33650368,33650611,33650489,243
"4176","chr15",83283435,83285178,83284306,1743
"4177","chr1",164576303,164576680,164576491,377
"4178","chr5",180291528,180292767,180292147,1239
"4179","chr6",107114250,107116106,107115178,1856
"4180","chr6",53651521,53652278,53651899,757
"4181","chr11",125569226,125569834,125569530,608
"4182","chr2",64865086,64865506,64865296,420
"4183","chr15",43510683,43511209,43510946,526
"4184","chr5",3606374,3607021,3606697,647
"4185","chr1",180502190,180503142,180502666,952
"4186","chr11",86906319,86906541,86906430,222
"4187","chr12",34218692,34219369,34219030,677
"4188","chr2",176159773,176160228,176160000,455
"4189","chr2",233461140,233461453,233461296,313
"4190","chr22",48667726,48668088,48667907,362
"4191","chr11",76164393,76165518,76164955,1125
"4192","chr4",74793891,74794530,74794210,639
"4193","chr3",138594138,138594500,138594319,362
"4194","chr8",85176966,85178052,85177509,1086
"4195","chr3",53255517,53256020,53255768,503
"4196","chr16",88259157,88259404,88259280,247
"4197","chr1",19209657,19210552,19210104,895
"4198","chrY",4999915,5000545,5000230,630
"4199","chr15",64387708,64388034,64387871,326
"4200","chrX",135098181,135099096,135098638,915
"4201","chr7",84939922,84940251,84940086,329
"4202","chr4",139015289,139016274,139015781,985
"4203","chr7",157768282,157768503,157768392,221
"4204","chr12",62466603,62467075,62466839,472
"4205","chr5",133968295,133968708,133968501,413
"4206","chr6",138692238,138693744,138692991,1506
"4207","chr17",781910,782748,782329,838
"4208","chr1",25858981,25859865,25859423,884
"4209","chr12",56333877,56334212,56334044,335
"4210","chr6",158869641,158870163,158869902,522
"4211","chr3",42773075,42773401,42773238,326
"4212","chr5",170503865,170504467,170504166,602
"4213","chr2",65435780,65436745,65436262,965
"4214","chr1",151059291,151059876,151059583,585
"4215","chr7",50782055,50783174,50782614,1119
"4216","chr13",100088702,100089551,100089126,849
"4217","chr9",131008972,131009623,131009297,651
"4218","chr2",237085714,237086233,237085973,519
"4219","chr2",94856853,94858443,94857648,1590
"4220","chr4",73620327,73620541,73620434,214
"4221","chr2",170822036,170823848,170822942,1812
"4222","chr15",82809614,82810521,82810067,907
"4223","chr3",45593598,45594440,45594019,842
"4224","chr15",79896664,79897353,79897008,689
"4225","chr6",150068807,150069422,150069114,615
"4226","chr9",100352313,100353132,100352722,819
"4227","chr15",69298800,69299415,69299107,615
"4228","chr7",20797932,20798585,20798258,653
"4229","chr3",133674274,133674813,133674543,539
"4230","chr13",24307960,24308727,24308343,767
"4231","chr4",5051209,5052157,5051683,948
"4232","chr16",12900717,12903833,12902275,3116
"4233","chr16",84191125,84191479,84191302,354
"4234","chr3",66499894,66501424,66500659,1530
"4235","chr7",100081145,100082079,100081612,934
"4236","chr6",57853876,57854165,57854020,289
"4237","chr3",15601263,15602074,15601668,811
"4238","chr5",149357783,149358046,149357914,263
"4239","chr6",32166683,32167419,32167051,736
"4240","chr20",44210209,44211243,44210726,1034
"4241","chr9",34637203,34637953,34637578,750
"4242","chr5",90409526,90409763,90409644,237
"4243","chr12",752276,754247,753261,1971
"4244","chr12",123584388,123585152,123584770,764
"4245","chr4",1167339,1167894,1167616,555
"4246","chr18",74495700,74496804,74496252,1104
"4247","chr6",36985891,36986694,36986292,803
"4248","chr11",68683891,68685378,68684634,1487
"4249","chr5",677698,678020,677859,322
"4250","chr22",49541012,49541731,49541371,719
"4251","chr2",238139430,238139813,238139621,383
"4252","chr11",124622768,124623257,124623012,489
"4253","chr22",18000425,18001734,18001079,1309
"4254","chr2",65313627,65314177,65313902,550
"4255","chr15",47717221,47718847,47718034,1626
"4256","chr7",96709504,96709965,96709734,461
"4257","chr11",9314183,9314930,9314556,747
"4258","chrX",53094129,53094595,53094362,466
"4259","chr12",127761047,127761291,127761169,244
"4260","chr16",87703046,87703301,87703173,255
"4261","chr17",74453843,74454478,74454160,635
"4262","chr18",55779843,55780611,55780227,768
"4263","chr9",107716753,107717139,107716946,386
"4264","chr16",28491492,28492170,28491831,678
"4265","chr7",151409290,151410722,151410006,1432
"4266","chr17",49132449,49133378,49132913,929
"4267","chr6",167797135,167797484,167797309,349
"4268","chr11",92882669,92883502,92883085,833
"4269","chrX",153517479,153518403,153517941,924
"4270","chr1",53276625,53277173,53276899,548
"4271","chr7",131557934,131558247,131558090,313
"4272","chr9",93183865,93185553,93184709,1688
"4273","chr1",21344867,21345826,21345346,959
"4274","chr9",128818311,128819322,128818816,1011
"4275","chr17",73310836,73312543,73311689,1707
"4276","chr4",150078098,150079554,150078826,1456
"4277","chr3",184561406,184562933,184562169,1527
"4278","chr6",43454630,43455967,43455298,1337
"4279","chr3",98732442,98732863,98732652,421
"4280","chr15",75738223,75739341,75738782,1118
"4281","chr15",24773027,24773386,24773206,359
"4282","chr2",96010412,96010985,96010698,573
"4283","chr22",46364553,46364782,46364667,229
"4284","chr16",85485503,85485751,85485627,248
"4285","chr17",74359957,74360188,74360072,231
"4286","chr16",88816648,88817053,88816850,405
"4287","chr4",730546,732281,731413,1735
"4288","chr9",21802122,21802982,21802552,860
"4289","chr10",47309891,47310694,47310292,803
"4290","chr12",14803057,14803537,14803297,480
"4291","chr12",119334548,119334789,119334668,241
"4292","chr11",47766648,47767470,47767059,822
"4293","chr2",65430634,65432852,65431743,2218
"4294","chr5",98768874,98770566,98769720,1692
"4295","chr19",15902819,15903206,15903012,387
"4296","chr2",196927023,196927283,196927153,260
"4297","chrX",17736933,17738528,17737730,1595
"4298","chr4",83535962,83536707,83536334,745
"4299","chr5",107669429,107672490,107670959,3061
"4300","chr5",9546364,9546603,9546483,239
"4301","chr2",70190614,70191178,70190896,564
"4302","chr12",52152153,52152579,52152366,426
"4303","chr5",131263642,131264713,131264177,1071
"4304","chr1",23530541,23531597,23531069,1056
"4305","chr5",1768799,1769580,1769189,781
"4306","chr18",49813041,49813741,49813391,700
"4307","chr12",113093109,113093671,113093390,562
"4308","chr7",1223860,1224728,1224294,868
"4309","chr16",35352346,35352753,35352549,407
"4310","chr3",4978191,4980538,4979364,2347
"4311","chr18",72541739,72544555,72543147,2816
"4312","chr6",100458076,100458810,100458443,734
"4313","chr19",52139360,52140155,52139757,795
"4314","chr1",9651674,9652943,9652308,1269
"4315","chrX",33726313,33726834,33726573,521
"4316","chr6",3157166,3158184,3157675,1018
"4317","chr2",37925031,37925742,37925386,711
"4318","chr6",35776448,35776785,35776616,337
"4319","chr10",95693721,95694256,95693988,535
"4320","chr11",14259195,14259618,14259406,423
"4321","chr4",2817772,2818702,2818237,930
"4322","chr20",2840217,2841265,2840741,1048
"4323","chr7",157710777,157711452,157711114,675
"4324","chr21",44816811,44819043,44817927,2232
"4325","chr17",82418203,82418885,82418544,682
"4326","chr22",44736776,44737512,44737144,736
"4327","chr7",5481737,5481984,5481860,247
"4328","chr14",100285335,100286002,100285668,667
"4329","chr9",126705851,126706057,126705954,206
"4330","chr5",1799347,1801791,1800569,2444
"4331","chr19",2717235,2717837,2717536,602
"4332","chr17",1022994,1023199,1023096,205
"4333","chr16",78099277,78100169,78099723,892
"4334","chr16",19883643,19885834,19884738,2191
"4335","chr9",14978096,14978587,14978341,491
"4336","chr7",5555022,5555486,5555254,464
"4337","chr5",1416677,1416889,1416783,212
"4338","chr22",29580951,29581227,29581089,276
"4339","chr11",133081797,133082312,133082054,515
"4340","chr2",97112732,97113803,97113267,1071
"4341","chr20",5911232,5911771,5911501,539
"4342","chr10",132885149,132885464,132885306,315
"4343","chr5",172669728,172670383,172670055,655
"4344","chr2",160269853,160270407,160270130,554
"4345","chr16",85553332,85557012,85555172,3680
"4346","chr15",49620788,49621285,49621036,497
"4347","chr18",32470152,32471382,32470767,1230
"4348","chr6",32148813,32149452,32149132,639
"4349","chr11",44565052,44565837,44565444,785
"4350","chr4",107824937,107825379,107825158,442
"4351","chr19",38618792,38619222,38619007,430
"4352","chr10",73732735,73733664,73733199,929
"4353","chr11",43311889,43312337,43312113,448
"4354","chr1",45326747,45327629,45327188,882
"4355","chr5",176743243,176743795,176743519,552
"4356","chr2",134191496,134192156,134191826,660
"4357","chr7",29194355,29195430,29194892,1075
"4358","chr3",126654685,126655299,126654992,614
"4359","chr20",57652196,57652631,57652413,435
"4360","chr5",138752970,138754147,138753558,1177
"4361","chr1",37318010,37318657,37318333,647
"4362","chr6",107848192,107848586,107848389,394
"4363","chr10",71396407,71398174,71397290,1767
"4364","chr3",126343692,126343919,126343805,227
"4365","chr1",35557079,35558233,35557656,1154
"4366","chr5",54883535,54884343,54883939,808
"4367","chr17",20320436,20321755,20321095,1319
"4368","chr9",136807501,136808771,136808136,1270
"4369","chr4",86594030,86594819,86594424,789
"4370","chr2",74513197,74516668,74514932,3471
"4371","chr5",178394851,178396864,178395857,2013
"4372","chr18",80246145,80247788,80246966,1643
"4373","chr5",76083149,76084971,76084060,1822
"4374","chr16",35207415,35208003,35207709,588
"4375","chr22",49852942,49854495,49853718,1553
"4376","chr6",170271801,170272025,170271913,224
"4377","chr11",3233009,3233246,3233127,237
"4378","chr15",100340752,100342233,100341492,1481
"4379","chr4",42150749,42152967,42151858,2218
"4380","chr2",218292254,218292657,218292455,403
"4381","chr7",157617154,157617549,157617351,395
"4382","chr2",175004686,175005561,175005123,875
"4383","chr17",81463474,81464111,81463792,637
"4384","chr17",78502725,78502993,78502859,268
"4385","chr3",20185797,20186464,20186130,667
"4386","chr15",22979069,22981130,22980099,2061
"4387","chrX",9464790,9466480,9465635,1690
"4388","chr5",80569023,80570628,80569825,1605
"4389","chr12",132198027,132198350,132198188,323
"4390","chr9",136074802,136075621,136075211,819
"4391","chr22",20436351,20438378,20437364,2027
"4392","chr10",13001094,13001781,13001437,687
"4393","chr12",68610440,68611597,68611018,1157
"4394","chr2",1797846,1798288,1798067,442
"4395","chr17",83078454,83081531,83079992,3077
"4396","chr19",36245119,36245982,36245550,863
"4397","chr10",60733027,60733618,60733322,591
"4398","chr2",218398375,218400833,218399604,2458
"4399","chr12",14567314,14568159,14567736,845
"4400","chr17",40316706,40316949,40316827,243
"4401","chr4",48016473,48017422,48016947,949
"4402","chr22",30356594,30357225,30356909,631
"4403","chr12",642586,643489,643037,903
"4404","chr5",10249648,10250888,10250268,1240
"4405","chr6",35318125,35318545,35318335,420
"4406","chr15",67823277,67830237,67826757,6960
"4407","chr6",166158357,166158558,166158457,201
"4408","chr20",64057198,64057525,64057361,327
"4409","chr5",178337135,178337340,178337237,205
"4410","chr3",25782845,25783474,25783159,629
"4411","chr2",32946381,32948097,32947239,1716
"4412","chr7",25857093,25857305,25857199,212
"4413","chr4",186959731,186973145,186966438,13414
"4414","chr20",31475246,31475478,31475362,232
"4415","chr17",43832662,43833450,43833056,788
"4416","chr11",1998335,1998633,1998484,298
"4417","chrX",102125689,102125988,102125838,299
"4418","chrX",72304982,72307449,72306215,2467
"4419","chr22",43209959,43210230,43210094,271
"4420","chr7",76267192,76267626,76267409,434
"4421","chr6",70566838,70567332,70567085,494
"4422","chr7",158266059,158266367,158266213,308
"4423","chr10",84237353,84237671,84237512,318
"4424","chr10",92848280,92849282,92848781,1002
"4425","chr7",151277000,151277449,151277224,449
"4426","chr9",112890166,112891168,112890667,1002
"4427","chr20",62708506,62709868,62709187,1362
"4428","chr2",127293771,127294281,127294026,510
"4429","chr20",57672193,57672595,57672394,402
"4430","chr2",110115368,110116010,110115689,642
"4431","chr12",113184956,113186126,113185541,1170
"4432","chr6",43269522,43269905,43269713,383
"4433","chr12",6700048,6700912,6700480,864
"4434","chr8",143726051,143728808,143727429,2757
"4435","chr5",177454220,177456153,177455186,1933
"4436","chr11",72697005,72697468,72697236,463
"4437","chr2",10302182,10304383,10303282,2201
"4438","chr3",194003164,194003502,194003333,338
"4439","chr19",2977243,2977634,2977438,391
"4440","chr19",44954956,44955826,44955391,870
"4441","chr2",96265121,96266553,96265837,1432
"4442","chr17",58006443,58008012,58007227,1569
"4443","chr14",100328735,100329039,100328887,304
"4444","chr16",53130088,53131926,53131007,1838
"4445","chr13",113998877,113999146,113999011,269
"4446","chr16",3058194,3059604,3058899,1410
"4447","chr2",84880607,84881306,84880956,699
"4448","chr17",59892681,59893660,59893170,979
"4449","chr20",21391403,21391825,21391614,422
"4450","chr5",170744552,170744794,170744673,242
"4451","chr6",31497683,31498411,31498047,728
"4452","chr4",80207075,80207537,80207306,462
"4453","chr5",2738839,2741123,2739981,2284
"4454","chr6",130019041,130021305,130020173,2264
"4455","chr3",39106886,39107909,39107397,1023
"4456","chr8",1393054,1394000,1393527,946
"4457","chr11",72642517,72643314,72642915,797
"4458","chr10",89207798,89208143,89207970,345
"4459","chr7",158085292,158085953,158085622,661
"4460","chr16",69186977,69188204,69187590,1227
"4461","chr5",135327031,135327337,135327184,306
"4462","chr12",54369273,54369504,54369388,231
"4463","chrX",137565367,137568019,137566693,2652
"4464","chr6",73520239,73521774,73521006,1535
"4465","chr2",156327877,156328120,156327998,243
"4466","chr2",69306477,69307643,69307060,1166
"4467","chr2",8684976,8686058,8685517,1082
"4468","chr7",19116427,19118419,19117423,1992
"4469","chr2",182715966,182716475,182716220,509
"4470","chr17",44947290,44947976,44947633,686
"4471","chr5",77077057,77077895,77077476,838
"4472","chr12",54588149,54588807,54588478,658
"4473","chr12",131686329,131686657,131686493,328
"4474","chr7",71131242,71133396,71132319,2154
"4475","chr6",117920184,117920406,117920295,222
"4476","chr16",28553824,28554432,28554128,608
"4477","chr16",15642949,15643300,15643124,351
"4478","chr20",44745708,44746249,44745978,541
"4479","chr10",26697213,26698159,26697686,946
"4480","chrX",132217503,132218507,132218005,1004
"4481","chr16",27109690,27110060,27109875,370
"4482","chr6",31356169,31357434,31356801,1265
"4483","chr13",106533162,106533386,106533274,224
"4484","chr18",46656876,46657093,46656984,217
"4485","chr8",943459,943760,943609,301
"4486","chr13",95301006,95301957,95301481,951
"4487","chr8",143018039,143018265,143018152,226
"4488","chr7",149474287,149474987,149474637,700
"4489","chr3",128486652,128493431,128490041,6779
"4490","chr16",1554963,1555344,1555153,381
"4491","chr22",42720145,42721115,42720630,970
"4492","chr5",43313089,43313822,43313455,733
"4493","chrX",12974988,12976480,12975734,1492
"4494","chr7",56483216,56483420,56483318,204
"4495","chr4",40055864,40057264,40056564,1400
"4496","chr8",37964968,37966490,37965729,1522
"4497","chr5",175443750,175445342,175444546,1592
"4498","chr11",47394806,47395047,47394926,241
"4499","chr19",57934968,57935432,57935200,464
"4500","chr1",68230925,68231945,68231435,1020
"4501","chrX",63754833,63755338,63755085,505
"4502","chr3",124730331,124730614,124730472,283
"4503","chr3",47577622,47579641,47578631,2019
"4504","chr17",81832654,81833813,81833233,1159
"4505","chr2",241724132,241724457,241724294,325
"4506","chr12",55817541,55817769,55817655,228
"4507","chr9",19379796,19380343,19380069,547
"4508","chr13",113441735,113442002,113441868,267
"4509","chr10",6089029,6089811,6089420,782
"4510","chr3",9553501,9553849,9553675,348
"4511","chr20",45812307,45813016,45812661,709
"4512","chr20",34216017,34216375,34216196,358
"4513","chr7",128350872,128352562,128351717,1690
"4514","chr7",66376754,66377451,66377102,697
"4515","chr7",155644351,155645123,155644737,772
"4516","chr11",128890546,128891338,128890942,792
"4517","chr11",2575148,2575377,2575262,229
"4518","chr5",1881810,1887629,1884719,5819
"4519","chrY",6265610,6265917,6265763,307
"4520","chr14",33799740,33801232,33800486,1492
"4521","chr22",30243740,30244005,30243872,265
"4522","chr12",54014642,54014929,54014785,287
"4523","chrX",119871288,119872254,119871771,966
"4524","chr11",6926289,6926981,6926635,692
"4525","chrX",101291075,101291562,101291318,487
"4526","chr18",12254148,12255090,12254619,942
"4527","chr12",121888576,121889138,121888857,562
"4528","chr2",32277896,32278402,32278149,506
"4529","chr10",124615225,124615644,124615434,419
"4530","chr2",128232935,128233751,128233343,816
"4531","chr3",149129411,149130181,149129796,770
"4532","chr11",23405406,23405803,23405604,397
"4533","chr2",219387286,219388718,219388002,1432
"4534","chr4",128811167,128812830,128811998,1663
"4535","chr6",15496573,15497105,15496839,532
"4536","chr6",109094357,109095544,109094950,1187
"4537","chr3",49910188,49910997,49910592,809
"4538","chr4",56505416,56505856,56505636,440
"4539","chr22",46249867,46251060,46250463,1193
"4540","chr12",100266970,100267868,100267419,898
"4541","chr13",99979498,99983272,99981385,3774
"4542","chr12",57620925,57621914,57621419,989
"4543","chr6",30913756,30914519,30914137,763
"4544","chr10",7666706,7667140,7666923,434
"4545","chr10",122112604,122113947,122113275,1343
"4546","chr16",87882582,87882863,87882722,281
"4547","chrX",57121246,57121564,57121405,318
"4548","chr8",92144109,92144412,92144260,303
"4549","chr4",158768548,158769671,158769109,1123
"4550","chr12",8605154,8605483,8605318,329
"4551","chr13",60396269,60397911,60397090,1642
"4552","chr8",142251686,142252158,142251922,472
"4553","chr16",1917798,1918969,1918383,1171
"4554","chr2",676651,677678,677164,1027
"4555","chr1",179081940,179082813,179082376,873
"4556","chr10",103367823,103368706,103368264,883
"4557","chr5",150758809,150759152,150758980,343
"4558","chr13",113051186,113051464,113051325,278
"4559","chr7",64947211,64947921,64947566,710
"4560","chr3",58586762,58587176,58586969,414
"4561","chr4",8085442,8085722,8085582,280
"4562","chr1",172443727,172444141,172443934,414
"4563","chr10",12042237,12043432,12042834,1195
"4564","chr5",141651351,141651610,141651480,259
"4565","chr7",102239314,102239715,102239514,401
"4566","chr2",100417144,100417834,100417489,690
"4567","chr16",4271257,4271504,4271380,247
"4568","chr20",2692258,2694052,2693155,1794
"4569","chr10",13656562,13657540,13657051,978
"4570","chr1",155977887,155978699,155978293,812
"4571","chr3",112990819,112991423,112991121,604
"4572","chr2",86105536,86106527,86106031,991
"4573","chr9",120928493,120929397,120928945,904
"4574","chr13",75635404,75637077,75636240,1673
"4575","chr16",56190660,56192366,56191513,1706
"4576","chr12",12813189,12813415,12813302,226
"4577","chr3",47802631,47803665,47803148,1034
"4578","chr17",79948922,79949174,79949048,252
"4579","chr16",57447083,57447754,57447418,671
"4580","chr1",18784226,18784438,18784332,212
"4581","chr12",62934363,62935355,62934859,992
"4582","chr1",207454186,207454935,207454560,749
"4583","chr3",139019879,139021081,139020480,1202
"4584","chr13",50133449,50133883,50133666,434
"4585","chr6",27810077,27810473,27810275,396
"4586","chr20",709931,710455,710193,524
"4587","chr3",14651424,14651922,14651673,498
"4588","chr1",92480309,92487052,92483680,6743
"4589","chr16",20806178,20807192,20806685,1014
"4590","chr10",43104790,43105717,43105253,927
"4591","chr2",239928861,239929173,239929017,312
"4592","chr1",157194748,157195345,157195046,597
"4593","chr3",101574041,101574768,101574404,727
"4594","chr10",119541966,119543657,119542811,1691
"4595","chr22",38397175,38397446,38397310,271
"4596","chr1",6447147,6449126,6448136,1979
"4597","chr16",2178189,2181169,2179679,2980
"4598","chr4",884926,885129,885027,203
"4599","chr11",14499350,14499948,14499649,598
"4600","chr20",63349212,63351021,63350116,1809
"4601","chr12",132134652,132136415,132135533,1763
"4602","chr1",100266076,100266443,100266259,367
"4603","chr17",14299315,14299941,14299628,626
"4604","chr17",80906230,80906478,80906354,248
"4605","chr17",35764150,35764900,35764525,750
"4606","chr11",69646292,69646610,69646451,318
"4607","chr4",1985765,1986533,1986149,768
"4608","chr17",81282160,81282523,81282341,363
"4609","chr19",3834517,3834905,3834711,388
"4610","chr1",36463813,36464530,36464171,717
"4611","chr1",33080923,33081642,33081282,719
"4612","chr20",45347893,45348602,45348247,709
"4613","chr19",5803723,5806012,5804867,2289
"4614","chr19",45178065,45179898,45178981,1833
"4615","chr16",30997302,30997715,30997508,413
"4616","chr16",55509008,55509362,55509185,354
"4617","chr16",2236599,2238072,2237335,1473
"4618","chr11",626728,628037,627382,1309
"4619","chr1",169893314,169893816,169893565,502
"4620","chr6",28399347,28399874,28399610,527
"4621","chr11",8870525,8871237,8870881,712
"4622","chr1",59146735,59147051,59146893,316
"4623","chr4",1870454,1872259,1871356,1805
"4624","chr1",156282448,156282924,156282686,476
"4625","chr4",68182344,68182719,68182531,375
"4626","chr15",28106460,28107956,28107208,1496
"4627","chr9",1051471,1052240,1051855,769
"4628","chr17",65123109,65123588,65123348,479
"4629","chr1",163321689,163322231,163321960,542
"4630","chr16",85688603,85689335,85688969,732
"4631","chr8",37849631,37849989,37849810,358
"4632","chr8",71556325,71557326,71556825,1001
"4633","chr10",121597102,121598771,121597936,1669
"4634","chr1",31412947,31414163,31413555,1216
"4635","chr11",75566321,75566987,75566654,666
"4636","chr20",290414,290796,290605,382
"4637","chr1",228211770,228214336,228213053,2566
"4638","chr10",3458600,3458836,3458718,236
"4639","chr16",1781720,1783567,1782643,1847
"4640","chr5",82278014,82278476,82278245,462
"4641","chr1",32753826,32754379,32754102,553
"4642","chr6",30555509,30555742,30555625,233
"4643","chr5",159100366,159100975,159100670,609
"4644","chr16",2785062,2785957,2785509,895
"4645","chr4",8428376,8428714,8428545,338
"4646","chr11",57667070,57667316,57667193,246
"4647","chr1",243254439,243255473,243254956,1034
"4648","chr7",77798014,77799533,77798773,1519
"4649","chr8",59117575,59120187,59118881,2612
"4650","chr8",687393,688251,687822,858
"4651","chr12",30795614,30796823,30796218,1209
"4652","chr6",43076196,43077319,43076757,1123
"4653","chr7",149415215,149415454,149415334,239
"4654","chr4",1340141,1340352,1340246,211
"4655","chr1",228424879,228425402,228425140,523
"4656","chr6",65301360,65301588,65301474,228
"4657","chr1",97920633,97921168,97920900,535
"4658","chr7",154750349,154750638,154750493,289
"4659","chr1",201481752,201481977,201481864,225
"4660","chr6",150599910,150601010,150600460,1100
"4661","chr6",168281567,168281780,168281673,213
"4662","chr7",45573787,45575262,45574524,1475
"4663","chr14",102506980,102510329,102508654,3349
"4664","chr4",704513,704903,704708,390
"4665","chr19",36489288,36489831,36489559,543
"4666","chr1",31296399,31297131,31296765,732
"4667","chr1",193121598,193122094,193121846,496
"4668","chr10",100969542,100969953,100969747,411
"4669","chr1",179365659,179366203,179365931,544
"4670","chr8",101492250,101492542,101492396,292
"4671","chr1",6127683,6128175,6127929,492
"4672","chr7",150950903,150951791,150951347,888
"4673","chr3",36763974,36764723,36764348,749
"4674","chr15",77944346,77944742,77944544,396
"4675","chr9",2621308,2623685,2622496,2377
"4676","chr1",247406013,247406500,247406256,487
"4677","chr17",16214961,16216196,16215578,1235
"4678","chr8",143950281,143950795,143950538,514
"4679","chr17",50865708,50867582,50866645,1874
"4680","chr17",8063925,8064147,8064036,222
"4681","chr16",29844582,29844874,29844728,292
"4682","chr22",41926039,41926905,41926472,866
"4683","chr22",46439087,46439388,46439237,301
"4684","chr4",70688137,70688756,70688446,619
"4685","chr1",6490023,6491055,6490539,1032
"4686","chr16",54194312,54194567,54194439,255
"4687","chr1",150926143,150926363,150926253,220
"4688","chrX",15335247,15335886,15335566,639
"4689","chr16",8569697,8569992,8569844,295
"4690","chr16",1060905,1061227,1061066,322
"4691","chr19",4037346,4037940,4037643,594
"4692","chr5",56814898,56817082,56815990,2184
"4693","chr18",49492064,49492578,49492321,514
"4694","chr1",3188392,3188689,3188540,297
"4695","chr12",125861353,125861834,125861593,481
"4696","chr5",120464126,120464373,120464249,247
"4697","chr21",29002663,29002907,29002785,244
"4698","chr8",127849711,127849978,127849844,267
"4699","chr22",31661936,31662337,31662136,401
"4700","chr6",170281503,170281821,170281662,318
"4701","chr1",155273070,155273645,155273357,575
"4702","chr12",124326193,124326431,124326312,238
"4703","chr6",32150324,32150767,32150545,443
"4704","chr20",2328132,2328396,2328264,264
"4705","chr1",11478612,11480554,11479583,1942
"4706","chr16",12803508,12804032,12803770,524
"4707","chr5",135488813,135489089,135488951,276
"4708","chr6",163413297,163416199,163414748,2902
"4709","chr1",12616978,12618636,12617807,1658
"4710","chr5",1226861,1227190,1227025,329
"4711","chr8",141973423,141973687,141973555,264
"4712","chrX",136909350,136909769,136909559,419
"4713","chr1",217137407,217137836,217137621,429
"4714","chr1",39883269,39883616,39883442,347
"4715","chr8",21912183,21912569,21912376,386
"4716","chr2",241209263,241209664,241209463,401
"4717","chr16",11915023,11916257,11915640,1234
"4718","chr10",71963953,71965012,71964482,1059
"4719","chr16",83807807,83808383,83808095,576
"4720","chr16",22206329,22206769,22206549,440
"4721","chr1",47023554,47023961,47023757,407
"4722","chr1",112466222,112466532,112466377,310
"4723","chr6",33207784,33208575,33208179,791
"4724","chr2",127810747,127811490,127811118,743
"4725","chr5",132490150,132491243,132490696,1093
"4726","chr1",223142843,223143347,223143095,504
"4727","chr1",217134402,217135837,217135119,1435
"4728","chr20",48664759,48665105,48664932,346
"4729","chr16",30377769,30379310,30378539,1541
"4730","chr16",88835767,88836059,88835913,292
"4731","chr1",47449967,47450280,47450123,313
"4732","chr15",85794187,85795056,85794621,869
"4733","chr2",84516339,84516561,84516450,222
"4734","chr17",79942885,79943117,79943001,232
"4735","chr22",41589521,41590041,41589781,520
"4736","chr17",807341,807672,807506,331
"4737","chrX",130401863,130402199,130402031,336
"4738","chr19",1383438,1384252,1383845,814
"4739","chr5",1494738,1495172,1494955,434
"4740","chr2",3640614,3640949,3640781,335
"4741","chr7",31052102,31053462,31052782,1360
"4742","chr1",26529580,26530193,26529886,613
"4743","chr4",804750,805196,804973,446
"4744","chr11",65040858,65041833,65041345,975
"4745","chr12",132887092,132888272,132887682,1180
"4746","chr2",240135986,240136499,240136242,513
"4747","chr1",28862795,28863440,28863117,645
"4748","chr4",6008141,6008558,6008349,417
"4749","chr12",114735809,114737017,114736413,1208
"4750","chr22",50603864,50604994,50604429,1130
"4751","chr2",88549917,88550174,88550045,257
"4752","chr10",89644480,89645291,89644885,811
"4753","chr5",43040743,43041059,43040901,316
"4754","chr12",120361569,120362109,120361839,540
"4755","chr1",65066587,65068282,65067434,1695
"4756","chr18",46173337,46175138,46174237,1801
"4757","chr1",209625804,209626009,209625906,205
"4758","chr17",79930105,79930598,79930351,493
"4759","chr4",2241524,2242280,2241902,756
"4760","chr13",24512384,24512929,24512656,545
"4761","chr6",37818931,37819774,37819352,843
"4762","chr2",3448575,3448811,3448693,236
"4763","chr2",58046507,58047287,58046897,780
"4764","chr7",54758888,54759495,54759191,607
"4765","chr6",138424211,138424456,138424333,245
"4766","chr13",46796628,46797349,46796988,721
"4767","chr8",7792089,7792343,7792216,254
"4768","chr6",117482334,117483508,117482921,1174
"4769","chr4",165378823,165379516,165379169,693
"4770","chr17",54900505,54900946,54900725,441
"4771","chrX",48918486,48919536,48919011,1050
"4772","chr21",33478922,33480395,33479658,1473
"4773","chr8",23709667,23710165,23709916,498
"4774","chr4",85475569,85475816,85475692,247
"4775","chr4",55948634,55949345,55948989,711
"4776","chr17",77055864,77056453,77056158,589
"4777","chr6",30345060,30345412,30345236,352
"4778","chr2",235669680,235671509,235670594,1829
"4779","chr11",50298084,50298601,50298342,517
"4780","chr16",70762502,70762725,70762613,223
"4781","chr1",34781275,34781998,34781636,723
"4782","chr1",2508358,2508583,2508470,225
"4783","chr1",20731513,20732873,20732193,1360
"4784","chr8",97868809,97869615,97869212,806
"4785","chr5",160118599,160119527,160119063,928
"4786","chr19",49818292,49818505,49818398,213
"4787","chr8",736830,739496,738163,2666
"4788","chr12",103495458,103496065,103495761,607
"4789","chr11",1870807,1871326,1871066,519
"4790","chr10",132395863,132397560,132396711,1697
"4791","chr3",16512820,16513906,16513363,1086
"4792","chr2",131590993,131591248,131591120,255
"4793","chr11",70202993,70203679,70203336,686
"4794","chr8",109539507,109539941,109539724,434
"4795","chr17",75877447,75878842,75878144,1395
"4796","chr2",31137455,31138955,31138205,1500
"4797","chr5",96662013,96663413,96662713,1400
"4798","chr7",101172203,101173714,101172958,1511
"4799","chr11",70087813,70088103,70087958,290
"4800","chrX",30888784,30889611,30889197,827
"4801","chr6",30555998,30557412,30556705,1414
"4802","chr10",97333649,97335198,97334423,1549
"4803","chr16",2055013,2055389,2055201,376
"4804","chr15",75356063,75356368,75356215,305
"4805","chr20",32277744,32277988,32277866,244
"4806","chr4",79964690,79964994,79964842,304
"4807","chr2",238633597,238633912,238633754,315
"4808","chr17",81917549,81918248,81917898,699
"4809","chr13",44989153,44989867,44989510,714
"4810","chr7",128869152,128870147,128869649,995
"4811","chr2",208406612,208407262,208406937,650
"4812","chr18",14458083,14459046,14458564,963
"4813","chr9",136466231,136466691,136466461,460
"4814","chr1",28581557,28582287,28581922,730
"4815","chr5",178730188,178730825,178730506,637
"4816","chr5",39424790,39425218,39425004,428
"4817","chr10",3784661,3785934,3785297,1273
"4818","chr12",12561699,12562924,12562311,1225
"4819","chr8",143733033,143734348,143733690,1315
"4820","chr3",119498461,119498909,119498685,448
"4821","chr3",131381497,131382307,131381902,810
"4822","chr2",189441431,189441707,189441569,276
"4823","chr1",28530525,28530799,28530662,274
"4824","chr2",20012306,20013022,20012664,716
"4825","chr6",131950216,131950518,131950367,302
"4826","chr19",3611796,3613660,3612728,1864
"4827","chr6",44223397,44224135,44223766,738
"4828","chr11",118401546,118401831,118401688,285
"4829","chr8",60922140,60923312,60922726,1172
"4830","chr16",58463129,58464691,58463910,1562
"4831","chr17",29166185,29166862,29166523,677
"4832","chr3",39180789,39181179,39180984,390
"4833","chr8",11808264,11808799,11808531,535
"4834","chr7",138001545,138002310,138001927,765
"4835","chr18",26133764,26133989,26133876,225
"4836","chr4",100189989,100190340,100190164,351
"4837","chr5",17216380,17218526,17217453,2146
"4838","chr17",31345317,31345594,31345455,277
"4839","chr10",46282670,46283264,46282967,594
"4840","chr7",35800522,35801981,35801251,1459
"4841","chr18",9913467,9915167,9914317,1700
"4842","chr16",2107861,2112138,2109999,4277
"4843","chr16",917241,917619,917430,378
"4844","chrX",153982135,153982601,153982368,466
"4845","chr10",117136452,117138526,117137489,2074
"4846","chr10",96831950,96833516,96832733,1566
"4847","chr18",14132001,14132483,14132242,482
"4848","chr17",75153538,75154790,75154164,1252
"4849","chr5",146203162,146203948,146203555,786
"4850","chr22",42070403,42071117,42070760,714
"4851","chr16",89566184,89566391,89566287,207
"4852","chr17",39637012,39637469,39637240,457
"4853","chrX",49922417,49923384,49922900,967
"4854","chr8",23068142,23069399,23068770,1257
"4855","chr3",146544339,146544718,146544528,379
"4856","chr11",57482473,57483375,57482924,902
"4857","chr20",63555772,63556543,63556157,771
"4858","chr20",61289692,61290013,61289852,321
"4859","chr12",102119890,102120171,102120030,281
"4860","chr17",49963832,49965700,49964766,1868
"4861","chr17",49910160,49910737,49910448,577
"4862","chr12",388932,389371,389151,439
"4863","chr9",137834026,137835444,137834735,1418
"4864","chr16",70438685,70439746,70439215,1061
"4865","chr17",1203276,1204085,1203680,809
"4866","chr1",235503789,235505319,235504554,1530
"4867","chr5",132776756,132777929,132777342,1173
"4868","chr8",143716138,143716868,143716503,730
"4869","chr12",124738974,124739204,124739089,230
"4870","chr17",47813590,47813799,47813694,209
"4871","chr22",37515972,37516251,37516111,279
"4872","chrX",47658616,47659451,47659033,835
"4873","chr1",27959508,27960327,27959917,819
"4874","chr17",74893197,74893962,74893579,765
"4875","chr11",2850134,2850710,2850422,576
"4876","chr9",32566743,32567006,32566874,263
"4877","chr16",28613619,28614061,28613840,442
"4878","chr6",3140321,3140551,3140436,230
"4879","chr12",949315,950264,949789,949
"4880","chr5",180673700,180674209,180673954,509
"4881","chr7",2004948,2005153,2005050,205
"4882","chr7",1229529,1243095,1236312,13566
"4883","chr22",49241617,49241963,49241790,346
"4884","chr2",64018800,64019759,64019279,959
"4885","chr7",157866741,157867630,157867185,889
"4886","chr6",166626474,166628191,166627332,1717
"4887","chr2",45168730,45171047,45169888,2317
"4888","chr12",14769943,14771040,14770491,1097
"4889","chr10",16519605,16521720,16520662,2115
"4890","chr11",6611648,6612556,6612102,908
"4891","chr7",36389641,36390197,36389919,556
"4892","chr6",29723329,29724316,29723822,987
"4893","chr16",1974778,1975082,1974930,304
"4894","chr17",48646369,48647021,48646695,652
"4895","chr8",33722846,33723082,33722964,236
"4896","chr1",155078679,155082545,155080612,3866
"4897","chr20",58888597,58892684,58890640,4087
"4898","chr4",4859521,4860514,4860017,993
"4899","chr7",5374114,5374579,5374346,465
"4900","chrX",129979766,129984714,129982240,4948
"4901","chr4",99088585,99088978,99088781,393
"4902","chr2",159904093,159904941,159904517,848
"4903","chr17",5499811,5501282,5500546,1471
"4904","chr3",123884309,123884693,123884501,384
"4905","chr10",91409730,91410816,91410273,1086
"4906","chr16",2696526,2696793,2696659,267
"4907","chr11",71453051,71453634,71453342,583
"4908","chr20",6122789,6123323,6123056,534
"4909","chr15",40471165,40471997,40471581,832
"4910","chr4",109702803,109703675,109703239,872
"4911","chr11",92224469,92226866,92225667,2397
"4912","chr13",80654912,80655310,80655111,398
"4913","chr12",57610097,57610466,57610281,369
"4914","chr16",4752408,4752786,4752597,378
"4915","chr1",23368197,23369557,23368877,1360
"4916","chr7",86786304,86786796,86786550,492
"4917","chr17",82613519,82613825,82613672,306
"4918","chr16",15888388,15888815,15888601,427
"4919","chr8",66177014,66177727,66177370,713
"4920","chr6",166870821,166871055,166870938,234
"4921","chr7",129144641,129145256,129144948,615
"4922","chr6",156687004,156687694,156687349,690
"4923","chr5",141183935,141184786,141184360,851
"4924","chr6",43013670,43014339,43014004,669
"4925","chr19",49524520,49524754,49524637,234
"4926","chr2",467849,468659,468254,810
"4927","chr16",74700254,74700674,74700464,420
"4928","chr2",96839482,96839863,96839672,381
"4929","chr6",83853101,83854039,83853570,938
"4930","chr2",240641307,240641865,240641586,558
"4931","chr2",127218813,127220394,127219603,1581
"4932","chr16",46883937,46885045,46884491,1108
"4933","chr8",8723041,8723704,8723372,663
"4934","chr11",64568017,64568493,64568255,476
"4935","chr6",39792290,39792650,39792470,360
"4936","chr21",31251828,31252066,31251947,238
"4937","chr2",112275216,112276380,112275798,1164
"4938","chr5",139764380,139764639,139764509,259
"4939","chrX",48801305,48802222,48801763,917
"4940","chr15",65869211,65870255,65869733,1044
"4941","chr2",130037767,130038141,130037954,374
"4942","chrY",12537115,12537734,12537424,619
"4943","chr6",31681304,31681596,31681450,292
"4944","chrX",100928888,100929355,100929121,467
"4945","chr8",142316997,142317416,142317206,419
"4946","chrY",2934923,2936242,2935582,1319
"4947","chr16",28292290,28293462,28292876,1172
"4948","chr5",78294313,78294897,78294605,584
"4949","chr10",100659390,100659911,100659650,521
"4950","chr8",38650781,38651230,38651005,449
"4951","chr20",41365905,41366876,41366390,971
"4952","chr5",178153533,178154125,178153829,592
"4953","chr9",136177909,136178230,136178069,321
"4954","chr22",46267708,46268149,46267928,441
"4955","chr7",2928600,2928962,2928781,362
"4956","chr2",74648001,74648435,74648218,434
"4957","chr11",2143905,2144442,2144173,537
"4958","chr13",102400092,102400594,102400343,502
"4959","chr5",28927498,28928530,28928014,1032
"4960","chr10",125719058,125719997,125719527,939
"4961","chr9",88180439,88180665,88180552,226
"4962","chr6",14210850,14211513,14211181,663
"4963","chr20",18497015,18497248,18497131,233
"4964","chr6",149990120,149991233,149990676,1113
"4965","chr8",143828885,143829905,143829395,1020
"4966","chr16",1500143,1500828,1500485,685
"4967","chr13",21669120,21671223,21670171,2103
"4968","chr5",179801283,179802003,179801643,720
"4969","chr13",21298040,21298526,21298283,486
"4970","chr16",88204063,88204287,88204175,224
"4971","chr5",179224050,179224327,179224188,277
"4972","chr11",131910458,131911638,131911048,1180
"4973","chr21",33033269,33034230,33033749,961
"4974","chr5",140145853,140146642,140146247,789
"4975","chr19",45076063,45076760,45076411,697
"4976","chr7",847166,847898,847532,732
"4977","chr19",20051963,20052298,20052130,335
"4978","chr3",195442162,195443390,195442776,1228
"4979","chr5",135543753,135544129,135543941,376
"4980","chr17",27332758,27333138,27332948,380
"4981","chr13",110456792,110457305,110457048,513
"4982","chr5",140882299,140882568,140882433,269
"4983","chr5",116447379,116447729,116447554,350
"4984","chr6",43516740,43517149,43516944,409
"4985","chr11",67665284,67665580,67665432,296
"4986","chr13",77026435,77027293,77026864,858
"4987","chr22",37069016,37069291,37069153,275
"4988","chrX",106999276,107000363,106999819,1087
"4989","chr7",151174214,151174949,151174581,735
"4990","chr6",55174372,55174594,55174483,222
"4991","chr17",37358853,37359684,37359268,831
"4992","chr19",38502523,38502735,38502629,212
"4993","chr16",3157596,3159412,3158504,1816
"4994","chr10",103967031,103967668,103967349,637
"4995","chr11",107591093,107591922,107591507,829
"4996","chr10",18651599,18651836,18651717,237
"4997","chr2",25251888,25252729,25252308,841
"4998","chr5",912379,912746,912562,367
"4999","chr22",36322405,36322715,36322560,310
"5000","chr5",181217239,181217683,181217461,444
"5001","chr10",80453800,80455004,80454402,1204
"5002","chr11",73264424,73264752,73264588,328
"5003","chr10",103692580,103693472,103693026,892
"5004","chr7",72335772,72337783,72336777,2011
"5005","chr17",4143668,4144073,4143870,405
"5006","chr16",88322116,88322441,88322278,325
"5007","chr10",133105251,133105471,133105361,220
"5008","chr7",98281147,98282306,98281726,1159
"5009","chr12",119154051,119154371,119154211,320
"5010","chr18",79787846,79790299,79789072,2453
"5011","chr19",29093039,29093357,29093198,318
"5012","chr5",67003940,67004146,67004043,206
"5013","chr18",2571287,2571581,2571434,294
"5014","chr5",1060924,1061607,1061265,683
"5015","chr13",50909795,50910455,50910125,660
"5016","chr12",110501651,110502368,110502009,717
"5017","chr4",8636349,8636618,8636483,269
"5018","chr2",176171526,176172485,176172005,959
"5019","chr10",91923673,91924082,91923877,409
"5020","chr6",29165687,29166196,29165941,509
"5021","chr11",57514198,57515832,57515015,1634
"5022","chr1",226736859,226738852,226737855,1993
"5023","chrX",154295388,154295822,154295605,434
"5024","chr16",3013678,3013980,3013829,302
"5025","chr1",226548679,226549711,226549195,1032
"5026","chr11",104036677,104037262,104036969,585
"5027","chr7",41965469,41966523,41965996,1054
"5028","chrX",110317475,110318322,110317898,847
"5029","chr5",16465129,16466351,16465740,1222
"5030","chr8",24942190,24942634,24942412,444
"5031","chr17",63848907,63849583,63849245,676
"5032","chr7",108001350,108003613,108002481,2263
"5033","chr6",144284790,144287144,144285967,2354
"5034","chr22",20964890,20965624,20965257,734
"5035","chr8",144500077,144501324,144500700,1247
"5036","chr8",68330685,68331568,68331126,883
"5037","chr1",44784188,44784680,44784434,492
"5038","chr6",35141024,35141722,35141373,698
"5039","chr4",139301272,139302181,139301726,909
"5040","chr22",19144479,19144784,19144631,305
"5041","chr7",149764564,149766133,149765348,1569
"5042","chr22",23402342,23402911,23402626,569
"5043","chr2",120343470,120343856,120343663,386
"5044","chr14",73758923,73760506,73759714,1583
"5045","chr12",57078491,57078836,57078663,345
"5046","chr10",88582771,88583464,88583117,693
"5047","chr5",109885285,109885498,109885391,213
"5048","chr10",2772811,2773277,2773044,466
"5049","chr5",1522910,1524473,1523691,1563
"5050","chr22",23180363,23182278,23181320,1915
"5051","chr4",41881475,41882553,41882014,1078
"5052","chr7",149624096,149625143,149624619,1047
"5053","chr13",112728284,112728693,112728488,409
"5054","chr2",208360247,208360583,208360415,336
"5055","chr5",141475819,141477053,141476436,1234
"5056","chr10",133520218,133520558,133520388,340
"5057","chr2",167716039,167716324,167716181,285
"5058","chr7",101232387,101232931,101232659,544
"5059","chr13",36431458,36432316,36431887,858
"5060","chr1",6180971,6181191,6181081,220
"5061","chr5",17655143,17655614,17655378,471
"5062","chr9",133979298,133979523,133979410,225
"5063","chr9",97848414,97849235,97848824,821
"5064","chr7",157138475,157139666,157139070,1191
"5065","chr17",76021570,76022577,76022073,1007
"5066","chr10",133457279,133457557,133457418,278
"5067","chr5",176365352,176366502,176365927,1150
"5068","chr2",131299289,131299626,131299457,337
"5069","chr19",3942012,3942252,3942132,240
"5070","chr5",95960664,95962114,95961389,1450
"5071","chr5",6378178,6378733,6378455,555
"5072","chr2",86622919,86624055,86623487,1136
"5073","chr11",6629674,6630848,6630261,1174
"5074","chr11",2443941,2444418,2444179,477
"5075","chr19",45676904,45677511,45677207,607
"5076","chr2",10042508,10044575,10043541,2067
"5077","chr16",30893755,30894462,30894108,707
"5078","chr7",158144922,158145149,158145035,227
"5079","chr11",120210779,120211637,120211208,858
"5080","chr10",133357141,133358450,133357795,1309
"5081","chr2",24049830,24050443,24050136,613
"5082","chr2",154697493,154699557,154698525,2064
"5083","chr7",76201724,76202224,76201974,500
"5084","chr16",87317028,87317964,87317496,936
"5085","chr11",74749076,74749513,74749294,437
"5086","chr8",116766248,116766907,116766577,659
"5087","chr15",24954888,24955907,24955397,1019
"5088","chr8",43276902,43277335,43277118,433
"5089","chr16",21158489,21158957,21158723,468
"5090","chr7",1050541,1050881,1050711,340
"5091","chr16",68084661,68086083,68085372,1422
"5092","chr2",237486418,237487598,237487008,1180
"5093","chr8",124998055,124998952,124998503,897
"5094","chr11",102268693,102268921,102268807,228
"5095","chr3",46565856,46566316,46566086,460
"5096","chr20",62474273,62476841,62475557,2568
"5097","chr8",30027255,30027794,30027524,539
"5098","chr19",35755583,35757081,35756332,1498
"5099","chr5",157142565,157143056,157142810,491
"5100","chr16",2720837,2721404,2721120,567
"5101","chr10",43202329,43202778,43202553,449
"5102","chr7",712075,712829,712452,754
"5103","chr22",48623105,48623505,48623305,400
"5104","chr1",27383110,27383341,27383225,231
"5105","chr7",2543572,2543908,2543740,336
"5106","chr11",12110266,12111469,12110867,1203
"5107","chr7",130490898,130493270,130492084,2372
"5108","chr11",63490906,63491332,63491119,426
"5109","chr8",123072662,123073078,123072870,416
"5110","chr18",24014049,24015500,24014774,1451
"5111","chr7",64181634,64183424,64182529,1790
"5112","chr7",140398105,140398628,140398366,523
"5113","chr16",71461870,71462357,71462113,487
"5114","chr13",52845762,52848737,52847249,2975
"5115","chr2",170813600,170814039,170813819,439
"5116","chr1",234599788,234600374,234600081,586
"5117","chr20",54172713,54174447,54173580,1734
"5118","chr4",184803280,184803493,184803386,213
"5119","chr10",34814196,34816315,34815255,2119
"5120","chr16",74367648,74368741,74368194,1093
"5121","chr20",23035079,23036242,23035660,1163
"5122","chr16",49854563,49859443,49857003,4880
"5123","chr11",85628299,85628585,85628442,286
"5124","chr2",1839074,1839365,1839219,291
"5125","chr4",900123,900398,900260,275
"5126","chr3",184361427,184363498,184362462,2071
"5127","chr7",64889046,64889773,64889409,727
"5128","chr19",12838592,12838919,12838755,327
"5129","chr7",108525767,108526341,108526054,574
"5130","chr15",82043131,82047596,82045363,4465
"5131","chr6",130365269,130366591,130365930,1322
"5132","chr7",23531138,23532200,23531669,1062
"5133","chr8",91070008,91070757,91070382,749
"5134","chr4",63349129,63349866,63349497,737
"5135","chr8",120125247,120125539,120125393,292
"5136","chr4",153759622,153760225,153759923,603
"5137","chr7",8433509,8435569,8434539,2060
"5138","chr15",25862356,25863671,25863013,1315
"5139","chr16",11742217,11743236,11742726,1019
"5140","chr12",94102057,94102454,94102255,397
"5141","chr21",42569838,42570089,42569963,251
"5142","chr15",64911531,64912193,64911862,662
"5143","chr12",105107555,105108189,105107872,634
"5144","chr6",57089933,57090688,57090310,755
"5145","chr22",26657117,26657665,26657391,548
"5146","chr20",3846578,3847384,3846981,806
"5147","chr2",20051433,20052103,20051768,670
"5148","chr11",65423353,65423587,65423470,234
"5149","chr21",45972581,45974622,45973601,2041
"5150","chr6",170172845,170173201,170173023,356
"5151","chr11",17475916,17477079,17476497,1163
"5152","chr20",62840551,62840904,62840727,353
"5153","chr2",210224689,210225452,210225070,763
"5154","chr7",149873277,149874300,149873788,1023
"5155","chr19",8485655,8486331,8485993,676
"5156","chr3",197456533,197456853,197456693,320
"5157","chr9",1050078,1050510,1050294,432
"5158","chr20",5112714,5113499,5113106,785
"5159","chr22",24952184,24953777,24952980,1593
"5160","chr7",106284204,106285209,106284706,1005
"5161","chr15",65355140,65356153,65355646,1013
"5162","chr5",69166848,69167313,69167080,465
"5163","chr17",73642889,73645531,73644210,2642
"5164","chr22",31970505,31971074,31970789,569
"5165","chr11",67616066,67616338,67616202,272
"5166","chr8",131904003,131904813,131904408,810
"5167","chr7",63756576,63756985,63756780,409
"5168","chr2",95389146,95389395,95389270,249
"5169","chr6",161645885,161646657,161646271,772
"5170","chr3",87792646,87793413,87793029,767
"5171","chr10",27100146,27100693,27100419,547
"5172","chr11",10294685,10294922,10294803,237
"5173","chr1",41381581,41383465,41382523,1884
"5174","chr10",73781799,73782448,73782123,649
"5175","chr22",45889597,45891742,45890669,2145
"5176","chr16",81035687,81036558,81036122,871
"5177","chr10",69630134,69630599,69630366,465
"5178","chrX",129843564,129844022,129843793,458
"5179","chr21",35026663,35026962,35026812,299
"5180","chr20",63071963,63072670,63072316,707
"5181","chr16",85798814,85800236,85799525,1422
"5182","chr4",163166309,163166994,163166651,685
"5183","chr16",30569906,30570213,30570059,307
"5184","chr1",54997015,54997337,54997176,322
"5185","chrX",70930825,70931152,70930988,327
"5186","chr3",46812237,46812588,46812412,351
"5187","chr6",36684097,36684358,36684227,261
"5188","chr11",33257111,33258629,33257870,1518
"5189","chr7",2210381,2210640,2210510,259
"5190","chr16",1129618,1129942,1129780,324
"5191","chr8",141128109,141129243,141128676,1134
"5192","chr7",156639739,156640976,156640357,1237
"5193","chr4",872310,872546,872428,236
"5194","chr1",7062459,7062667,7062563,208
"5195","chr12",3365844,3366488,3366166,644
"5196","chr9",89310457,89311724,89311090,1267
"5197","chr11",126416556,126416975,126416765,419
"5198","chr12",138289,139335,138812,1046
"5199","chr5",64768416,64768711,64768563,295
"5200","chr1",66752396,66752610,66752503,214
"5201","chr10",69318190,69319621,69318905,1431
"5202","chr1",27914073,27915024,27914548,951
"5203","chr2",3703238,3704337,3703787,1099
"5204","chr21",42879001,42879698,42879349,697
"5205","chr8",124474280,124475381,124474830,1101
"5206","chr15",78149153,78149919,78149536,766
"5207","chr7",143361747,143363063,143362405,1316
"5208","chr2",102618917,102620095,102619506,1178
"5209","chr15",30903470,30904018,30903744,548
"5210","chr7",158425159,158428017,158426588,2858
"5211","chr3",187139139,187139871,187139505,732
"5212","chr11",95150483,95151647,95151065,1164
"5213","chr12",120739312,120739538,120739425,226
"5214","chr3",196639523,196640048,196639785,525
"5215","chr6",34531536,34531803,34531669,267
"5216","chr15",101088923,101089253,101089088,330
"5217","chr8",142390270,142390870,142390570,600
"5218","chr22",27918600,27919970,27919285,1370
"5219","chr1",32204968,32206284,32205626,1316
"5220","chr2",25168203,25169006,25168604,803
"5221","chr2",132669079,132671297,132670188,2218
"5222","chr21",36692879,36693885,36693382,1006
"5223","chr12",7189478,7190202,7189840,724
"5224","chr7",50468042,50468255,50468148,213
"5225","chr3",3179399,3179933,3179666,534
"5226","chr16",75566108,75566962,75566535,854
"5227","chr5",124651705,124652055,124651880,350
"5228","chr16",49492337,49492753,49492545,416
"5229","chr3",23202559,23203557,23203058,998
"5230","chr7",1569789,1570401,1570095,612
"5231","chr13",113412631,113413173,113412902,542
"5232","chr1",211207064,211207441,211207252,377
"5233","chr6",26285195,26285712,26285453,517
"5234","chr12",7018230,7019052,7018641,822
"5235","chr3",129605072,129607181,129606126,2109
"5236","chr10",93060269,93063495,93061882,3226
"5237","chr15",22714471,22715301,22714886,830
"5238","chr2",33599243,33599790,33599516,547
"5239","chr3",161221173,161221706,161221439,533
"5240","chr5",14011510,14011932,14011721,422
"5241","chr4",17577025,17577916,17577470,891
"5242","chr1",2525802,2526820,2526311,1018
"5243","chr3",128726057,128726807,128726432,750
"5244","chr2",120984530,120984820,120984675,290
"5245","chr8",74320414,74321866,74321140,1452
"5246","chr10",5976981,5978171,5977576,1190
"5247","chr16",87957681,87957990,87957835,309
"5248","chr8",2085456,2085709,2085582,253
"5249","chr7",2156048,2156348,2156198,300
"5250","chr5",140664609,140665061,140664835,452
"5251","chr1",3649780,3653072,3651426,3292
"5252","chrX",149937895,149938705,149938300,810
"5253","chr1",151721515,151721806,151721660,291
"5254","chr1",243474337,243474840,243474588,503
"5255","chr13",99989080,99989934,99989507,854
"5256","chr11",113773577,113773935,113773756,358
"5257","chr1",86704192,86705332,86704762,1140
"5258","chr8",145002560,145003535,145003047,975
"5259","chr9",121499527,121500308,121499917,781
"5260","chr5",141849365,141850519,141849942,1154
"5261","chr3",11568663,11568896,11568779,233
"5262","chr1",161020928,161021435,161021181,507
"5263","chr6",44126971,44128397,44127684,1426
"5264","chr10",13891482,13892184,13891833,702
"5265","chr1",167219893,167222124,167221008,2231
"5266","chr10",8049411,8056366,8052888,6955
"5267","chr8",140510770,140512361,140511565,1591
"5268","chr10",132908542,132908788,132908665,246
"5269","chr1",15744133,15744358,15744245,225
"5270","chr2",36597649,36598162,36597905,513
"5271","chr2",233463407,233463698,233463552,291
"5272","chr1",46668002,46668723,46668362,721
"5273","chr6",36196355,36197428,36196891,1073
"5274","chr9",88006673,88007186,88006929,513
"5275","chr3",49006699,49007793,49007246,1094
"5276","chr9",77013994,77014477,77014235,483
"5277","chr7",50399868,50400702,50400285,834
"5278","chr15",38454073,38454584,38454328,511
"5279","chr1",6424443,6425267,6424855,824
"5280","chr15",32615457,32615749,32615603,292
"5281","chr12",116508390,116508802,116508596,412
"5282","chr8",35236382,35236593,35236487,211
"5283","chr19",36378662,36379377,36379019,715
"5284","chr2",202871202,202872160,202871681,958
"5285","chr20",56625223,56631733,56628478,6510
"5286","chr8",96261387,96262539,96261963,1152
"5287","chr10",1159622,1159919,1159770,297
"5288","chr21",39348259,39349699,39348979,1440
"5289","chr19",50358516,50358826,50358671,310
"5290","chr1",109739729,109740684,109740206,955
"5291","chr8",125091518,125091880,125091699,362
"5292","chr1",52404195,52404633,52404414,438
"5293","chr19",58203853,58204666,58204259,813
"5294","chr2",239905412,239905644,239905528,232
"5295","chr20",842210,842417,842313,207
"5296","chr1",17407939,17408149,17408044,210
"5297","chr11",134124814,134125195,134125004,381
"5298","chr11",27700114,27701092,27700603,978
"5299","chr1",9730234,9730646,9730440,412
"5300","chr11",95037442,95038240,95037841,798
"5301","chr2",73385527,73386533,73386030,1006
"5302","chr8",106657761,106658363,106658062,602
"5303","chr2",61065733,61066450,61066091,717
"5304","chr8",1359941,1360333,1360137,392
"5305","chr12",108514925,108515698,108515311,773
"5306","chr19",2250561,2253960,2252260,3399
"5307","chr11",125592428,125592989,125592708,561
"5308","chr11",113387721,113388099,113387910,378
"5309","chr11",78903160,78903552,78903356,392
"5310","chr1",1019388,1020963,1020175,1575
"5311","chr11",115659279,115659830,115659554,551
"5312","chr16",67841814,67843181,67842497,1367
"5313","chr11",77147682,77147951,77147816,269
"5314","chr3",184241273,184241959,184241616,686
"5315","chr11",76670405,76671251,76670828,846
"5316","chr16",49638532,49638814,49638673,282
"5317","chr14",21090388,21093284,21091836,2896
"5318","chr1",11859058,11859498,11859278,440
"5319","chr15",101053242,101053677,101053459,435
"5320","chr15",40694673,40695574,40695123,901
"5321","chr22",41205065,41205472,41205268,407
"5322","chr10",101131253,101132274,101131763,1021
"5323","chr1",37931564,37932049,37931806,485
"5324","chr1",2150875,2151090,2150982,215
"5325","chr3",4303321,4303658,4303489,337
"5326","chr20",31722700,31722904,31722802,204
"5327","chr1",1136989,1137467,1137228,478
"5328","chr9",129885764,129886005,129885884,241
"5329","chr5",320673,322895,321784,2222
"5330","chr2",124024675,124025678,124025176,1003
"5331","chr8",98944330,98944795,98944562,465
"5332","chr16",1180112,1180317,1180214,205
"5333","chr2",176490343,176490716,176490529,373
"5334","chr16",30064989,30066551,30065770,1562
"5335","chr18",57621408,57622250,57621829,842
"5336","chr15",76191752,76192239,76191995,487
"5337","chr20",32762201,32763457,32762829,1256
"5338","chr16",304243,304446,304344,203
"5339","chr11",43358691,43359490,43359090,799
"5340","chr19",40465569,40467486,40466527,1917
"5341","chr2",241239861,241240095,241239978,234
"5342","chr8",102806392,102807267,102806829,875
"5343","chr7",83162358,83163096,83162727,738
"5344","chr2",138780122,138781080,138780601,958
"5345","chr16",30561372,30561716,30561544,344
"5346","chr10",96586292,96587307,96586799,1015
"5347","chr21",29024527,29025089,29024808,562
"5348","chr7",151119918,151120150,151120034,232
"5349","chr1",9182108,9183768,9182938,1660
"5350","chr7",1664225,1670881,1667553,6656
"5351","chr5",40797549,40798840,40798194,1291
"5352","chr2",239816333,239816539,239816436,206
"5353","chr1",200302148,200302410,200302279,262
"5354","chr12",120116358,120117420,120116889,1062
"5355","chr4",77156842,77158438,77157640,1596
"5356","chr20",63807754,63808480,63808117,726
"5357","chr7",1027295,1028609,1027952,1314
"5358","chr9",113112919,113113458,113113188,539
"5359","chr8",10054119,10055123,10054621,1004
"5360","chr21",37072560,37074197,37073378,1637
"5361","chr2",113157104,113157819,113157461,715
"5362","chr2",236171545,236171789,236171667,244
"5363","chr20",2101638,2103424,2102531,1786
"5364","chr10",46023201,46023623,46023412,422
"5365","chr4",818598,818858,818728,260
"5366","chrX",107118289,107118670,107118479,381
"5367","chr10",73910938,73911621,73911279,683
"5368","chr2",161427070,161428068,161427569,998
"5369","chr7",139035298,139036273,139035785,975
"5370","chr16",30786423,30786794,30786608,371
"5371","chr11",96389372,96390423,96389897,1051
"5372","chr1",159854216,159855130,159854673,914
"5373","chr7",63560170,63560380,63560275,210
"5374","chr7",13989753,13989968,13989860,215
"5375","chr2",190407758,190408945,190408351,1187
"5376","chr3",51707108,51707397,51707252,289
"5377","chr13",96089884,96091908,96090896,2024
"5378","chr9",135412622,135412838,135412730,216
"5379","chr20",32582938,32585838,32584388,2900
"5380","chr19",18192813,18193482,18193147,669
"5381","chr7",50092976,50093325,50093150,349
"5382","chr10",101694222,101695357,101694789,1135
"5383","chr2",27262149,27265321,27263735,3172
"5384","chr5",178204218,178205507,178204862,1289
"5385","chr1",119853186,119853452,119853319,266
"5386","chr8",144331679,144339153,144335416,7474
"5387","chr15",49046166,49046574,49046370,408
"5388","chr16",979878,985327,982602,5449
"5389","chr1",181485838,181486125,181485981,287
"5390","chr1",161612243,161612587,161612415,344
"5391","chr16",84699557,84700497,84700027,940
"5392","chr7",149692609,149692885,149692747,276
"5393","chr7",36152739,36153825,36153282,1086
"5394","chrX",135434923,135435184,135435053,261
"5395","chr1",205679847,205680775,205680311,928
"5396","chr1",25819631,25820884,25820257,1253
"5397","chr1",46474564,46474765,46474664,201
"5398","chr22",41919498,41920405,41919951,907
"5399","chr1",1081483,1082059,1081771,576
"5400","chr16",15395669,15396218,15395943,549
"5401","chr1",94541281,94542083,94541682,802
"5402","chr9",114504188,114505814,114505001,1626
"5403","chr15",28832105,28832538,28832321,433
"5404","chr7",74083514,74084367,74083940,853
"5405","chr1",1426180,1426407,1426293,227
"5406","chr3",101724634,101725015,101724824,381
"5407","chr1",3640399,3640637,3640518,238
"5408","chr10",45198543,45199442,45198992,899
"5409","chr18",13824002,13824378,13824190,376
"5410","chr2",226791187,226791931,226791559,744
"5411","chr1",171670807,171671084,171670945,277
"5412","chr9",89676353,89676609,89676481,256
"5413","chr2",218908824,218909381,218909102,557
"5414","chr8",108443371,108444034,108443702,663
"5415","chr3",184298789,184299628,184299208,839
"5416","chr2",98608181,98608859,98608520,678
"5417","chr4",17781019,17782001,17781510,982
"5418","chr8",11284385,11285177,11284781,792
"5419","chr1",19311713,19312815,19312264,1102
"5420","chr11",45804064,45805426,45804745,1362
"5421","chr18",23453107,23453654,23453380,547
"5422","chr1",70205500,70205759,70205629,259
"5423","chr4",186104578,186105719,186105148,1141
"5424","chr1",2391042,2392325,2391683,1283
"5425","chr1",246565905,246566974,246566439,1069
"5426","chr11",62709298,62710009,62709653,711
"5427","chr16",1198853,1199446,1199149,593
"5428","chr1",163423087,163423310,163423198,223
"5429","chr3",169146242,169146661,169146451,419
"5430","chr10",119596301,119597446,119596873,1145
"5431","chr2",174328670,174329036,174328853,366
"5432","chr4",41878207,41878483,41878345,276
"5433","chr15",64045953,64046687,64046320,734
"5434","chr3",126988775,126989638,126989206,863
"5435","chr5",31532003,31532430,31532216,427
"5436","chr1",157993610,157994157,157993883,547
"5437","chr1",27489831,27490342,27490086,511
"5438","chr2",207166128,207166753,207166440,625
"5439","chr5",148383720,148384103,148383911,383
"5440","chr16",29901575,29901882,29901728,307
"5441","chr1",91949161,91949429,91949295,268
"5442","chr7",124764120,124764378,124764249,258
"5443","chr2",216810242,216810491,216810366,249
"5444","chr5",136079380,136079618,136079499,238
"5445","chr19",1401093,1401785,1401439,692
"5446","chr16",66406599,66407055,66406827,456
"5447","chr12",117098831,117099616,117099223,785
"5448","chr8",129983675,129983903,129983789,228
"5449","chrY",19567257,19567670,19567463,413
"5450","chr1",91885356,91886528,91885942,1172
"5451","chr7",116525377,116526424,116525900,1047
"5452","chr7",13991340,13991588,13991464,248
"5453","chr4",44726016,44726702,44726359,686
"5454","chr5",128082902,128084820,128083861,1918
"5455","chr7",218309,218951,218630,642
"5456","chr2",222291007,222291435,222291221,428
"5457","chr2",152098119,152099270,152098694,1151
"5458","chr20",3168014,3168414,3168214,400
"5459","chr1",37690370,37690607,37690488,237
"5460","chr1",183635148,183636198,183635673,1050
"5461","chr5",32173492,32174731,32174111,1239
"5462","chr5",91380005,91381113,91380559,1108
"5463","chr10",128265703,128266014,128265858,311
"5464","chr5",17491348,17491764,17491556,416
"5465","chr7",38177947,38178400,38178173,453
"5466","chr15",69160112,69161600,69160856,1488
"5467","chr1",241847849,241848442,241848145,593
"5468","chr7",155349985,155350801,155350393,816
"5469","chr3",54626162,54626611,54626386,449
"5470","chr7",22854026,22854958,22854492,932
"5471","chr20",57265160,57266738,57265949,1578
"5472","chr1",21823190,21823404,21823297,214
"5473","chr1",45339892,45340311,45340101,419
"5474","chr2",97735196,97735554,97735375,358
"5475","chr2",85616085,85616554,85616319,469
"5476","chr7",25179789,25180365,25180077,576
"5477","chr1",27349428,27351525,27350476,2097
"5478","chr2",105236674,105236883,105236778,209
"5479","chr15",74432982,74434146,74433564,1164
"5480","chr12",85280100,85280922,85280511,822
"5481","chr3",184017352,184018315,184017833,963
"5482","chr6",33711381,33711924,33711652,543
"5483","chr4",146945677,146946007,146945842,330
"5484","chr11",65111574,65112941,65112257,1367
"5485","chr1",118185193,118185474,118185333,281
"5486","chr7",30134614,30135840,30135227,1226
"5487","chr15",72319605,72320461,72320033,856
"5488","chr20",45840649,45840928,45840788,279
"5489","chr7",158316642,158316902,158316772,260
"5490","chr1",24502375,24503388,24502881,1013
"5491","chr1",225777628,225778032,225777830,404
"5492","chr2",135531400,135531849,135531624,449
"5493","chr19",1066867,1067674,1067270,807
"5494","chr2",241632896,241633287,241633091,391
"5495","chr8",143617063,143618311,143617687,1248
"5496","chr11",66568104,66568680,66568392,576
"5497","chr1",235104239,235104514,235104376,275
"5498","chr22",19131647,19132189,19131918,542
"5499","chr4",83109477,83110156,83109816,679
"5500","chr1",236281303,236282400,236281851,1097
"5501","chr10",83564943,83565246,83565094,303
"5502","chr5",157671255,157672033,157671644,778
"5503","chr1",2093766,2094786,2094276,1020
"5504","chr18",47028508,47030300,47029404,1792
"5505","chr7",112789925,112790511,112790218,586
"5506","chr8",64586046,64586271,64586158,225
"5507","chr1",228378248,228379420,228378834,1172
"5508","chr1",155609941,155610537,155610239,596
"5509","chr9",6006964,6008329,6007646,1365
"5510","chr7",101814138,101817750,101815944,3612
"5511","chr19",1007552,1011984,1009768,4432
"5512","chr13",25169860,25171989,25170924,2129
"5513","chr7",29684572,29685820,29685196,1248
"5514","chr21",46403168,46404186,46403677,1018
"5515","chr1",201647913,201650660,201649286,2747
"5516","chr10",97426021,97426537,97426279,516
"5517","chr2",61763779,61764697,61764238,918
"5518","chr11",127003196,127003914,127003555,718
"5519","chr20",3795551,3795772,3795661,221
"5520","chr2",160492712,160493860,160493286,1148
"5521","chr2",120522266,120522607,120522436,341
"5522","chr21",44338638,44339642,44339140,1004
"5523","chr1",92029810,92030407,92030108,597
"5524","chr15",91852783,91854452,91853617,1669
"5525","chr8",121639425,121640149,121639787,724
"5526","chr19",45472590,45473004,45472797,414
"5527","chr3",12158683,12159032,12158857,349
"5528","chr2",37083929,37084750,37084339,821
"5529","chr10",22436562,22437835,22437198,1273
"5530","chr8",106269803,106270919,106270361,1116
"5531","chr11",103091545,103092320,103091932,775
"5532","chr7",129778446,129782669,129780557,4223
"5533","chr7",90320944,90321464,90321204,520
"5534","chr2",232407694,232407990,232407842,296
"5535","chr16",86507824,86511622,86509723,3798
"5536","chr17",79943788,79944086,79943937,298
"5537","chr8",29348147,29352330,29350238,4183
"5538","chr16",88558398,88558640,88558519,242
"5539","chr16",23182395,23183452,23182923,1057
"5540","chr11",129278602,129280022,129279312,1420
"5541","chr3",44861467,44862373,44861920,906
"5542","chr3",182682290,182683052,182682671,762
"5543","chr7",26199798,26202442,26201120,2644
"5544","chr16",85898515,85899336,85898925,821
"5545","chr7",151782903,151783267,151783085,364
"5546","chr17",35770081,35770380,35770230,299
"5547","chr3",195989645,195990704,195990174,1059
"5548","chr16",14629745,14630309,14630027,564
"5549","chr6",137495337,137496086,137495711,749
"5550","chr10",133100307,133100535,133100421,228
"5551","chr10",16817090,16817976,16817533,886
"5552","chr17",2689734,2690750,2690242,1016
"5553","chr16",49698437,49698801,49698619,364
"5554","chr3",198113590,198113912,198113751,322
"5555","chr3",33439506,33440647,33440076,1141
"5556","chr5",151770453,151772525,151771489,2072
"5557","chr15",71115317,71116159,71115738,842
"5558","chr8",85463271,85464485,85463878,1214
"5559","chr16",87950795,87952127,87951461,1332
"5560","chr4",84492844,84493721,84493282,877
"5561","chr18",12911025,12912705,12911865,1680
"5562","chr3",52536346,52536826,52536586,480
"5563","chr10",59176067,59177289,59176678,1222
"5564","chr16",49275212,49275442,49275327,230
"5565","chr15",82539884,82540913,82540398,1029
"5566","chr4",187363034,187363248,187363141,214
"5567","chr1",53092716,53092970,53092843,254
"5568","chr4",124712525,124713120,124712822,595
"5569","chr1",245153245,245156945,245155095,3700
"5570","chr8",120123625,120123902,120123763,277
"5571","chr11",69157222,69157489,69157355,267
"5572","chr13",113096172,113097251,113096711,1079
"5573","chr1",151145573,151146897,151146235,1324
"5574","chr17",57045434,57046657,57046045,1223
"5575","chr7",5970444,5970777,5970610,333
"5576","chr4",189307406,189309644,189308525,2238
"5577","chr2",241558598,241559859,241559228,1261
"5578","chr16",67666106,67667451,67666778,1345
"5579","chr8",26039684,26040096,26039890,412
"5580","chr13",27450028,27451141,27450584,1113
"5581","chr16",67659548,67661657,67660602,2109
"5582","chr2",36808555,36808775,36808665,220
"5583","chr9",37002492,37002960,37002726,468
"5584","chr20",63360834,63362247,63361540,1413
"5585","chr11",60515310,60515572,60515441,262
"5586","chr6",56843261,56844368,56843814,1107
"5587","chr8",47959898,47960278,47960088,380
"5588","chr1",247639436,247639839,247639637,403
"5589","chr9",31253953,31254765,31254359,812
"5590","chr1",68496600,68497323,68496961,723
"5591","chr3",68007756,68008024,68007890,268
"5592","chr12",51951358,51952119,51951738,761
"5593","chr11",28110316,28110674,28110495,358
"5594","chr16",88234507,88234761,88234634,254
"5595","chr3",50237961,50238213,50238087,252
"5596","chr7",27115380,27115807,27115593,427
"5597","chr16",89052898,89053256,89053077,358
"5598","chr22",46658134,46658377,46658255,243
"5599","chr8",2055691,2056016,2055853,325
"5600","chr1",203629343,203629725,203629534,382
"5601","chr11",2376993,2378368,2377680,1375
"5602","chr1",177164256,177164710,177164483,454
"5603","chr4",78551652,78552023,78551837,371
"5604","chr5",2642991,2643195,2643093,204
"5605","chr16",2979751,2980953,2980352,1202
"5606","chr8",33599397,33599997,33599697,600
"5607","chr19",38949969,38950371,38950170,402
"5608","chr8",100720985,100722994,100721989,2009
"5609","chr9",14322394,14322986,14322690,592
"5610","chr16",661065,661275,661170,210
"5611","chr20",49812635,49813108,49812871,473
"5612","chr11",128549303,128549618,128549460,315
"5613","chr19",18203098,18204319,18203708,1221
"5614","chr10",42241838,42243690,42242764,1852
"5615","chr4",98657991,98659009,98658500,1018
"5616","chr2",28894500,28895159,28894829,659
"5617","chr6",30617108,30617900,30617504,792
"5618","chr10",70404300,70404817,70404558,517
"5619","chr22",39319468,39319940,39319704,472
"5620","chrX",53254647,53254856,53254751,209
"5621","chr1",40161241,40161940,40161590,699
"5622","chr3",19946841,19947829,19947335,988
"5623","chr17",81159294,81159548,81159421,254
"5624","chr13",28493651,28495840,28494745,2189
"5625","chr16",19717872,19718615,19718243,743
"5626","chr11",62855887,62856405,62856146,518
"5627","chr4",140252680,140253413,140253046,733
"5628","chr2",144331886,144332830,144332358,944
"5629","chr12",88035328,88035829,88035578,501
"5630","chr8",142449823,142453338,142451580,3515
"5631","chr5",173327053,173330095,173328574,3042
"5632","chr9",128392067,128393644,128392855,1577
"5633","chr3",187199623,187199968,187199795,345
"5634","chr2",128321898,128322596,128322247,698
"5635","chr10",133527751,133529057,133528404,1306
"5636","chr10",47325393,47325620,47325506,227
"5637","chr1",15934375,15934660,15934517,285
"5638","chr8",10613047,10613322,10613184,275
"5639","chr1",111139605,111140681,111140143,1076
"5640","chr4",173333532,173335387,173334459,1855
"5641","chr15",42736517,42737421,42736969,904
"5642","chr4",53377475,53378230,53377852,755
"5643","chr22",50299380,50300532,50299956,1152
"5644","chr22",27677923,27678270,27678096,347
"5645","chr11",82689543,82689816,82689679,273
"5646","chr1",50047972,50048648,50048310,676
"5647","chr7",47979218,47979792,47979505,574
"5648","chr5",2748254,2756910,2752582,8656
"5649","chr5",3854422,3854682,3854552,260
"5650","chr7",4641808,4642486,4642147,678
"5651","chr4",86892019,86892565,86892292,546
"5652","chr3",88058400,88058860,88058630,460
"5653","chr17",42562069,42563264,42562666,1195
"5654","chr6",41100736,41101604,41101170,868
"5655","chr10",17201305,17201788,17201546,483
"5656","chr11",132942767,132943180,132942973,413
"5657","chr10",22315978,22316703,22316340,725
"5658","chr10",124091635,124093717,124092676,2082
"5659","chr2",26033432,26034698,26034065,1266
"5660","chr3",24494353,24495945,24495149,1592
"5661","chr1",22710330,22711869,22711099,1539
"5662","chr18",49460134,49460824,49460479,690
"5663","chrX",17860321,17861141,17860731,820
"5664","chr15",98969436,98969662,98969549,226
"5665","chr4",98928154,98929401,98928777,1247
"5666","chr19",39498757,39499500,39499128,743
"5667","chr7",150720326,150720930,150720628,604
"5668","chr22",37658396,37659443,37658919,1047
"5669","chr2",144515889,144517811,144516850,1922
"5670","chr17",77451395,77451739,77451567,344
"5671","chr2",165793399,165794456,165793927,1057
"5672","chr3",156291202,156291531,156291366,329
"5673","chr8",32547889,32549383,32548636,1494
"5674","chr20",30376723,30377681,30377202,958
"5675","chr15",41115861,41116658,41116259,797
"5676","chr8",43056072,43056899,43056485,827
"5677","chr16",56519617,56520163,56519890,546
"5678","chr10",78973556,78974256,78973906,700
"5679","chr16",89080528,89080768,89080648,240
"5680","chr20",45469715,45470896,45470305,1181
"5681","chr11",58963838,58964062,58963950,224
"5682","chr6",57221598,57222513,57222055,915
"5683","chr18",8367275,8367601,8367438,326
"5684","chr2",60880990,60881881,60881435,891
"5685","chr11",93542648,93543464,93543056,816
"5686","chr11",2796757,2797151,2796954,394
"5687","chr1",100539012,100540329,100539670,1317
"5688","chr5",51382798,51383381,51383089,583
"5689","chr15",62067628,62068796,62068212,1168
"5690","chr1",169794832,169795206,169795019,374
"5691","chr2",110732400,110733307,110732853,907
"5692","chr1",156623865,156625674,156624769,1809
"5693","chr3",61564672,61564903,61564787,231
"5694","chr8",138877638,138878204,138877921,566
"5695","chr11",13008783,13011037,13009910,2254
"5696","chr2",74440466,74442276,74441371,1810
"5697","chr6",73695877,73696411,73696144,534
"5698","chr2",240888360,240888614,240888487,254
"5699","chr22",19291148,19291732,19291440,584
"5700","chr5",31854897,31855320,31855108,423
"5701","chr6",10404129,10404947,10404538,818
"5702","chr3",141231069,141232609,141231839,1540
"5703","chr7",22356420,22357198,22356809,778
"5704","chr8",123240814,123241467,123241140,653
"5705","chr10",43396098,43397469,43396783,1371
"5706","chr5",172683279,172684301,172683790,1022
"5707","chr16",2459815,2460611,2460213,796
"5708","chr11",112024852,112025723,112025287,871
"5709","chr2",119263099,119263394,119263246,295
"5710","chr20",23420471,23421657,23421064,1186
"5711","chr2",239938795,239939170,239938982,375
"5712","chr8",22164787,22165610,22165198,823
"5713","chr1",160205300,160205912,160205606,612
"5714","chr8",54101464,54102121,54101792,657
"5715","chr1",212432763,212433502,212433132,739
"5716","chr8",143428680,143431787,143430233,3107
"5717","chr2",74178225,74179037,74178631,812
"5718","chr7",32298371,32299113,32298742,742
"5719","chr16",31202245,31202966,31202605,721
"5720","chr5",1950510,1951557,1951033,1047
"5721","chr14",101559652,101565230,101562441,5578
"5722","chr1",958933,967274,963103,8341
"5723","chr8",13131871,13132126,13131998,255
"5724","chr1",2059340,2059732,2059536,392
"5725","chr8",29262440,29263270,29262855,830
"5726","chr1",108660971,108661756,108661363,785
"5727","chr8",41653468,41654191,41653829,723
"5728","chr7",26864250,26865134,26864692,884
"5729","chr17",409963,410590,410276,627
"5730","chr20",61977024,61977275,61977149,251
"5731","chr8",53657107,53657450,53657278,343
"5732","chr1",236795014,236795902,236795458,888
"5733","chr2",199955330,199955993,199955661,663
"5734","chr8",28701071,28702443,28701757,1372
"5735","chr1",40979198,40980444,40979821,1246
"5736","chr11",45180232,45181177,45180704,945
"5737","chr3",42536096,42536347,42536221,251
"5738","chr3",146469321,146469923,146469622,602
"5739","chr16",88726663,88727469,88727066,806
"5740","chr1",30773163,30773433,30773298,270
"5741","chr5",83472568,83473428,83472998,860
"5742","chr11",68460392,68461108,68460750,716
"5743","chr6",37705532,37705998,37705765,466
"5744","chr8",141518085,141518929,141518507,844
"5745","chrX",130109699,130111600,130110649,1901
"5746","chr1",1777955,1779143,1778549,1188
"5747","chr3",48440004,48440756,48440380,752
"5748","chr4",95548708,95549843,95549275,1135
"5749","chrX",12583363,12583713,12583538,350
"5750","chr3",14297749,14298074,14297911,325
"5751","chr3",112086338,112086723,112086530,385
"5752","chr16",89341829,89342057,89341943,228
"5753","chr1",3278812,3279488,3279150,676
"5754","chr1",161038587,161039040,161038813,453
"5755","chr5",179257325,179257658,179257491,333
"5756","chr8",143953490,143954184,143953837,694
"5757","chr8",23288015,23288493,23288254,478
"5758","chr1",16724996,16725396,16725196,400
"5759","chr1",44813093,44813956,44813524,863
"5760","chr15",26866883,26868332,26867607,1449
"5761","chr4",182799505,182800586,182800045,1081
"5762","chr19",42325403,42326445,42325924,1042
"5763","chr1",39514693,39516096,39515394,1403
"5764","chr1",156657550,156657784,156657667,234
"5765","chr1",17539434,17540048,17539741,614
"5766","chr19",49639966,49640718,49640342,752
"5767","chr1",11012340,11013188,11012764,848
"5768","chr1",2300871,2301178,2301024,307
"5769","chr8",98293675,98294498,98294086,823
"5770","chr11",809202,810509,809855,1307
"5771","chr7",100335615,100336464,100336039,849
"5772","chr19",2278606,2278849,2278727,243
"5773","chr3",39145033,39145239,39145136,206
"5774","chr5",81301501,81301915,81301708,414
"5775","chr22",37953495,37953962,37953728,467
"5776","chr20",22582098,22585466,22583782,3368
"5777","chr4",184097237,184097568,184097402,331
"5778","chr2",105337287,105337792,105337539,505
"5779","chr16",88523796,88524002,88523899,206
"5780","chr12",76878797,76879436,76879116,639
"5781","chr11",134037140,134037388,134037264,248
"5782","chr3",136862033,136862879,136862456,846
"5783","chrX",16719618,16719976,16719797,358
"5784","chr5",37208970,37209359,37209164,389
"5785","chr20",63589981,63590703,63590342,722
"5786","chr13",19633321,19633926,19633623,605
"5787","chr16",57382062,57382426,57382244,364
"5788","chr2",240573047,240573254,240573150,207
"5789","chr10",133128421,133129497,133128959,1076
"5790","chr16",88655916,88656290,88656103,374
"5791","chr22",16601046,16602738,16601892,1692
"5792","chr7",18086997,18087386,18087191,389
"5793","chr5",176542748,176544052,176543400,1304
"5794","chr4",101790672,101791042,101790857,370
"5795","chr4",48906275,48906833,48906554,558
"5796","chr21",44750015,44750260,44750137,245
"5797","chr11",14973582,14974362,14973972,780
"5798","chr6",154995316,154996063,154995689,747
"5799","chr16",11276082,11276364,11276223,282
"5800","chr9",135699437,135699658,135699547,221
"5801","chr16",89305079,89305302,89305190,223
"5802","chr22",36528888,36529581,36529234,693
"5803","chr10",72319696,72320103,72319899,407
"5804","chr16",67174164,67174775,67174469,611
"5805","chr6",42978572,42979389,42978980,817
"5806","chr20",22568329,22569082,22568705,753
"5807","chr5",73444224,73444973,73444598,749
"5808","chr5",14461043,14461354,14461198,311
"5809","chr10",472252,472531,472391,279
"5810","chr2",130836942,130837729,130837335,787
"5811","chr3",184229252,184231013,184230132,1761
"5812","chr6",106360409,106361296,106360852,887
"5813","chr5",181246068,181247150,181246609,1082
"5814","chr7",49773412,49776156,49774784,2744
"5815","chr19",23762911,23763326,23763118,415
"5816","chr19",4669915,4670592,4670253,677
"5817","chr11",8682236,8683069,8682652,833
"5818","chr17",81536560,81537155,81536857,595
"5819","chr8",26051776,26052170,26051973,394
"5820","chr15",84980281,84982634,84981457,2353
"5821","chr20",34872627,34873063,34872845,436
"5822","chr8",79765346,79765761,79765553,415
"5823","chr6",34028161,34028387,34028274,226
"5824","chr7",123748345,123749569,123748957,1224
"5825","chr18",78925187,78925397,78925292,210
"5826","chr18",65750600,65751404,65751002,804
"5827","chr15",101008470,101008693,101008581,223
"5828","chr7",51388844,51389137,51388990,293
"5829","chr7",155296995,155298502,155297748,1507
"5830","chr7",65873019,65874041,65873530,1022
"5831","chr16",69385625,69386183,69385904,558
"5832","chr22",30080023,30080541,30080282,518
"5833","chr22",47212945,47213572,47213258,627
"5834","chr15",72375700,72376317,72376008,617
"5835","chr6",147506777,147509426,147508101,2649
"5836","chr16",850440,851043,850741,603
"5837","chr7",91940672,91941034,91940853,362
"5838","chr6",32761565,32761883,32761724,318
"5839","chr7",100611971,100613032,100612501,1061
"5840","chr11",73217972,73218840,73218406,868
"5841","chr22",42368383,42369242,42368812,859
"5842","chr20",62417402,62418030,62417716,628
"5843","chr20",32052105,32052983,32052544,878
"5844","chr5",59039009,59040054,59039531,1045
"5845","chr2",160407279,160408032,160407655,753
"5846","chr18",13868533,13869027,13868780,494
"5847","chrY",22308657,22308936,22308796,279
"5848","chr1",174159158,174159909,174159533,751
"5849","chr7",1550751,1551384,1551067,633
"5850","chr19",50804182,50805114,50804648,932
"5851","chr4",93828344,93829847,93829095,1503
"5852","chr5",91280530,91280812,91280671,282
"5853","chr18",10726249,10726669,10726459,420
"5854","chr22",20858422,20859406,20858914,984
"5855","chr16",88933254,88933938,88933596,684
"5856","chr16",30657786,30659834,30658810,2048
"5857","chr19",39875386,39875968,39875677,582
"5858","chr15",63157219,63157824,63157521,605
"5859","chr3",53823365,53823927,53823646,562
"5860","chr2",118224193,118224890,118224541,697
"5861","chr2",219041385,219041606,219041495,221
"5862","chr3",126949416,126949677,126949546,261
"5863","chr20",59222168,59222438,59222303,270
"5864","chr15",26970804,26971709,26971256,905
"5865","chr19",50376349,50377026,50376687,677
"5866","chr12",4370356,4370807,4370581,451
"5867","chr19",1449940,1450388,1450164,448
"5868","chr2",10721080,10722256,10721668,1176
"5869","chr13",100532142,100532594,100532368,452
"5870","chr3",98522565,98523091,98522828,526
"5871","chr19",2235682,2237103,2236392,1421
"5872","chr3",49469951,49470857,49470404,906
"5873","chr8",23571525,23571752,23571638,227
"5874","chr6",3063577,3064319,3063948,742
"5875","chr8",27325573,27325873,27325723,300
"5876","chr10",133276465,133276987,133276726,522
"5877","chr16",32348326,32349160,32348743,834
"5878","chr11",125495241,125496423,125495832,1182
"5879","chr4",108166591,108169251,108167921,2660
"5880","chr10",114174124,114174503,114174313,379
"5881","chr18",35290211,35290548,35290379,337
"5882","chr7",97016474,97017287,97016880,813
"5883","chrX",129957090,129957652,129957371,562
"5884","chr7",138869485,138869753,138869619,268
"5885","chr1",27872520,27872746,27872633,226
"5886","chr7",76259768,76260442,76260105,674
"5887","chr6",151389959,151391442,151390700,1483
"5888","chr19",45584608,45585087,45584847,479
"5889","chr20",419600,419825,419712,225
"5890","chr6",57046404,57047190,57046797,786
"5891","chr20",31879741,31880162,31879951,421
"5892","chr7",1244203,1244404,1244303,201
"5893","chr1",38044430,38047970,38046200,3540
"5894","chr3",93973710,93973939,93973824,229
"5895","chr4",52861870,52862833,52862351,963
"5896","chr11",1036420,1036827,1036623,407
"5897","chr3",94062804,94063264,94063034,460
"5898","chr7",141014678,141015143,141014910,465
"5899","chr2",5706724,5707429,5707076,705
"5900","chr7",32891118,32892344,32891731,1226
"5901","chr16",70454455,70454911,70454683,456
"5902","chr15",40894695,40894971,40894833,276
"5903","chr1",61042970,61043734,61043352,764
"5904","chr1",223712288,223713121,223712704,833
"5905","chr19",33301155,33304038,33302596,2883
"5906","chr9",133200001,133200314,133200157,313
"5907","chr10",110672077,110672668,110672372,591
"5908","chr4",154332978,154333451,154333214,473
"5909","chr5",16178955,16180311,16179633,1356
"5910","chr11",65314466,65315862,65315164,1396
"5911","chr2",113437588,113437986,113437787,398
"5912","chr4",13529223,13529620,13529421,397
"5913","chr1",161389709,161390596,161390152,887
"5914","chr19",12260237,12260520,12260378,283
"5915","chr6",24494436,24495442,24494939,1006
"5916","chr2",131646711,131647387,131647049,676
"5917","chr8",22221587,22221833,22221710,246
"5918","chr2",235865239,235865440,235865339,201
"5919","chr1",242057447,242057698,242057572,251
"5920","chr1",247300546,247301408,247300977,862
"5921","chr19",46710806,46711047,46710926,241
"5922","chr1",92217881,92218125,92218003,244
"5923","chr3",128153333,128153999,128153666,666
"5924","chr9",127784985,127786838,127785911,1853
"5925","chr20",49046195,49046912,49046553,717
"5926","chr1",243931453,243931815,243931634,362
"5927","chr16",88623059,88623275,88623167,216
"5928","chr20",56924925,56926046,56925485,1121
"5929","chr19",40090633,40090956,40090794,323
"5930","chr5",95554703,95555465,95555084,762
"5931","chr18",76919885,76920089,76919987,204
"5932","chr20",49713108,49714145,49713626,1037
"5933","chr10",115092502,115094335,115093418,1833
"5934","chr3",9703768,9705098,9704433,1330
"5935","chr19",11406383,11406608,11406495,225
"5936","chr1",15214685,15214951,15214818,266
"5937","chr1",1699647,1701787,1700717,2140
"5938","chr17",17836197,17837237,17836717,1040
"5939","chr16",1102947,1103355,1103151,408
"5940","chr22",31084788,31085387,31085087,599
"5941","chr10",805160,805585,805372,425
"5942","chr19",4322977,4323204,4323090,227
"5943","chr9",2933373,2933724,2933548,351
"5944","chr10",118046314,118047033,118046673,719
"5945","chr11",1409709,1410604,1410156,895
"5946","chr1",84077463,84078578,84078020,1115
"5947","chr22",41682056,41682545,41682300,489
"5948","chr9",135744863,135745123,135744993,260
"5949","chr9",127244950,127245409,127245179,459
"5950","chr19",50329044,50329375,50329209,331
"5951","chr10",75210234,75211244,75210739,1010
"5952","chr1",112722951,112723165,112723058,214
"5953","chr18",2654919,2656818,2655868,1899
"5954","chr16",3140764,3141388,3141076,624
"5955","chr22",43151313,43152163,43151738,850
"5956","chr12",128823389,128824179,128823784,790
"5957","chr6",131135224,131136017,131135620,793
"5958","chr15",72473919,72475352,72474635,1433
"5959","chr17",1399312,1400595,1399953,1283
"5960","chr16",22162357,22162599,22162478,242
"5961","chr11",109422793,109423692,109423242,899
"5962","chr8",18386945,18387716,18387330,771
"5963","chr1",1760328,1760624,1760476,296
"5964","chr1",183416865,183418529,183417697,1664
"5965","chr1",43007196,43007663,43007429,467
"5966","chr3",30606495,30607389,30606942,894
"5967","chr12",55743017,55744000,55743508,983
"5968","chr4",3447923,3448268,3448095,345
"5969","chr3",64444909,64445516,64445212,607
"5970","chr13",99498438,99498766,99498602,328
"5971","chr11",128810437,128810648,128810542,211
"5972","chr19",38209693,38209937,38209815,244
"5973","chr1",21289887,21290608,21290247,721
"5974","chr21",13609615,13609862,13609738,247
"5975","chr18",79713844,79714114,79713979,270
"5976","chr22",46289482,46289899,46289690,417
"5977","chr3",126287900,126288114,126288007,214
"5978","chr17",43952805,43953573,43953189,768
"5979","chr8",795683,795889,795786,206
"5980","chr1",4666516,4666807,4666661,291
"5981","chr3",48301094,48301768,48301431,674
"5982","chr4",151015501,151016367,151015934,866
"5983","chr16",29251575,29251805,29251690,230
"5984","chr16",88393107,88393331,88393219,224
"5985","chr11",18105744,18106164,18105954,420
"5986","chr4",2063815,2064671,2064243,856
"5987","chr3",54087597,54088120,54087858,523
"5988","chr2",51027477,51028360,51027918,883
"5989","chr19",1274470,1276359,1275414,1889
"5990","chr17",78214048,78214546,78214297,498
"5991","chr1",27549881,27551036,27550458,1155
"5992","chr13",52738858,52739910,52739384,1052
"5993","chr18",47022593,47024385,47023489,1792
"5994","chr12",118103249,118104330,118103789,1081
"5995","chr4",108650537,108650883,108650710,346
"5996","chr19",49688073,49688302,49688187,229
"5997","chr1",20343073,20343525,20343299,452
"5998","chr1",234373237,234373755,234373496,518
"5999","chr16",87414093,87414525,87414309,432
"6000","chr19",6707101,6707556,6707328,455
"6001","chr5",75611461,75611945,75611703,484
"6002","chr2",495193,495834,495513,641
"6003","chr16",88100934,88101243,88101088,309
"6004","chr13",27797372,27797631,27797501,259
"6005","chr5",1108687,1108936,1108811,249
"6006","chr16",87644279,87645054,87644666,775
"6007","chr17",39196952,39197688,39197320,736
"6008","chr1",156741006,156741354,156741180,348
"6009","chr1",15746823,15747026,15746924,203
"6010","chr6",38639429,38640372,38639900,943
"6011","chr19",41859608,41860695,41860151,1087
"6012","chr20",11890726,11891559,11891142,833
"6013","chr1",231626712,231627369,231627040,657
"6014","chr2",108449053,108449498,108449275,445
"6015","chr19",4723673,4723969,4723821,296
"6016","chr7",2253641,2253941,2253791,300
"6017","chr17",76074323,76077449,76075886,3126
"6018","chr1",90893565,90894006,90893785,441
"6019","chr8",79611740,79612161,79611950,421
"6020","chr21",33915499,33915904,33915701,405
"6021","chr20",23356231,23356564,23356397,333
"6022","chr1",78045893,78046477,78046185,584
"6023","chr11",47269522,47270619,47270070,1097
"6024","chr2",113890092,113890735,113890413,643
"6025","chr12",114671698,114672256,114671977,558
"6026","chr7",76329548,76329757,76329652,209
"6027","chr2",162073723,162074369,162074046,646
"6028","chr1",63329692,63330469,63330080,777
"6029","chr19",48468968,48469900,48469434,932
"6030","chr13",20192069,20193770,20192919,1701
"6031","chr22",43434979,43435242,43435110,263
"6032","chr3",45035577,45035919,45035748,342
"6033","chrX",46836706,46837640,46837173,934
"6034","chr7",53219158,53219499,53219328,341
"6035","chr15",70891937,70892350,70892143,413
"6036","chr7",94655546,94657215,94656380,1669
"6037","chr16",88429793,88431355,88430574,1562
"6038","chr6",35213318,35214770,35214044,1452
"6039","chr11",69654042,69654384,69654213,342
"6040","chr18",79473326,79476398,79474862,3072
"6041","chr17",45144398,45145021,45144709,623
"6042","chr7",1137943,1138619,1138281,676
"6043","chr20",1947072,1947472,1947272,400
"6044","chr7",34078851,34079147,34078999,296
"6045","chr7",56229739,56229969,56229854,230
"6046","chr17",82729503,82730050,82729776,547
"6047","chr19",40190904,40192286,40191595,1382
"6048","chr1",165630488,165631337,165630912,849
"6049","chr7",157873377,157873707,157873542,330
"6050","chr16",57528539,57529413,57528976,874
"6051","chr22",50562204,50563086,50562645,882
"6052","chr1",26045790,26046822,26046306,1032
"6053","chr1",21459952,21460220,21460086,268
"6054","chr10",104337837,104338798,104338317,961
"6055","chr17",50095096,50095630,50095363,534
"6056","chrX",153767013,153767899,153767456,886
"6057","chr21",42127761,42127979,42127870,218
"6058","chr1",242523614,242525380,242524497,1766
"6059","chr17",17280572,17281385,17280978,813
"6060","chr1",39080967,39082287,39081627,1320
"6061","chr17",4607259,4607482,4607370,223
"6062","chr8",38104931,38105935,38105433,1004
"6063","chr1",154558205,154559089,154558647,884
"6064","chr17",38673642,38675215,38674428,1573
"6065","chr1",165354954,165357091,165356022,2137
"6066","chr4",153153231,153153893,153153562,662
"6067","chr13",112898067,112898459,112898263,392
"6068","chr20",21521323,21523293,21522308,1970
"6069","chr17",841377,841667,841522,290
"6070","chr17",21376046,21377409,21376727,1363
"6071","chr22",29388180,29388790,29388485,610
"6072","chr11",66316101,66316311,66316206,210
"6073","chr20",2652032,2653044,2652538,1012
"6074","chr2",127526002,127526948,127526475,946
"6075","chr15",66780968,66781605,66781286,637
"6076","chr19",13505938,13506453,13506195,515
"6077","chr1",53438467,53439585,53439026,1118
"6078","chr6",158644159,158644762,158644460,603
"6079","chr1",117121647,117122526,117122086,879
"6080","chr1",109041233,109042224,109041728,991
"6081","chr11",16738398,16738839,16738618,441
"6082","chr7",50792544,50793432,50792988,888
"6083","chr13",74133972,74134392,74134182,420
"6084","chr9",137138783,137139724,137139253,941
"6085","chr19",8209357,8210161,8209759,804
"6086","chr19",15124955,15125820,15125387,865
"6087","chr12",123364070,123365372,123364721,1302
"6088","chr7",56874473,56874676,56874574,203
"6089","chr6",143511252,143511806,143511529,554
"6090","chr3",12796493,12796860,12796676,367
"6091","chr15",90529457,90530744,90530100,1287
"6092","chr1",88992351,88992921,88992636,570
"6093","chr10",104268766,104269289,104269027,523
"6094","chr9",95085858,95086243,95086050,385
"6095","chr19",7515938,7516529,7516233,591
"6096","chr17",355684,356876,356280,1192
"6097","chr8",1026015,1026416,1026215,401
"6098","chr10",68074656,68075476,68075066,820
"6099","chr12",98894444,98895596,98895020,1152
"6100","chr1",245974473,245976257,245975365,1784
"6101","chr17",17809597,17811069,17810333,1472
"6102","chr7",1403851,1404152,1404001,301
"6103","chr17",31558802,31560358,31559580,1556
"6104","chr4",147617298,147617567,147617432,269
"6105","chr2",86440692,86442324,86441508,1632
"6106","chr10",70132336,70133046,70132691,710
"6107","chr11",46277861,46278665,46278263,804
"6108","chr22",38467876,38468258,38468067,382
"6109","chr1",39408346,39409567,39408956,1221
"6110","chr15",75647163,75648490,75647826,1327
"6111","chr2",178450487,178451846,178451166,1359
"6112","chr17",38853218,38853865,38853541,647
"6113","chr2",73779722,73780147,73779934,425
"6114","chr1",44631609,44632377,44631993,768
"6115","chr9",132579777,132583199,132581488,3422
"6116","chr11",64660766,64660987,64660876,221
"6117","chr20",34955279,34956043,34955661,764
"6118","chr17",9771537,9771948,9771742,411
"6119","chr1",6051549,6051776,6051662,227
"6120","chr11",47176476,47177334,47176905,858
"6121","chr15",45587076,45587720,45587398,644
"6122","chr12",25958258,25959390,25958824,1132
"6123","chr7",157576428,157576702,157576565,274
"6124","chr19",1490389,1491807,1491098,1418
"6125","chr21",33491337,33491961,33491649,624
"6126","chr19",48735170,48735556,48735363,386
"6127","chr16",1408142,1408434,1408288,292
"6128","chr1",7663340,7665115,7664227,1775
"6129","chr12",132116681,132117439,132117060,758
"6130","chr10",44384266,44386943,44385604,2677
"6131","chr19",49019516,49019836,49019676,320
"6132","chr12",6689221,6689756,6689488,535
"6133","chr16",16363496,16367758,16365627,4262
"6134","chr1",180912180,180913283,180912731,1103
"6135","chr19",56795314,56795664,56795489,350
"6136","chr11",57426867,57427177,57427022,310
"6137","chr16",87216491,87217139,87216815,648
"6138","chr2",113235627,113236498,113236062,871
"6139","chr16",381189,382810,381999,1621
"6140","chr16",46789919,46790351,46790135,432
"6141","chr12",81077790,81078340,81078065,550
"6142","chr20",21020124,21020639,21020381,515
"6143","chr8",38030174,38031312,38030743,1138
"6144","chr11",120137338,120138002,120137670,664
"6145","chr17",28725923,28727066,28726494,1143
"6146","chr10",132227995,132228280,132228137,285
"6147","chr10",116741357,116743195,116742276,1838
"6148","chr7",24283939,24285461,24284700,1522
"6149","chr1",1554152,1554414,1554283,262
"6150","chr16",89119790,89120143,89119966,353
"6151","chr11",22192626,22193774,22193200,1148
"6152","chr1",229558025,229559327,229558676,1302
"6153","chr14",92106210,92106535,92106372,325
"6154","chr19",1483102,1484120,1483611,1018
"6155","chr16",89656784,89658228,89657506,1444
"6156","chr4",52712191,52713071,52712631,880
"6157","chr12",116737818,116738631,116738224,813
"6158","chr3",128608094,128608664,128608379,570
"6159","chr16",66604351,66605658,66605004,1307
"6160","chrX",11111156,11111638,11111397,482
"6161","chr11",7019841,7020718,7020279,877
"6162","chr1",22129530,22129732,22129631,202
"6163","chr5",73298320,73299981,73299150,1661
"6164","chr16",55056705,55057035,55056870,330
"6165","chr9",35102698,35103466,35103082,768
"6166","chr18",79526051,79526277,79526164,226
"6167","chr4",3514729,3515117,3514923,388
"6168","chr6",170283296,170283991,170283643,695
"6169","chr11",63938557,63939396,63938976,839
"6170","chr7",23415173,23415578,23415375,405
"6171","chr19",4639206,4639738,4639472,532
"6172","chr6",30006443,30007592,30007017,1149
"6173","chr16",30010937,30011686,30011311,749
"6174","chr2",30230700,30232789,30231744,2089
"6175","chr7",97871871,97872607,97872239,736
"6176","chr1",115642094,115642940,115642517,846
"6177","chr13",112163502,112164625,112164063,1123
"6178","chrX",120629882,120630375,120630128,493
"6179","chr7",139523688,139524323,139524005,635
"6180","chr10",15860080,15860403,15860241,323
"6181","chr2",183037674,183038553,183038113,879
"6182","chr15",93432524,93432750,93432637,226
"6183","chr10",133219826,133220841,133220333,1015
"6184","chr5",170106076,170106530,170106303,454
"6185","chr19",14418961,14419693,14419327,732
"6186","chr12",124324770,124325598,124325184,828
"6187","chr2",191881958,191882270,191882114,312
"6188","chr10",79347326,79348191,79347758,865
"6189","chr12",122752447,122753117,122752782,670
"6190","chr20",63295842,63296130,63295986,288
"6191","chr7",157423904,157424255,157424079,351
"6192","chr11",2166258,2167015,2166636,757
"6193","chr2",225041936,225042837,225042386,901
"6194","chr18",3247295,3248259,3247777,964
"6195","chr16",88532039,88532754,88532396,715
"6196","chr2",96638202,96638650,96638426,448
"6197","chr7",90118578,90119722,90119150,1144
"6198","chr1",248847364,248848597,248847980,1233
"6199","chrX",103687179,103687558,103687368,379
"6200","chr7",98251820,98252594,98252207,774
"6201","chr7",114084869,114087740,114086304,2871
"6202","chr19",55080065,55080276,55080170,211
"6203","chr1",36385488,36386272,36385880,784
"6204","chr19",41958599,41959543,41959071,944
"6205","chr1",197915930,197916259,197916094,329
"6206","chr11",73597754,73598455,73598104,701
"6207","chr12",75305530,75305733,75305631,203
"6208","chr2",38601961,38603662,38602811,1701
"6209","chr1",21887409,21887626,21887517,217
"6210","chr1",159188438,159188708,159188573,270
"6211","chr11",95789296,95790879,95790087,1583
"6212","chr8",27614437,27615006,27614721,569
"6213","chr21",37563552,37564244,37563898,692
"6214","chr10",131095165,131095425,131095295,260
"6215","chr6",7725862,7727928,7726895,2066
"6216","chrX",53422018,53422823,53422420,805
"6217","chr15",80694855,80696323,80695589,1468
"6218","chr19",41226101,41226660,41226380,559
"6219","chr9",132354547,132355396,132354971,849
"6220","chr12",132489257,132491149,132490203,1892
"6221","chr20",3751414,3752149,3751781,735
"6222","chr2",27494814,27495470,27495142,656
"6223","chr5",75336651,75337848,75337249,1197
"6224","chr4",147683803,147684474,147684138,671
"6225","chr6",37535762,37536515,37536138,753
"6226","chr10",102432227,102432770,102432498,543
"6227","chr15",41511245,41513333,41512289,2088
"6228","chr4",138560580,138560842,138560711,262
"6229","chr2",109031499,109031774,109031636,275
"6230","chr6",4018244,4018867,4018555,623
"6231","chr7",95527854,95528076,95527965,222
"6232","chr15",62060028,62060893,62060460,865
"6233","chr7",28955615,28958925,28957270,3310
"6234","chr2",197785027,197786875,197785951,1848
"6235","chr5",171456596,171456832,171456714,236
"6236","chr11",8963905,8964960,8964432,1055
"6237","chr22",50261040,50261929,50261484,889
"6238","chr1",75614769,75615123,75614946,354
"6239","chr6",18387219,18387615,18387417,396
"6240","chr2",100562856,100563619,100563237,763
"6241","chr16",88639803,88640084,88639943,281
"6242","chr16",614036,614587,614311,551
"6243","chr20",50958279,50959750,50959014,1471
"6244","chr4",5711077,5711724,5711400,647
"6245","chr19",19257909,19258872,19258390,963
"6246","chr13",76991923,76992464,76992193,541
"6247","chr11",118434707,118436990,118435848,2283
"6248","chr10",1397426,1397819,1397622,393
"6249","chr5",173228837,173229199,173229018,362
"6250","chr10",113165763,113165992,113165877,229
"6251","chr7",139716487,139716723,139716605,236
"6252","chr16",30557860,30558728,30558294,868
"6253","chr18",80033336,80034761,80034048,1425
"6254","chr10",114285995,114286353,114286174,358
"6255","chr19",50511061,50511616,50511338,555
"6256","chr10",101353766,101354657,101354211,891
"6257","chr7",2313994,2314792,2314393,798
"6258","chr19",17334263,17334998,17334630,735
"6259","chr6",10319448,10319812,10319630,364
"6260","chr22",37259565,37259799,37259682,234
"6261","chr15",88802812,88803972,88803392,1160
"6262","chr3",126704045,126704766,126704405,721
"6263","chr15",64151388,64152622,64152005,1234
"6264","chr19",15107438,15107806,15107622,368
"6265","chr14",90060352,90062607,90061479,2255
"6266","chr15",67065001,67066424,67065712,1423
"6267","chr16",88200382,88200584,88200483,202
"6268","chr7",1102995,1103226,1103110,231
"6269","chr8",11059152,11059807,11059479,655
"6270","chr7",37920714,37921444,37921079,730
"6271","chr12",57242774,57243890,57243332,1116
"6272","chr17",35449534,35449869,35449701,335
"6273","chr6",52670916,52671190,52671053,274
"6274","chr16",2798425,2799144,2798784,719
"6275","chr19",47860303,47860903,47860603,600
"6276","chr7",105244602,105244953,105244777,351
"6277","chr1",19664653,19666295,19665474,1642
"6278","chr17",17971853,17972619,17972236,766
"6279","chr17",18087766,18088267,18088016,501
"6280","chr7",42932035,42932700,42932367,665
"6281","chr19",51181457,51181992,51181724,535
"6282","chr15",64355715,64356324,64356019,609
"6283","chr20",63746826,63747259,63747042,433
"6284","chr22",26499219,26499494,26499356,275
"6285","chr22",30423410,30424309,30423859,899
"6286","chr10",75043782,75044099,75043940,317
"6287","chr19",33132004,33132325,33132164,321
"6288","chr14",101947920,101948883,101948401,963
"6289","chr17",15260613,15261493,15261053,880
"6290","chr3",123201856,123202267,123202061,411
"6291","chr12",95790095,95791421,95790758,1326
"6292","chr11",79437314,79441160,79439237,3846
"6293","chr12",6970337,6970966,6970651,629
"6294","chr12",6773689,6773940,6773814,251
"6295","chr16",88569768,88570925,88570346,1157
"6296","chr2",130213360,130213800,130213580,440
"6297","chr15",37101465,37102045,37101755,580
"6298","chr2",171433854,171434786,171434320,932
"6299","chr2",74833752,74835537,74834644,1785
"6300","chr19",12789590,12794140,12791865,4550
"6301","chr2",45004072,45005411,45004741,1339
"6302","chr3",13204192,13204539,13204365,347
"6303","chr18",77131404,77133470,77132437,2066
"6304","chr6",135180850,135183273,135182061,2423
"6305","chr9",136267261,136267714,136267487,453
"6306","chr11",61955272,61956011,61955641,739
"6307","chr8",42842726,42843183,42842954,457
"6308","chr22",44023944,44024910,44024427,966
"6309","chr6",42727127,42727893,42727510,766
"6310","chr11",1652604,1652994,1652799,390
"6311","chr7",151080520,151083792,151082156,3272
"6312","chr15",96331956,96334492,96333224,2536
"6313","chr8",56319811,56320236,56320023,425
"6314","chr15",74410712,74410914,74410813,202
"6315","chr6",168283922,168284254,168284088,332
"6316","chr17",34961155,34961894,34961524,739
"6317","chr16",29841752,29842074,29841913,322
"6318","chr2",239532315,239532553,239532434,238
"6319","chr4",11427790,11428009,11427899,219
"6320","chr10",104274816,104275045,104274930,229
"6321","chrX",153598585,153599805,153599195,1220
"6322","chr19",8005040,8005992,8005516,952
"6323","chr19",38905241,38905466,38905353,225
"6324","chr1",151611898,151612729,151612313,831
"6325","chr20",64079416,64080392,64079904,976
"6326","chr7",65269593,65269797,65269695,204
"6327","chr13",112104284,112106177,112105230,1893
"6328","chr8",102738653,102738860,102738756,207
"6329","chr7",157594361,157594630,157594495,269
"6330","chr17",32006944,32008107,32007525,1163
"6331","chr19",57191328,57192057,57191692,729
"6332","chr15",59657177,59657653,59657415,476
"6333","chr20",25083202,25084889,25084045,1687
"6334","chr16",16374394,16374598,16374496,204
"6335","chr11",129895250,129895722,129895486,472
"6336","chr3",136195355,136197248,136196301,1893
"6337","chr10",22713226,22714398,22713812,1172
"6338","chr2",426472,427581,427026,1109
"6339","chr7",158158562,158159108,158158835,546
"6340","chr11",299389,299635,299512,246
"6341","chr19",53991354,53991876,53991615,522
"6342","chr6",26458082,26458306,26458194,224
"6343","chr2",181680481,181680917,181680699,436
"6344","chr19",40570436,40570792,40570614,356
"6345","chr7",158126012,158126717,158126364,705
"6346","chr2",3500511,3500857,3500684,346
"6347","chr2",196068586,196068941,196068763,355
"6348","chr11",57567575,57568013,57567794,438
"6349","chr2",236101574,236101806,236101690,232
"6350","chr12",6663092,6663413,6663252,321
"6351","chr22",41666786,41666998,41666892,212
"6352","chr3",69079907,69080364,69080135,457
"6353","chr11",1460548,1461414,1460981,866
"6354","chr7",1073589,1074361,1073975,772
"6355","chr2",46698759,46699830,46699294,1071
"6356","chr5",43396795,43397262,43397028,467
"6357","chr19",58097971,58098621,58098296,650
"6358","chr2",113050940,113051179,113051059,239
"6359","chr22",38705820,38706663,38706241,843
"6360","chr17",7931853,7932251,7932052,398
"6361","chr3",16883888,16885350,16884619,1462
"6362","chr1",113198851,113199123,113198987,272
"6363","chr1",26695342,26697530,26696436,2188
"6364","chr1",77281688,77282539,77282113,851
"6365","chr11",46705195,46705487,46705341,292
"6366","chr1",90850692,90851833,90851262,1141
"6367","chr7",130381670,130381885,130381777,215
"6368","chr16",1677938,1678841,1678389,903
"6369","chr17",36657841,36658165,36658003,324
"6370","chr19",7789230,7789827,7789528,597
"6371","chr10",56361298,56361514,56361406,216
"6372","chr7",19708774,19709238,19709006,464
"6373","chr17",81841410,81841748,81841579,338
"6374","chr3",25664065,25665079,25664572,1014
"6375","chr15",76059343,76060192,76059767,849
"6376","chr2",131673637,131674195,131673916,558
"6377","chr4",48490100,48491572,48490836,1472
"6378","chr3",40505900,40506137,40506018,237
"6379","chr4",184825403,184826673,184826038,1270
"6380","chr4",139082914,139083165,139083039,251
"6381","chr6",33571245,33571562,33571403,317
"6382","chr19",2096044,2097492,2096768,1448
"6383","chr10",73811124,73812051,73811587,927
"6384","chr2",203534767,203535446,203535106,679
"6385","chr22",22558979,22559291,22559135,312
"6386","chr1",20717339,20718278,20717808,939
"6387","chr5",179577496,179577835,179577665,339
"6388","chr8",143989751,143991218,143990484,1467
"6389","chr1",54886790,54887655,54887222,865
"6390","chr3",186806306,186806905,186806605,599
"6391","chr3",46833402,46834279,46833840,877
"6392","chr19",10653568,10655131,10654349,1563
"6393","chr10",98134508,98135157,98134832,649
"6394","chr10",6220684,6220908,6220796,224
"6395","chr7",2076732,2077146,2076939,414
"6396","chr22",48749924,48751396,48750660,1472
"6397","chr3",111978892,111979296,111979094,404
"6398","chr6",30907865,30908180,30908022,315
"6399","chr5",137889297,137889788,137889542,491
"6400","chrX",68828816,68830409,68829612,1593
"6401","chr20",45934253,45935152,45934702,899
"6402","chr19",40213507,40214208,40213857,701
"6403","chr10",101005448,101005691,101005569,243
"6404","chr3",127018296,127018516,127018406,220
"6405","chr15",24427037,24427390,24427213,353
"6406","chr8",66961153,66963365,66962259,2212
"6407","chrX",69538348,69538804,69538576,456
"6408","chr2",63047340,63052295,63049817,4955
"6409","chr2",185738665,185739183,185738924,518
"6410","chr14",74763224,74763652,74763438,428
"6411","chr7",32490141,32490534,32490337,393
"6412","chr2",223837221,223838073,223837647,852
"6413","chrX",72131091,72132287,72131689,1196
"6414","chr17",28711066,28711901,28711483,835
"6415","chr6",42048505,42048993,42048749,488
"6416","chr5",108728034,108728371,108728202,337
"6417","chr7",100866136,100866524,100866330,388
"6418","chr21",42009170,42011380,42010275,2210
"6419","chr17",68290400,68292391,68291395,1991
"6420","chr11",2883793,2885894,2884843,2101
"6421","chr8",94823021,94823704,94823362,683
"6422","chr10",22475779,22478121,22476950,2342
"6423","chr11",1200345,1200637,1200491,292
"6424","chr16",30407236,30407951,30407593,715
"6425","chr9",124776990,124777802,124777396,812
"6426","chr20",34268853,34269442,34269147,589
"6427","chr16",873303,873659,873481,356
"6428","chr10",91220625,91221208,91220916,583
"6429","chr21",46111985,46112907,46112446,922
"6430","chr3",15858990,15860483,15859736,1493
"6431","chr10",117534406,117538164,117536285,3758
"6432","chr21",28885103,28885359,28885231,256
"6433","chr3",73110706,73110989,73110847,283
"6434","chr4",145098011,145098674,145098342,663
"6435","chr1",18854451,18854975,18854713,524
"6436","chr16",32925435,32925785,32925610,350
"6437","chr7",19144598,19145063,19144830,465
"6438","chr3",61560654,61563995,61562324,3341
"6439","chr12",122966321,122966660,122966490,339
"6440","chr19",7500818,7501427,7501122,609
"6441","chr11",64894990,64895408,64895199,418
"6442","chr6",162727344,162727985,162727664,641
"6443","chr21",45470934,45471201,45471067,267
"6444","chr17",6775886,6776391,6776138,505
"6445","chr7",100477680,100477928,100477804,248
"6446","chr19",55640166,55644105,55642135,3939
"6447","chr19",11362418,11362678,11362548,260
"6448","chr7",103344410,103344890,103344650,480
"6449","chr19",38849283,38852617,38850950,3334
"6450","chr15",89243767,89244460,89244113,693
"6451","chr21",32978418,32978653,32978535,235
"6452","chr7",131945415,131945737,131945576,322
"6453","chr6",133837988,133838211,133838099,223
"6454","chr13",112241113,112241394,112241253,281
"6455","chr10",70145459,70146919,70146189,1460
"6456","chr3",45689123,45689802,45689462,679
"6457","chr10",43362038,43362757,43362397,719
"6458","chr20",63004819,63007703,63006261,2884
"6459","chr8",27310688,27311565,27311126,877
"6460","chr11",36509617,36510467,36510042,850
"6461","chr12",56487617,56488918,56488267,1301
"6462","chr6",37169294,37171658,37170476,2364
"6463","chr11",117795919,117797426,117796672,1507
"6464","chr14",39102833,39103499,39103166,666
"6465","chr17",78924640,78925879,78925259,1239
"6466","chr3",179450947,179451481,179451214,534
"6467","chr10",68900769,68901717,68901243,948
"6468","chr20",63471188,63472724,63471956,1536
"6469","chr15",48330988,48332454,48331721,1466
"6470","chr2",149038508,149039294,149038901,786
"6471","chr17",1643053,1644030,1643541,977
"6472","chr19",15807613,15807894,15807753,281
"6473","chr9",138147698,138148159,138147928,461
"6474","chr13",74134648,74135681,74135164,1033
"6475","chr17",38729855,38730405,38730130,550
"6476","chrX",23742953,23743493,23743223,540
"6477","chr3",38648918,38650022,38649470,1104
"6478","chr19",2289896,2291905,2290900,2009
"6479","chr19",12754605,12755011,12754808,406
"6480","chr11",1207521,1207794,1207657,273
"6481","chrX",20141303,20142165,20141734,862
"6482","chr10",49614304,49614620,49614462,316
"6483","chrX",91434603,91435120,91434861,517
"6484","chr11",3227885,3228608,3228246,723
"6485","chr1",182952684,182953509,182953096,825
"6486","chr2",218270064,218270670,218270367,606
"6487","chr19",5790540,5791280,5790910,740
"6488","chr6",151239631,151239858,151239744,227
"6489","chr4",147481046,147481608,147481327,562
"6490","chr12",124863238,124864142,124863690,904
"6491","chr16",88497644,88497986,88497815,342
"6492","chr19",17680258,17680492,17680375,234
"6493","chr6",159315658,159315941,159315799,283
"6494","chr12",106585651,106587308,106586479,1657
"6495","chr10",110643195,110644570,110643882,1375
"6496","chr11",125062834,125063761,125063297,927
"6497","chr19",23002760,23003248,23003004,488
"6498","chr3",10505494,10505705,10505599,211
"6499","chrX",12138485,12139155,12138820,670
"6500","chr19",49869679,49870140,49869909,461
"6501","chrX",129905774,129906176,129905975,402
"6502","chr22",31489154,31490306,31489730,1152
"6503","chr17",64145864,64146764,64146314,900
"6504","chr17",79464163,79464564,79464363,401
"6505","chr14",104723590,104724527,104724058,937
"6506","chr17",16439190,16439583,16439386,393
"6507","chr6",143842906,143843634,143843270,728
"6508","chr13",21673664,21675616,21674640,1952
"6509","chr6",3750554,3752533,3751543,1979
"6510","chr19",50661992,50662496,50662244,504
"6511","chr3",28575172,28576479,28575825,1307
"6512","chr6",20401486,20403552,20402519,2066
"6513","chrX",102142170,102142542,102142356,372
"6514","chr3",107524942,107525483,107525212,541
"6515","chr16",14974659,14975604,14975131,945
"6516","chr19",29873128,29873708,29873418,580
"6517","chr18",54357577,54358624,54358100,1047
"6518","chr20",25247664,25248766,25248215,1102
"6519","chrX",53320468,53321666,53321067,1198
"6520","chr6",17280508,17282103,17281305,1595
"6521","chr16",85124224,85124442,85124333,218
"6522","chr17",42039769,42040432,42040100,663
"6523","chr5",5422012,5423138,5422575,1126
"6524","chr1",28735,29737,29236,1002
"6525","chr16",56643208,56643686,56643447,478
"6526","chr19",47239468,47239993,47239730,525
"6527","chr7",99499654,99500481,99500067,827
"6528","chr11",424955,425286,425120,331
"6529","chr18",46679942,46680488,46680215,546
"6530","chr4",109729545,109730092,109729818,547
"6531","chr2",135985117,135986025,135985571,908
"6532","chr16",284444,284764,284604,320
"6533","chr19",30225421,30229063,30227242,3642
"6534","chr2",223957211,223957858,223957534,647
"6535","chr11",2534175,2534388,2534281,213
"6536","chr12",68332067,68332695,68332381,628
"6537","chr1",22676923,22677338,22677130,415
"6538","chr1",182390562,182392428,182391495,1866
"6539","chr19",43901665,43901901,43901783,236
"6540","chr18",79863265,79864578,79863921,1313
"6541","chr12",6567833,6568589,6568211,756
"6542","chr13",18628334,18629267,18628800,933
"6543","chr11",119094307,119095754,119095030,1447
"6544","chr10",55630583,55631455,55631019,872
"6545","chr19",55279480,55279737,55279608,257
"6546","chr1",202709795,202710641,202710218,846
"6547","chr3",50502789,50503938,50503363,1149
"6548","chr3",184134990,184135598,184135294,608
"6549","chr3",128993561,128994215,128993888,654
"6550","chr12",125683894,125684112,125684003,218
"6551","chr8",70069638,70072653,70071145,3015
"6552","chr19",40716693,40717224,40716958,531
"6553","chr22",20241438,20242752,20242095,1314
"6554","chr3",13932993,13933370,13933181,377
"6555","chr19",50625068,50625536,50625302,468
"6556","chr20",45362975,45363727,45363351,752
"6557","chr17",74736709,74737406,74737057,697
"6558","chr11",76380480,76381594,76381037,1114
"6559","chr6",34791757,34792532,34792144,775
"6560","chr1",227946721,227948581,227947651,1860
"6561","chr6",31660561,31660881,31660721,320
"6562","chr1",117366552,117367823,117367187,1271
"6563","chr1",5890764,5890969,5890866,205
"6564","chr11",100687192,100687670,100687431,478
"6565","chr12",121827468,121828048,121827758,580
"6566","chr2",11481874,11483139,11482506,1265
"6567","chr1",155062449,155064102,155063275,1653
"6568","chr19",30374776,30375457,30375116,681
"6569","chr5",136028818,136029347,136029082,529
"6570","chr19",49422369,49422755,49422562,386
"6571","chr3",192408032,192410205,192409118,2173
"6572","chr11",62678566,62679141,62678853,575
"6573","chr13",114149061,114149278,114149169,217
"6574","chr19",40055913,40056243,40056078,330
"6575","chr1",18365380,18365587,18365483,207
"6576","chr3",71581422,71583323,71582372,1901
"6577","chr20",44966253,44966603,44966428,350
"6578","chr1",11838336,11838675,11838505,339
"6579","chr1",2317876,2318195,2318035,319
"6580","chrX",136250877,136251567,136251222,690
"6581","chr7",102195451,102196317,102195884,866
"6582","chr12",115451792,115452190,115451991,398
"6583","chr3",105369228,105369495,105369361,267
"6584","chr19",54462992,54465635,54464313,2643
"6585","chr6",41546472,41548451,41547461,1979
"6586","chr10",121608666,121609219,121608942,553
"6587","chr3",197736464,197737273,197736868,809
"6588","chr17",49993334,49995290,49994312,1956
"6589","chr7",6706236,6707085,6706660,849
"6590","chr4",3484236,3484654,3484445,418
"6591","chr20",36050327,36051042,36050684,715
"6592","chr1",3083163,3083414,3083288,251
"6593","chr1",207910753,207911168,207910960,415
"6594","chr20",56403468,56403715,56403591,247
"6595","chr3",190120291,190121090,190120690,799
"6596","chr6",25732464,25732729,25732596,265
"6597","chr1",26336047,26336975,26336511,928
"6598","chr4",7646028,7646233,7646130,205
"6599","chr15",68229080,68229663,68229371,583
"6600","chr14",50116252,50116786,50116519,534
"6601","chr2",23384858,23387253,23386055,2395
"6602","chr1",18110057,18111179,18110618,1122
"6603","chr1",147178043,147178273,147178158,230
"6604","chr16",1428220,1428811,1428515,591
"6605","chr19",46850357,46850893,46850625,536
"6606","chr2",64143754,64144677,64144215,923
"6607","chr1",88683932,88685035,88684483,1103
"6608","chrX",154428387,154429017,154428702,630
"6609","chr10",46284441,46285143,46284792,702
"6610","chr1",99264426,99264779,99264602,353
"6611","chr8",1315257,1318172,1316714,2915
"6612","chr8",98948269,98949210,98948739,941
"6613","chr20",63894443,63895686,63895064,1243
"6614","chr11",75425362,75425644,75425503,282
"6615","chr1",121519059,121519727,121519393,668
"6616","chr16",72664644,72665232,72664938,588
"6617","chr6",170086676,170088127,170087401,1451
"6618","chr19",41352622,41354195,41353408,1573
"6619","chr2",219568066,219568319,219568192,253
"6620","chr1",31788403,31788752,31788577,349
"6621","chr19",10286927,10288027,10287477,1100
"6622","chr22",40370455,40371029,40370742,574
"6623","chrX",40167339,40169123,40168231,1784
"6624","chr16",138068,138905,138486,837
"6625","chr4",182807906,182808191,182808048,285
"6626","chr6",43170973,43172554,43171763,1581
"6627","chrX",71365865,71367213,71366539,1348
"6628","chr18",32769727,32772339,32771033,2612
"6629","chrX",153818916,153819456,153819186,540
"6630","chr12",132265952,132266198,132266075,246
"6631","chr3",50205117,50206156,50205636,1039
"6632","chr16",1746809,1747228,1747018,419
"6633","chr22",20021337,20021577,20021457,240
"6634","chr2",112541826,112542707,112542266,881
"6635","chr1",2280581,2282442,2281511,1861
"6636","chr2",231198459,231198902,231198680,443
"6637","chr20",64073727,64074590,64074158,863
"6638","chr8",142475353,142475837,142475595,484
"6639","chr7",91880683,91881113,91880898,430
"6640","chr9",76905887,76906592,76906239,705
"6641","chr6",2685166,2685391,2685278,225
"6642","chr10",102420721,102422285,102421503,1564
"6643","chr12",3838756,3839454,3839105,698
"6644","chr10",70477905,70479065,70478485,1160
"6645","chrX",137428149,137428755,137428452,606
"6646","chr22",50406729,50407008,50406868,279
"6647","chr12",31252250,31252611,31252430,361
"6648","chr12",111685442,111686255,111685848,813
"6649","chr7",5296830,5297263,5297046,433
"6650","chrX",9895487,9895782,9895634,295
"6651","chr19",1312788,1313529,1313158,741
"6652","chr1",1471464,1472441,1471952,977
"6653","chr11",65421992,65422824,65422408,832
"6654","chr3",127589725,127591289,127590507,1564
"6655","chr6",68634840,68635154,68634997,314
"6656","chr19",48703186,48703561,48703373,375
"6657","chr2",224442183,224442783,224442483,600
"6658","chr4",653404,653660,653532,256
"6659","chr19",1546220,1546456,1546338,236
"6660","chr8",363868,364073,363970,205
"6661","chr19",49436353,49436788,49436570,435
"6662","chr3",121834973,121835389,121835181,416
"6663","chr20",34516307,34516738,34516522,431
"6664","chr19",18279550,18282188,18280869,2638
"6665","chr3",14402129,14403069,14402599,940
"6666","chr1",155250291,155250758,155250524,467
"6667","chr5",177531300,177531516,177531408,216
"6668","chr1",35769323,35770199,35769761,876
"6669","chr19",2755327,2755631,2755479,304
"6670","chr1",228139807,228140859,228140333,1052
"6671","chr12",100200708,100201021,100200864,313
"6672","chr2",240452459,240454181,240453320,1722
"6673","chr6",158231673,158233038,158232355,1365
"6674","chr4",109433308,109434442,109433875,1134
"6675","chr5",132829780,132830987,132830383,1207
"6676","chr22",38656049,38657049,38656549,1000
"6677","chr3",120348652,120349684,120349168,1032
"6678","chr10",413752,414118,413935,366
"6679","chr1",165598028,165598293,165598160,265
"6680","chr11",8593850,8594342,8594096,492
"6681","chr20",43507153,43508422,43507787,1269
"6682","chr2",104853026,104857030,104855028,4004
"6683","chr7",5228117,5228479,5228298,362
"6684","chr5",149960368,149961388,149960878,1020
"6685","chr11",117985923,117986583,117986253,660
"6686","chr8",96157503,96158204,96157853,701
"6687","chr19",17309908,17310130,17310019,222
"6688","chr1",157978930,157979263,157979096,333
"6689","chr5",42424236,42424945,42424590,709
"6690","chr7",22499926,22500403,22500164,477
"6691","chr5",139903765,139904697,139904231,932
"6692","chr2",166375878,166376201,166376039,323
"6693","chr7",5847361,5847852,5847606,491
"6694","chr3",184812024,184812467,184812245,443
"6695","chr11",47980052,47981618,47980835,1566
"6696","chr8",119832558,119832875,119832716,317
"6697","chr7",75394976,75395938,75395457,962
"6698","chr15",70095590,70100867,70098228,5277
"6699","chr19",18232686,18233386,18233036,700
"6700","chr11",120335751,120336940,120336345,1189
"6701","chr19",3061190,3062800,3061995,1610
"6702","chr12",48198194,48199002,48198598,808
"6703","chr3",180679316,180680089,180679702,773
"6704","chr5",1111281,1112273,1111777,992
"6705","chr22",42090345,42091242,42090793,897
"6706","chr5",141339562,141339776,141339669,214
"6707","chr6",143677967,143678530,143678248,563
"6708","chr1",92831941,92832565,92832253,624
"6709","chr7",138980965,138982226,138981595,1261
"6710","chr12",100142138,100142936,100142537,798
"6711","chr8",72005070,72005406,72005238,336
"6712","chr19",14517594,14518877,14518235,1283
"6713","chr22",19656513,19656717,19656615,204
"6714","chr19",17766659,17766968,17766813,309
"6715","chr15",56887079,56887640,56887359,561
"6716","chr1",2226773,2229734,2228253,2961
"6717","chr3",113696060,113696889,113696474,829
"6718","chr11",119168775,119169235,119169005,460
"6719","chr8",730915,731731,731323,816
"6720","chr8",129939126,129940405,129939765,1279
"6721","chr5",140107346,140108279,140107812,933
"6722","chr1",226186334,226187059,226186696,725
"6723","chr16",25014746,25015424,25015085,678
"6724","chr2",70086068,70088358,70087213,2290
"6725","chr1",225809944,225810531,225810237,587
"6726","chr5",135027402,135029456,135028429,2054
"6727","chr15",43776388,43777594,43776991,1206
"6728","chr16",1177260,1177476,1177368,216
"6729","chr9",136727790,136728976,136728383,1186
"6730","chr2",27134112,27134819,27134465,707
"6731","chr16",57760795,57761147,57760971,352
"6732","chr1",161524234,161525566,161524900,1332
"6733","chr6",131627947,131628412,131628179,465
"6734","chr1",5711996,5712453,5712224,457
"6735","chr1",3746399,3747406,3746902,1007
"6736","chr2",200306477,200307769,200307123,1292
"6737","chr19",8610413,8610989,8610701,576
"6738","chr19",10333012,10335346,10334179,2334
"6739","chr21",41426219,41426957,41426588,738
"6740","chr17",35567847,35568123,35567985,276
"6741","chr19",44908463,44909343,44908903,880
"6742","chr15",65067686,65068204,65067945,518
"6743","chr2",26345540,26346498,26346019,958
"6744","chr4",47463493,47463802,47463647,309
"6745","chr1",52842622,52843505,52843063,883
"6746","chr18",59272392,59274308,59273350,1916
"6747","chr1",161166211,161166896,161166553,685
"6748","chr3",46693241,46694227,46693734,986
"6749","chr19",57351073,57351868,57351470,795
"6750","chr20",13784520,13785263,13784891,743
"6751","chr7",31336231,31336928,31336579,697
"6752","chr8",79612697,79613530,79613113,833
"6753","chr8",144180299,144180539,144180419,240
"6754","chr19",39872055,39872646,39872350,591
"6755","chr7",155780908,155781132,155781020,224
"6756","chr13",112979529,112979751,112979640,222
"6757","chr16",85642685,85642986,85642835,301
"6758","chr8",142776863,142777995,142777429,1132
"6759","chr16",88027516,88027989,88027752,473
"6760","chr16",20900244,20901294,20900769,1050
"6761","chr7",111562023,111562627,111562325,604
"6762","chr2",26172547,26174335,26173441,1788
"6763","chr16",29804926,29807918,29806422,2992
"6764","chr8",81732368,81732614,81732491,246
"6765","chr15",78077175,78077906,78077540,731
"6766","chrX",74614164,74614762,74614463,598
"6767","chr5",116084884,116085468,116085176,584
"6768","chr16",18789929,18790544,18790236,615
"6769","chr7",25950392,25951700,25951046,1308
"6770","chr7",141701632,141702407,141702019,775
"6771","chr7",153748079,153749255,153748667,1176
"6772","chr20",3173146,3174430,3173788,1284
"6773","chr22",39145017,39146132,39145574,1115
"6774","chr22",20130986,20132111,20131548,1125
"6775","chr5",180860903,180861862,180861382,959
"6776","chr22",41543913,41544684,41544298,771
"6777","chr12",30754425,30754995,30754710,570
"6778","chr7",131105599,131108014,131106806,2415
"6779","chr19",49689763,49691541,49690652,1778
"6780","chr18",51029921,51030963,51030442,1042
"6781","chr8",38466201,38466552,38466376,351
"6782","chr16",1443498,1443717,1443607,219
"6783","chr16",89850242,89850784,89850513,542
"6784","chr20",59939016,59940581,59939798,1565
"6785","chr2",85753376,85755075,85754225,1699
"6786","chr5",135930159,135930828,135930493,669
"6787","chr15",59995243,59995464,59995353,221
"6788","chr6",1523918,1524308,1524113,390
"6789","chr15",52803817,52804285,52804051,468
"6790","chr10",110567314,110568430,110567872,1116
"6791","chr1",1669542,1669792,1669667,250
"6792","chrX",69149975,69150242,69150108,267
"6793","chr15",41774290,41775032,41774661,742
"6794","chr16",29218631,29218962,29218796,331
"6795","chr7",97020909,97022239,97021574,1330
"6796","chr13",21176148,21177193,21176670,1045
"6797","chr1",2027975,2028428,2028201,453
"6798","chr16",28900623,28900862,28900742,239
"6799","chr5",78648045,78649397,78648721,1352
"6800","chr19",7549899,7551372,7550635,1473
"6801","chr20",51542365,51542970,51542667,605
"6802","chr1",169485320,169486339,169485829,1019
"6803","chr20",17569685,17570672,17570178,987
"6804","chr13",53200129,53202210,53201169,2081
"6805","chr8",105318277,105319892,105319084,1615
"6806","chr10",132185408,132187996,132186702,2588
"6807","chr19",38315795,38316107,38315951,312
"6808","chr19",14571845,14572182,14572013,337
"6809","chr5",391317,392522,391919,1205
"6810","chr2",127624010,127624315,127624162,305
"6811","chr22",20667722,20668456,20668089,734
"6812","chr20",3164475,3165100,3164787,625
"6813","chr1",3393538,3394471,3394004,933
"6814","chr5",90473808,90475039,90474423,1231
"6815","chr5",179166902,179167655,179167278,753
"6816","chr11",134523436,134524314,134523875,878
"6817","chr19",41912840,41913361,41913100,521
"6818","chr13",99997068,99998134,99997601,1066
"6819","chr19",1580400,1580631,1580515,231
"6820","chr2",196592668,196593623,196593145,955
"6821","chr18",6920592,6920875,6920733,283
"6822","chr5",57173191,57174694,57173942,1503
"6823","chr10",67849719,67849964,67849841,245
"6824","chr8",100950416,100953199,100951807,2783
"6825","chr6",31971953,31972782,31972367,829
"6826","chr1",109090566,109091010,109090788,444
"6827","chr4",1338553,1339888,1339220,1335
"6828","chr16",88883567,88883839,88883703,272
"6829","chr9",127224285,127226016,127225150,1731
"6830","chr6",33080639,33081037,33080838,398
"6831","chr8",78516198,78516519,78516358,321
"6832","chr9",121772700,121773248,121772974,548
"6833","chr6",167351034,167351636,167351335,602
"6834","chrX",100636302,100636797,100636549,495
"6835","chr6",167989461,167989674,167989567,213
"6836","chr7",57019960,57020297,57020128,337
"6837","chr16",11586152,11587419,11586785,1267
"6838","chr10",48655575,48656556,48656065,981
"6839","chr1",178486664,178487151,178486907,487
"6840","chr1",50959775,50960398,50960086,623
"6841","chr8",143549597,143549801,143549699,204
"6842","chr1",27634056,27634512,27634284,456
"6843","chr3",186360921,186362322,186361621,1401
"6844","chrX",107775376,107776381,107775878,1005
"6845","chr3",131361734,131362347,131362040,613
"6846","chr4",174214108,174214345,174214226,237
"6847","chr9",69516267,69517258,69516762,991
"6848","chr12",131121013,131121222,131121117,209
"6849","chr16",912817,913531,913174,714
"6850","chr16",3966193,3967042,3966617,849
"6851","chr1",51990105,51990781,51990443,676
"6852","chr12",112013101,112014052,112013576,951
"6853","chr3",138010152,138010364,138010258,212
"6854","chr19",46713816,46714298,46714057,482
"6855","chr2",174682134,174683152,174682643,1018
"6856","chr6",10419166,10420090,10419628,924
"6857","chr1",93846288,93847530,93846909,1242
"6858","chr19",33205283,33207287,33206285,2004
"6859","chr8",140535422,140535650,140535536,228
"6860","chr9",7799355,7799846,7799600,491
"6861","chr17",45060861,45061489,45061175,628
"6862","chr8",11902353,11902703,11902528,350
"6863","chr10",127736146,127739102,127737624,2956
"6864","chr5",100903018,100903434,100903226,416
"6865","chr4",186555125,186555690,186555407,565
"6866","chr5",88659820,88660046,88659933,226
"6867","chr16",85586333,85586656,85586494,323
"6868","chr7",139777110,139778697,139777903,1587
"6869","chr7",129188393,129189525,129188959,1132
"6870","chr19",4044919,4045156,4045037,237
"6871","chr8",2238425,2238678,2238551,253
"6872","chr6",31723648,31723941,31723794,293
"6873","chr10",119207870,119208111,119207990,241
"6874","chr20",58692471,58693364,58692917,893
"6875","chr6",134317659,134317883,134317771,224
"6876","chrX",47574015,47574725,47574370,710
"6877","chr8",46617367,46617752,46617559,385
"6878","chr4",9497581,9498673,9498127,1092
"6879","chr16",29454032,29455716,29454874,1684
"6880","chr16",19067526,19068066,19067796,540
"6881","chr22",32411838,32412298,32412068,460
"6882","chr19",639150,639413,639281,263
"6883","chr9",128203185,128204237,128203711,1052
"6884","chr4",89307563,89307839,89307701,276
"6885","chr3",42685592,42686424,42686008,832
"6886","chr1",205343365,205344448,205343906,1083
"6887","chr19",55086609,55087519,55087064,910
"6888","chr6",100447131,100447370,100447250,239
"6889","chr6",158086687,158087094,158086890,407
"6890","chr9",123999447,124000404,123999925,957
"6891","chr19",45063892,45064682,45064287,790
"6892","chr16",57535936,57536932,57536434,996
"6893","chr5",151157530,151157857,151157693,327
"6894","chr3",160038845,160039210,160039027,365
"6895","chr6",149863208,149864497,149863852,1289
"6896","chr11",45664610,45665945,45665277,1335
"6897","chr20",8019142,8019852,8019497,710
"6898","chr9",136531665,136531990,136531827,325
"6899","chr13",113625598,113626040,113625819,442
"6900","chr13",114113566,114114055,114113810,489
"6901","chr11",122976786,122977900,122977343,1114
"6902","chr17",441225,441473,441349,248
"6903","chr5",154405081,154405570,154405325,489
"6904","chr11",9664085,9664503,9664294,418
"6905","chr8",140457119,140457826,140457472,707
"6906","chr6",28141587,28142161,28141874,574
"6907","chr5",91892,92622,92257,730
"6908","chr1",47225308,47226055,47225681,747
"6909","chr5",1339547,1339967,1339757,420
"6910","chr19",47244106,47244458,47244282,352
"6911","chrX",17375036,17377694,17376365,2658
"6912","chr17",8888153,8888687,8888420,534
"6913","chr5",68288385,68288623,68288504,238
"6914","chr15",84747848,84749132,84748490,1284
"6915","chr19",58044430,58045246,58044838,816
"6916","chr5",1879575,1879814,1879694,239
"6917","chrX",38256090,38256317,38256203,227
"6918","chr11",90222574,90223190,90222882,616
"6919","chr2",75560003,75560294,75560148,291
"6920","chr2",106065281,106065947,106065614,666
"6921","chr1",2107116,2107424,2107270,308
"6922","chr5",69492324,69493996,69493160,1672
"6923","chr5",144170375,144170769,144170572,394
"6924","chr6",29926363,29927340,29926851,977
"6925","chr22",32474563,32475377,32474970,814
"6926","chr2",206274606,206275307,206274956,701
"6927","chr19",48795148,48795488,48795318,340
"6928","chr13",75537537,75537908,75537722,371
"6929","chr17",81222545,81223619,81223082,1074
"6930","chr15",52019023,52019983,52019503,960
"6931","chr3",43363927,43364133,43364030,206
"6932","chr16",56589156,56590002,56589579,846
"6933","chr20",63495890,63496382,63496136,492
"6934","chr19",1555011,1556867,1555939,1856
"6935","chr1",42816903,42817419,42817161,516
"6936","chr9",35603971,35605994,35604982,2023
"6937","chr8",27837578,27837962,27837770,384
"6938","chr22",20495072,20496117,20495594,1045
"6939","chr17",48581586,48582641,48582113,1055
"6940","chr11",19240926,19242850,19241888,1924
"6941","chr22",24185664,24186159,24185911,495
"6942","chr16",82627046,82628208,82627627,1162
"6943","chr20",36773422,36774054,36773738,632
"6944","chr9",133474926,133475141,133475033,215
"6945","chr11",116790318,116790694,116790506,376
"6946","chr19",18097611,18097920,18097765,309
"6947","chrX",140503702,140506413,140505057,2711
"6948","chr10",44864726,44865078,44864902,352
"6949","chr11",133930789,133931036,133930912,247
"6950","chrX",111096136,111096451,111096293,315
"6951","chr4",2792767,2793148,2792957,381
"6952","chr19",5043647,5044430,5044038,783
"6953","chr17",40140220,40140753,40140486,533
"6954","chr6",46015140,46015897,46015518,757
"6955","chrX",139203156,139203434,139203295,278
"6956","chr2",218009959,218010586,218010272,627
"6957","chrX",118116270,118117066,118116668,796
"6958","chr8",11707708,11710414,11709061,2706
"6959","chr6",28635076,28635518,28635297,442
"6960","chr7",155882023,155882247,155882135,224
"6961","chr20",17530833,17531564,17531198,731
"6962","chr14",50003297,50003701,50003499,404
"6963","chr7",159162206,159162417,159162311,211
"6964","chr15",52111994,52112781,52112387,787
"6965","chr7",158958293,158958519,158958406,226
"6966","chr20",31604203,31604470,31604336,267
"6967","chr13",113321490,113321824,113321657,334
"6968","chr5",154445857,154446966,154446411,1109
"6969","chr8",35235161,35236041,35235601,880
"6970","chr1",167935789,167936877,167936333,1088
"6971","chr7",44019009,44019389,44019199,380
"6972","chr1",93345661,93346383,93346022,722
"6973","chr11",68002956,68004119,68003537,1163
"6974","chr3",129974280,129975998,129975139,1718
"6975","chr2",173963602,173964205,173963903,603
"6976","chr11",68750199,68751707,68750953,1508
"6977","chr12",103929239,103931033,103930136,1794
"6978","chr4",499050,499590,499320,540
"6979","chr10",47300041,47300950,47300495,909
"6980","chr19",52993479,52993775,52993627,296
"6981","chr15",89406142,89407899,89407020,1757
"6982","chr16",68310403,68311343,68310873,940
"6983","chr6",42745428,42746248,42745838,820
"6984","chr7",26291843,26292324,26292083,481
"6985","chr5",55737866,55738165,55738015,299
"6986","chr6",137218989,137219541,137219265,552
"6987","chr7",138459922,138461278,138460600,1356
"6988","chr22",49935045,49936337,49935691,1292
"6989","chr6",43059201,43060103,43059652,902
"6990","chr21",15064175,15065543,15064859,1368
"6991","chr6",29752604,29753324,29752964,720
"6992","chr15",93088199,93089944,93089071,1745
"6993","chr16",66947876,66949042,66948459,1166
"6994","chr6",168571836,168573429,168572632,1593
"6995","chr19",57487657,57488245,57487951,588
"6996","chr19",42369546,42369802,42369674,256
"6997","chr11",86068683,86069355,86069019,672
"6998","chr4",118836041,118836656,118836348,615
"6999","chr5",76715295,76716467,76715881,1172
"7000","chr1",34792963,34793190,34793076,227
"7001","chr1",168136078,168136920,168136499,842
"7002","chr12",130424232,130424646,130424439,414
"7003","chr6",143536606,143537614,143537110,1008
"7004","chr2",74919878,74920209,74920043,331
"7005","chr19",19634666,19634920,19634793,254
"7006","chrX",103376393,103377145,103376769,752
"7007","chr6",26156221,26156918,26156569,697
"7008","chr18",46916947,46917869,46917408,922
"7009","chr17",44967001,44969056,44968028,2055
"7010","chr16",88131954,88132428,88132191,474
"7011","chr7",47254190,47254688,47254439,498
"7012","chr1",167454851,167455979,167455415,1128
"7013","chr6",89117415,89118403,89117909,988
"7014","chr12",125093802,125094042,125093922,240
"7015","chr20",17614626,17614838,17614732,212
"7016","chr14",74610614,74612893,74611753,2279
"7017","chr7",112205805,112206832,112206318,1027
"7018","chr12",4269236,4275239,4272237,6003
"7019","chr8",113432597,113432856,113432726,259
"7020","chr3",40477026,40477357,40477191,331
"7021","chr11",45146487,45147550,45147018,1063
"7022","chr18",31723997,31724291,31724144,294
"7023","chr7",150799721,150801118,150800419,1397
"7024","chr1",23483484,23484862,23484173,1378
"7025","chr20",52973168,52973481,52973324,313
"7026","chr5",179797732,179797985,179797858,253
"7027","chr10",73167884,73168150,73168017,266
"7028","chr11",14520054,14520679,14520366,625
"7029","chr1",242056982,242057313,242057147,331
"7030","chr7",48847913,48848222,48848067,309
"7031","chr10",113854614,113855297,113854955,683
"7032","chr7",105532021,105532374,105532197,353
"7033","chr22",49775964,49776216,49776090,252
"7034","chr16",56363912,56364114,56364013,202
"7035","chr7",1493358,1493916,1493637,558
"7036","chr9",93951044,93955904,93953474,4860
"7037","chr1",33430401,33431328,33430864,927
"7038","chr1",9943107,9943527,9943317,420
"7039","chr11",44305690,44306382,44306036,692
"7040","chr20",51562210,51563136,51562673,926
"7041","chr7",27187901,27189424,27188662,1523
"7042","chr1",244451150,244452299,244451724,1149
"7043","chr7",50449929,50450970,50450449,1041
"7044","chr7",101251921,101252524,101252222,603
"7045","chr12",48681706,48682518,48682112,812
"7046","chr4",83012179,83013217,83012698,1038
"7047","chr6",5260497,5261702,5261099,1205
"7048","chr6",20212037,20212902,20212469,865
"7049","chr10",71773334,71773735,71773534,401
"7050","chr6",43575387,43576339,43575863,952
"7051","chr3",63278313,63278529,63278421,216
"7052","chr18",50287064,50288176,50287620,1112
"7053","chr16",268618,268902,268760,284
"7054","chr16",70346736,70347096,70346916,360
"7055","chr12",132323638,132324503,132324070,865
"7056","chr12",64610013,64611119,64610566,1106
"7057","chr12",106138328,106139918,106139123,1590
"7058","chr7",148983198,148983474,148983336,276
"7059","chr1",228173916,228174990,228174453,1074
"7060","chr16",89879106,89879915,89879510,809
"7061","chr10",132808919,132809137,132809028,218
"7062","chr19",48321272,48322236,48321754,964
"7063","chr12",4320877,4321581,4321229,704
"7064","chr7",129433881,129434859,129434370,978
"7065","chr4",73869201,73869827,73869514,626
"7066","chr16",69424361,69424723,69424542,362
"7067","chrX",56995158,56995611,56995384,453
"7068","chrX",143633594,143635126,143634360,1532
"7069","chr2",11784857,11785127,11784992,270
"7070","chr2",45013233,45014440,45013836,1207
"7071","chr13",51221981,51222752,51222366,771
"7072","chr16",22007666,22008736,22008201,1070
"7073","chr22",38088608,38089714,38089161,1106
"7074","chr5",88268791,88269064,88268927,273
"7075","chr1",113758892,113759650,113759271,758
"7076","chr1",154567757,154568097,154567927,340
"7077","chr5",178626431,178627410,178626920,979
"7078","chr19",8589268,8589628,8589448,360
"7079","chr11",829284,833558,831421,4274
"7080","chr4",3248900,3249720,3249310,820
"7081","chr16",67416033,67416569,67416301,536
"7082","chr8",22275278,22275844,22275561,566
"7083","chr5",1088706,1089161,1088933,455
"7084","chr16",67968176,67968818,67968497,642
"7085","chr7",40134282,40135419,40134850,1137
"7086","chr9",89177747,89178696,89178221,949
"7087","chrX",70444906,70445505,70445205,599
"7088","chr4",82284868,82285191,82285029,323
"7089","chr19",40880371,40880684,40880527,313
"7090","chr16",49280126,49282632,49281379,2506
"7091","chr22",41688637,41689010,41688823,373
"7092","chr6",69867082,69867680,69867381,598
"7093","chr2",101150580,101151797,101151188,1217
"7094","chr19",18340482,18340981,18340731,499
"7095","chr8",96160406,96161652,96161029,1246
"7096","chr8",27491141,27491366,27491253,225
"7097","chr6",7106842,7109621,7108231,2779
"7098","chr4",139698393,139698626,139698509,233
"7099","chr17",2691630,2692980,2692305,1350
"7100","chr2",120349370,120349960,120349665,590
"7101","chr2",70978433,70979399,70978916,966
"7102","chr19",49142835,49143051,49142943,216
"7103","chr1",147669720,147670796,147670258,1076
"7104","chr1",21603686,21603887,21603786,201
"7105","chr7",1211190,1211505,1211347,315
"7106","chr1",153775179,153776222,153775700,1043
"7107","chr5",119071049,119071747,119071398,698
"7108","chr5",119355706,119356064,119355885,358
"7109","chr7",149861331,149861576,149861453,245
"7110","chr5",54310102,54310968,54310535,866
"7111","chr2",186589672,186590622,186590147,950
"7112","chr19",16541702,16542929,16542315,1227
"7113","chrX",129678255,129678542,129678398,287
"7114","chr16",86286569,86287449,86287009,880
"7115","chr2",15939679,15942910,15941294,3231
"7116","chr10",25174497,25176710,25175603,2213
"7117","chr19",12648161,12648396,12648278,235
"7118","chr16",1764083,1764481,1764282,398
"7119","chr17",1715682,1716768,1716225,1086
"7120","chr5",116572701,116575096,116573898,2395
"7121","chr8",40897645,40897885,40897765,240
"7122","chr2",97645899,97646461,97646180,562
"7123","chrX",115189343,115192632,115190987,3289
"7124","chr7",105583077,105583403,105583240,326
"7125","chr19",49929097,49929881,49929489,784
"7126","chr8",144046730,144046933,144046831,203
"7127","chr11",4607868,4608300,4608084,432
"7128","chr10",3137982,3138386,3138184,404
"7129","chr11",849087,850982,850034,1895
"7130","chr3",37998798,37999024,37998911,226
"7131","chr19",4457264,4458043,4457653,779
"7132","chr7",156607324,156608018,156607671,694
"7133","chr3",101848911,101850202,101849556,1291
"7134","chr9",135176244,135176448,135176346,204
"7135","chr18",23437707,23438047,23437877,340
"7136","chr7",4263447,4265430,4264438,1983
"7137","chr20",21100288,21102183,21101235,1895
"7138","chr5",151447541,151447939,151447740,398
"7139","chr2",96739711,96740143,96739927,432
"7140","chr2",231398143,231398833,231398488,690
"7141","chr6",149717528,149718304,149717916,776
"7142","chr6",87155201,87156059,87155630,858
"7143","chr17",78341644,78342501,78342072,857
"7144","chr8",26043046,26048326,26045686,5280
"7145","chr9",123391947,123392283,123392115,336
"7146","chr11",101127299,101129043,101128171,1744
"7147","chr3",170037806,170039059,170038432,1253
"7148","chr10",3066458,3069227,3067842,2769
"7149","chr1",6392959,6394125,6393542,1166
"7150","chr19",13096561,13096807,13096684,246
"7151","chr15",90249327,90249697,90249512,370
"7152","chr18",45837423,45839138,45838280,1715
"7153","chr12",65823737,65826401,65825069,2664
"7154","chr16",56638025,56638476,56638250,451
"7155","chr5",132011199,132012083,132011641,884
"7156","chr10",93073515,93075499,93074507,1984
"7157","chr8",23704962,23707662,23706312,2700
"7158","chr8",33514379,33515008,33514693,629
"7159","chr2",151409757,151410772,151410264,1015
"7160","chr2",6238150,6238571,6238360,421
"7161","chr5",139647858,139650634,139649246,2776
"7162","chr1",36320899,36323801,36322350,2902
"7163","chr16",86565749,86569043,86567396,3294
"7164","chr17",29179871,29180589,29180230,718
"7165","chr4",94451650,94452384,94452017,734
"7166","chr5",116361437,116361892,116361664,455
"7167","chr9",130053487,130054336,130053911,849
"7168","chr6",99618529,99619401,99618965,872
"7169","chr1",119712221,119712649,119712435,428
"7170","chr9",83920827,83921731,83921279,904
"7171","chr19",46634523,46634813,46634668,290
"7172","chr22",50704374,50704880,50704627,506
"7173","chr15",52568555,52569213,52568884,658
"7174","chr13",114008269,114009023,114008646,754
"7175","chr17",64262443,64263439,64262941,996
"7176","chr17",8629686,8631615,8630650,1929
"7177","chr11",65027515,65027890,65027702,375
"7178","chrX",69221542,69221851,69221696,309
"7179","chr2",55419485,55420084,55419784,599
"7180","chr2",27489687,27489975,27489831,288
"7181","chr7",477080,477337,477208,257
"7182","chr20",47784998,47786763,47785880,1765
"7183","chr16",3170437,3171355,3170896,918
"7184","chrX",77910427,77910798,77910612,371
"7185","chr2",235493155,235495302,235494228,2147
"7186","chr10",31031554,31032429,31031991,875
"7187","chr19",56838629,56839102,56838865,473
"7188","chr1",148303110,148303477,148303293,367
"7189","chr2",119156550,119159006,119157778,2456
"7190","chr17",20009226,20010096,20009661,870
"7191","chr1",149813037,149813657,149813347,620
"7192","chr7",5282893,5283935,5283414,1042
"7193","chr4",7025036,7025439,7025237,403
"7194","chr11",18046169,18046381,18046275,212
"7195","chr17",7251105,7252807,7251956,1702
"7196","chr5",132747181,132748219,132747700,1038
"7197","chr17",1709932,1710816,1710374,884
"7198","chr8",19013479,19014536,19014007,1057
"7199","chr19",7198106,7198550,7198328,444
"7200","chr20",49481975,49484485,49483230,2510
"7201","chr19",55433083,55433801,55433442,718
"7202","chr2",314828,315170,314999,342
"7203","chr4",3412954,3413626,3413290,672
"7204","chr6",107633959,107635489,107634724,1530
"7205","chr9",97199854,97200144,97199999,290
"7206","chr17",80090161,80090370,80090265,209
"7207","chr7",77121857,77122077,77121967,220
"7208","chr9",96383242,96383803,96383522,561
"7209","chr11",134331890,134332513,134332201,623
"7210","chr6",116100510,116101219,116100864,709
"7211","chr17",502957,503262,503109,305
"7212","chr4",185005226,185005497,185005361,271
"7213","chr18",13136597,13137565,13137081,968
"7214","chr19",49114198,49115312,49114755,1114
"7215","chr10",102226095,102226489,102226292,394
"7216","chr20",44475766,44476014,44475890,248
"7217","chr7",27122468,27122807,27122637,339
"7218","chr16",76235079,76235295,76235187,216
"7219","chr18",79461855,79462111,79461983,256
"7220","chr15",65610873,65611332,65611102,459
"7221","chr16",15434493,15435229,15434861,736
"7222","chr19",3369479,3369859,3369669,380
"7223","chrX",23782938,23783508,23783223,570
"7224","chr16",86836256,86836539,86836397,283
"7225","chr6",107490756,107491005,107490880,249
"7226","chr16",90093924,90094667,90094295,743
"7227","chr19",19901101,19901429,19901265,328
"7228","chr6",6058122,6058431,6058276,309
"7229","chr10",74824939,74827078,74826008,2139
"7230","chr20",760989,761414,761201,425
"7231","chr18",11148308,11149937,11149122,1629
"7232","chr1",211478964,211479412,211479188,448
"7233","chr16",297923,298234,298078,311
"7234","chr3",184601588,184602044,184601816,456
"7235","chr4",6301806,6302483,6302144,677
"7236","chr16",2603220,2603846,2603533,626
"7237","chr17",17591429,17592191,17591810,762
"7238","chr8",22367006,22367731,22367368,725
"7239","chr8",143839472,143839742,143839607,270
"7240","chr1",20242962,20243324,20243143,362
"7241","chr2",169584286,169584831,169584558,545
"7242","chr2",74457438,74458662,74458050,1224
"7243","chr19",17281574,17282966,17282270,1392
"7244","chr19",46015025,46016822,46015923,1797
"7245","chrX",20266009,20268693,20267351,2684
"7246","chr19",7848865,7849082,7848973,217
"7247","chr6",100455615,100455837,100455726,222
"7248","chr13",40921640,40922077,40921858,437
"7249","chr11",59754952,59755654,59755303,702
"7250","chr5",93570533,93573169,93571851,2636
"7251","chr7",8442344,8443132,8442738,788
"7252","chr19",2041824,2042594,2042209,770
"7253","chr2",119247938,119248180,119248059,242
"7254","chr10",132690916,132692064,132691490,1148
"7255","chr7",157661158,157661516,157661337,358
"7256","chr11",1102364,1102611,1102487,247
"7257","chr17",42122505,42123342,42122923,837
"7258","chr20",1225466,1226779,1226122,1313
"7259","chr2",5673350,5673578,5673464,228
"7260","chr10",90857063,90858277,90857670,1214
"7261","chr11",1471289,1471525,1471407,236
"7262","chr5",138352457,138353365,138352911,908
"7263","chr11",62664847,62665945,62665396,1098
"7264","chr7",76516079,76516464,76516271,385
"7265","chr5",28809293,28810413,28809853,1120
"7266","chr17",16352304,16353834,16353069,1530
"7267","chr7",1041199,1041433,1041316,234
"7268","chr17",8125463,8125694,8125578,231
"7269","chr15",71811851,71812078,71811964,227
"7270","chr16",89179211,89179552,89179381,341
"7271","chr19",44304744,44305076,44304910,332
"7272","chr22",29267633,29268914,29268273,1281
"7273","chr10",130202967,130203284,130203125,317
"7274","chr3",126679233,126679522,126679377,289
"7275","chr6",26240469,26240723,26240596,254
"7276","chr15",96340712,96341304,96341008,592
"7277","chr7",73647843,73648258,73648050,415
"7278","chr22",38397727,38399365,38398546,1638
"7279","chr10",5616214,5616559,5616386,345
"7280","chr19",8591904,8593033,8592468,1129
"7281","chr2",219331709,219332046,219331877,337
"7282","chr2",78993066,78993466,78993266,400
"7283","chr2",10079521,10080889,10080205,1368
"7284","chr2",197498965,197500681,197499823,1716
"7285","chr21",37675324,37675626,37675475,302
"7286","chr12",132717502,132718292,132717897,790
"7287","chr19",13830250,13830955,13830602,705
"7288","chr6",28207504,28207827,28207665,323
"7289","chr7",6402178,6402411,6402294,233
"7290","chr19",36687202,36687687,36687444,485
"7291","chr17",14309046,14309572,14309309,526
"7292","chr6",11093354,11094434,11093894,1080
"7293","chr16",21283659,21284093,21283876,434
"7294","chr19",7872163,7872729,7872446,566
"7295","chr17",45982880,45983164,45983022,284
"7296","chr1",36155850,36156709,36156279,859
"7297","chr20",19757395,19759129,19758262,1734
"7298","chr2",233060381,233060608,233060494,227
"7299","chr6",34248631,34249571,34249101,940
"7300","chr2",62705460,62706218,62705839,758
"7301","chr16",75235130,75235981,75235555,851
"7302","chr11",72223203,72225277,72224240,2074
"7303","chr16",89537155,89537488,89537321,333
"7304","chr2",231925285,231926576,231925930,1291
"7305","chr3",123066887,123067753,123067320,866
"7306","chr17",36703963,36704247,36704105,284
"7307","chr15",25713730,25714093,25713911,363
"7308","chr17",74852027,74852762,74852394,735
"7309","chr15",41661625,41662140,41661882,515
"7310","chr2",240024861,240025854,240025357,993
"7311","chr12",57127741,57128376,57128058,635
"7312","chr6",170376918,170377915,170377416,997
"7313","chr12",126727733,126727983,126727858,250
"7314","chr16",86578582,86580215,86579398,1633
"7315","chr6",70282337,70283209,70282773,872
"7316","chr3",186827127,186827682,186827404,555
"7317","chr3",137761153,137761355,137761254,202
"7318","chr2",240462144,240462569,240462356,425
"7319","chr2",46616511,46617193,46616852,682
"7320","chr15",73991911,73992480,73992195,569
"7321","chr10",42932719,42934012,42933365,1293
"7322","chr16",34140138,34140409,34140273,271
"7323","chr17",2593199,2594729,2593964,1530
"7324","chr19",44890576,44891735,44891155,1159
"7325","chr19",7197104,7197452,7197278,348
"7326","chr12",19439249,19440751,19440000,1502
"7327","chr8",22604579,22605355,22604967,776
"7328","chr4",5019276,5019602,5019439,326
"7329","chr2",10812276,10813258,10812767,982
"7330","chr12",107092834,107094033,107093433,1199
"7331","chr19",45815232,45816003,45815617,771
"7332","chr11",1469967,1470295,1470131,328
"7333","chr12",120978682,120979014,120978848,332
"7334","chr17",49361544,49362576,49362060,1032
"7335","chr8",80873190,80874598,80873894,1408
"7336","chr16",970219,971303,970761,1084
"7337","chr18",63936166,63937010,63936588,844
"7338","chr3",193593035,193593399,193593217,364
"7339","chr4",1770279,1770538,1770408,259
"7340","chr2",94871451,94872065,94871758,614
"7341","chr7",149497048,149498184,149497616,1136
"7342","chr17",15944443,15946199,15945321,1756
"7343","chr12",8949554,8950207,8949880,653
"7344","chr1",2132343,2132613,2132478,270
"7345","chr17",1733759,1734198,1733978,439
"7346","chr14",100567526,100569042,100568284,1516
"7347","chr19",47465834,47466262,47466048,428
"7348","chr10",120456747,120457865,120457306,1118
"7349","chr5",115296289,115296650,115296469,361
"7350","chr4",173528895,173530318,173529606,1423
"7351","chr17",60421350,60421971,60421660,621
"7352","chr4",184648807,184649826,184649316,1019
"7353","chr17",35487215,35487928,35487571,713
"7354","chr11",63681232,63681914,63681573,682
"7355","chr10",132117091,132117694,132117392,603
"7356","chr11",88508542,88509394,88508968,852
"7357","chr11",8018862,8020011,8019436,1149
"7358","chr6",34465634,34466594,34466114,960
"7359","chr22",48489072,48491231,48490151,2159
"7360","chr3",169149423,169149625,169149524,202
"7361","chr19",23971655,23971957,23971806,302
"7362","chr21",45028167,45028678,45028422,511
"7363","chr2",63053899,63054212,63054055,313
"7364","chr9",135736236,135736884,135736560,648
"7365","chr19",45385510,45386207,45385858,697
"7366","chr18",79446921,79447546,79447233,625
"7367","chr17",76868088,76870575,76869331,2487
"7368","chr19",18433018,18438351,18435684,5333
"7369","chr16",28211200,28212242,28211721,1042
"7370","chr19",2135932,2136165,2136048,233
"7371","chr11",2862584,2863231,2862907,647
"7372","chr7",2115042,2115617,2115329,575
"7373","chr4",8305997,8306337,8306167,340
"7374","chr20",63737602,63740609,63739105,3007
"7375","chr7",64307372,64307613,64307492,241
"7376","chr6",167719954,167720212,167720083,258
"7377","chr7",154051322,154053359,154052340,2037
"7378","chr8",29352966,29353284,29353125,318
"7379","chr6",34425548,34426237,34425892,689
"7380","chr16",88967652,88967885,88967768,233
"7381","chr16",28319904,28321168,28320536,1264
"7382","chr11",1515499,1515723,1515611,224
"7383","chr8",96644946,96645715,96645330,769
"7384","chr17",2336336,2338253,2337294,1917
"7385","chr8",41490275,41491062,41490668,787
"7386","chr14",106482190,106482811,106482500,621
"7387","chr19",34365005,34366010,34365507,1005
"7388","chr19",51108166,51108919,51108542,753
"7389","chr17",78131440,78132325,78131882,885
"7390","chr17",3667930,3669324,3668627,1394
"7391","chr17",35930642,35930844,35930743,202
"7392","chr4",3765345,3768062,3766703,2717
"7393","chr13",113605876,113606250,113606063,374
"7394","chr7",72827933,72828409,72828171,476
"7395","chr1",998007,1002030,1000018,4023
"7396","chr19",53992802,53993358,53993080,556
"7397","chr1",20483969,20487018,20485493,3049
"7398","chr3",49277004,49277382,49277193,378
"7399","chr11",70662223,70662512,70662367,289
"7400","chr8",30383900,30385362,30384631,1462
"7401","chr17",31391212,31392273,31391742,1061
"7402","chr16",56669475,56669736,56669605,261
"7403","chr15",38564061,38565457,38564759,1396
"7404","chr2",131444692,131446187,131445439,1495
"7405","chr7",151013594,151014245,151013919,651
"7406","chr1",68046960,68047322,68047141,362
"7407","chr19",6039979,6040217,6040098,238
"7408","chr6",28259201,28259705,28259453,504
"7409","chr16",66751137,66751972,66751554,835
"7410","chr3",133894722,133896330,133895526,1608
"7411","chr15",60398509,60398731,60398620,222
"7412","chr9",129890071,129890436,129890253,365
"7413","chr2",186849119,186849342,186849230,223
"7414","chr7",107743212,107744576,107743894,1364
"7415","chr12",569793,570133,569963,340
"7416","chr9",127754128,127755570,127754849,1442
"7417","chr19",55674742,55675518,55675130,776
"7418","chr2",105242130,105242627,105242378,497
"7419","chr7",151439847,151440149,151439998,302
"7420","chr18",34977062,34977919,34977490,857
"7421","chr1",91535466,91535887,91535676,421
"7422","chr16",89720429,89722681,89721555,2252
"7423","chr19",45234224,45234887,45234555,663
"7424","chr16",3089032,3090535,3089783,1503
"7425","chr8",52713445,52714941,52714193,1496
"7426","chr16",68538988,68539837,68539412,849
"7427","chr16",69565534,69566833,69566183,1299
"7428","chr17",28598724,28599494,28599109,770
"7429","chr2",119432454,119432732,119432593,278
"7430","chr1",25430074,25431624,25430849,1550
"7431","chr1",209747608,209748000,209747804,392
"7432","chr15",62953038,62953331,62953184,293
"7433","chr1",167630235,167630602,167630418,367
"7434","chr2",74120146,74120650,74120398,504
"7435","chr10",73358447,73358921,73358684,474
"7436","chr8",81720738,81721437,81721087,699
"7437","chr11",10750946,10751542,10751244,596
"7438","chr19",1068439,1068765,1068602,326
"7439","chr10",132772666,132772967,132772816,301
"7440","chr12",49623190,49623683,49623436,493
"7441","chr19",50406990,50407198,50407094,208
"7442","chr2",23526216,23526421,23526318,205
"7443","chr18",35240821,35241239,35241030,418
"7444","chr13",28531311,28531539,28531425,228
"7445","chr3",139005483,139006604,139006043,1121
"7446","chr16",69105725,69107997,69106861,2272
"7447","chr3",43079929,43080177,43080053,248
"7448","chr2",10911975,10913350,10912662,1375
"7449","chr2",48617612,48617846,48617729,234
"7450","chr2",156435590,156436497,156436043,907
"7451","chr10",72215913,72216357,72216135,444
"7452","chr16",10580023,10580878,10580450,855
"7453","chr15",66252094,66253667,66252880,1573
"7454","chr10",79700667,79700987,79700827,320
"7455","chr3",58123373,58123642,58123507,269
"7456","chr5",43602875,43603548,43603211,673
"7457","chr11",44065968,44066615,44066291,647
"7458","chr16",23186229,23186494,23186361,265
"7459","chr19",39515008,39515986,39515497,978
"7460","chr2",144524169,144524488,144524328,319
"7461","chr6",98831441,98835966,98833703,4525
"7462","chr13",46052319,46052884,46052601,565
"7463","chr6",15662213,15663181,15662697,968
"7464","chr18",46560399,46560612,46560505,213
"7465","chr16",67652715,67653771,67653243,1056
"7466","chr3",40309366,40310341,40309853,975
"7467","chr18",62715071,62717138,62716104,2067
"7468","chr10",103458209,103458530,103458369,321
"7469","chr10",74813437,74813749,74813593,312
"7470","chr7",27662601,27663232,27662916,631
"7471","chr11",74592484,74592995,74592739,511
"7472","chr19",43619333,43620092,43619712,759
"7473","chr19",2360243,2360755,2360499,512
"7474","chr19",38417847,38418600,38418223,753
"7475","chr6",18277186,18277831,18277508,645
"7476","chr2",129877502,129877862,129877682,360
"7477","chr16",1379049,1380103,1379576,1054
"7478","chr12",122124169,122124459,122124314,290
"7479","chr6",86937535,86937989,86937762,454
"7480","chr3",56467840,56468787,56468313,947
"7481","chr13",36919705,36920615,36920160,910
"7482","chr7",44145210,44146104,44145657,894
"7483","chr10",114631707,114632199,114631953,492
"7484","chr16",57996310,57997729,57997019,1419
"7485","chr7",151122832,151123677,151123254,845
"7486","chr1",171781259,171781794,171781526,535
"7487","chr16",878142,878380,878261,238
"7488","chr1",25905459,25907133,25906296,1674
"7489","chr2",230067752,230068834,230068293,1082
"7490","chr11",14891354,14892225,14891789,871
"7491","chr18",23135004,23137107,23136055,2103
"7492","chr2",240700992,240701942,240701467,950
"7493","chr19",21586387,21586984,21586685,597
"7494","chr1",65002589,65003145,65002867,556
"7495","chr10",59362548,59362778,59362663,230
"7496","chr2",175181241,175181776,175181508,535
"7497","chr11",94740369,94741172,94740770,803
"7498","chr2",53970511,53971353,53970932,842
"7499","chr10",7576414,7576652,7576533,238
"7500","chr19",2229738,2230595,2230166,857
"7501","chrX",104254025,104255162,104254593,1137
"7502","chrY",9547862,9548168,9548015,306
"7503","chr3",72996683,72997366,72997024,683
"7504","chr2",131476033,131476562,131476297,529
"7505","chr15",89893793,89894362,89894077,569
"7506","chr13",96052975,96053655,96053315,680
"7507","chr1",27154854,27155251,27155052,397
"7508","chr1",22342145,22342381,22342263,236
"7509","chr2",19361202,19361889,19361545,687
"7510","chr10",48140094,48140633,48140363,539
"7511","chr12",96247019,96247389,96247204,370
"7512","chr11",624780,625053,624916,273
"7513","chr6",43635758,43636081,43635919,323
"7514","chr14",36580128,36582521,36581324,2393
"7515","chr1",30907997,30909119,30908558,1122
"7516","chr3",33277326,33277817,33277571,491
"7517","chrX",9890568,9890890,9890729,322
"7518","chr22",31080886,31081519,31081202,633
"7519","chr11",124759827,124760030,124759928,203
"7520","chr19",2926775,2927118,2926946,343
"7521","chr1",162561066,162562063,162561564,997
"7522","chr14",101891550,101891764,101891657,214
"7523","chr11",18634264,18634935,18634599,671
"7524","chr20",63347973,63348221,63348097,248
"7525","chr7",1479361,1479808,1479584,447
"7526","chrX",18353777,18355028,18354402,1251
"7527","chr3",187670126,187670388,187670257,262
"7528","chr22",49489419,49489736,49489577,317
"7529","chr2",231256062,231256354,231256208,292
"7530","chr12",49794872,49795178,49795025,306
"7531","chr3",24521372,24522085,24521728,713
"7532","chr15",27902779,27903319,27903049,540
"7533","chr19",49593352,49593655,49593503,303
"7534","chr7",2679192,2679490,2679341,298
"7535","chr12",31791872,31792296,31792084,424
"7536","chr1",78490939,78491831,78491385,892
"7537","chr17",8006391,8006723,8006557,332
"7538","chr21",29939068,29939788,29939428,720
"7539","chr10",131812216,131812478,131812347,262
"7540","chr19",12995770,12996874,12996322,1104
"7541","chr2",241666663,241667145,241666904,482
"7542","chr13",114083525,114087271,114085398,3746
"7543","chr11",130916216,130916739,130916477,523
"7544","chr20",18137318,18138345,18137831,1027
"7545","chr22",19029300,19030406,19029853,1106
"7546","chr10",86631989,86632485,86632237,496
"7547","chr14",105463905,105465175,105464540,1270
"7548","chr7",156999624,157000578,157000101,954
"7549","chr7",27220482,27220848,27220665,366
"7550","chr13",26760089,26760776,26760432,687
"7551","chr19",43754461,43755191,43754826,730
"7552","chr2",61888310,61888855,61888582,545
"7553","chr17",36934599,36943576,36939087,8977
"7554","chr17",32443942,32445119,32444530,1177
"7555","chr1",246931183,246932365,246931774,1182
"7556","chr16",12042891,12043095,12042993,204
"7557","chr12",27014063,27014531,27014297,468
"7558","chr2",219418478,219419028,219418753,550
"7559","chr12",6199986,6201226,6200606,1240
"7560","chr7",152759698,152760426,152760062,728
"7561","chr7",7969226,7969864,7969545,638
"7562","chr7",108569340,108570462,108569901,1122
"7563","chr12",128266496,128268606,128267551,2110
"7564","chr19",8050366,8050640,8050503,274
"7565","chr2",176071518,176072081,176071799,563
"7566","chr2",95159057,95159976,95159516,919
"7567","chr17",39700100,39700638,39700369,538
"7568","chr2",240966287,240966494,240966390,207
"7569","chr8",11613505,11613740,11613622,235
"7570","chr8",28716080,28716323,28716201,243
"7571","chr7",159024484,159024938,159024711,454
"7572","chr8",26864125,26867049,26865587,2924
"7573","chr4",110198031,110198928,110198479,897
"7574","chr3",50345458,50345879,50345668,421
"7575","chr15",77027809,77028115,77027962,306
"7576","chr13",112330652,112331419,112331035,767
"7577","chr22",41237548,41238838,41238193,1290
"7578","chr7",2906602,2906829,2906715,227
"7579","chr6",13328355,13328864,13328609,509
"7580","chr17",80727027,80727324,80727175,297
"7581","chr17",57255707,57257065,57256386,1358
"7582","chr12",110582306,110583336,110582821,1030
"7583","chr11",16924845,16925851,16925348,1006
"7584","chr16",88895340,88895557,88895448,217
"7585","chr14",104985566,104986224,104985895,658
"7586","chr2",180006900,180007147,180007023,247
"7587","chr17",3755178,3755391,3755284,213
"7588","chr12",132853339,132853993,132853666,654
"7589","chr10",89414648,89415409,89415028,761
"7590","chr10",35126560,35127757,35127158,1197
"7591","chr5",16616400,16617319,16616859,919
"7592","chr12",132250822,132251172,132250997,350
"7593","chr12",109052433,109052868,109052650,435
"7594","chr2",222295006,222295768,222295387,762
"7595","chr16",13919894,13920438,13920166,544
"7596","chr7",896748,896955,896851,207
"7597","chr8",73285618,73285976,73285797,358
"7598","chr1",3874300,3875047,3874673,747
"7599","chr16",10385829,10386397,10386113,568
"7600","chr19",49148955,49151003,49149979,2048
"7601","chr18",79555951,79556153,79556052,202
"7602","chr15",75368047,75368719,75368383,672
"7603","chr2",239052743,239053028,239052885,285
"7604","chr4",588382,588846,588614,464
"7605","chr15",79431757,79433301,79432529,1544
"7606","chr11",67606726,67607255,67606990,529
"7607","chr1",3425448,3425762,3425605,314
"7608","chr14",24368666,24369118,24368892,452
"7609","chr4",108171882,108173390,108172636,1508
"7610","chr10",71661721,71661945,71661833,224
"7611","chr2",172555472,172556715,172556093,1243
"7612","chr3",158109971,158110408,158110189,437
"7613","chr15",99104824,99106239,99105531,1415
"7614","chr9",96020934,96022082,96021508,1148
"7615","chr6",28838914,28839155,28839034,241
"7616","chr10",132205996,132206272,132206134,276
"7617","chr11",65181244,65181812,65181528,568
"7618","chr2",12716499,12718893,12717696,2394
"7619","chr12",5430729,5431537,5431133,808
"7620","chr3",195065248,195065678,195065463,430
"7621","chr17",44004659,44007604,44006131,2945
"7622","chr16",30534203,30535192,30534697,989
"7623","chr19",57527204,57527840,57527522,636
"7624","chr7",752347,752601,752474,254
"7625","chr17",80801791,80802015,80801903,224
"7626","chr5",62412567,62413229,62412898,662
"7627","chr15",64823814,64824368,64824091,554
"7628","chr6",73451363,73452367,73451865,1004
"7629","chr4",157222144,157222901,157222522,757
"7630","chr2",63055379,63055987,63055683,608
"7631","chr12",52675308,52675576,52675442,268
"7632","chr1",23424303,23425170,23424736,867
"7633","chr1",52056108,52056624,52056366,516
"7634","chr19",54939454,54939760,54939607,306
"7635","chr16",1533808,1534640,1534224,832
"7636","chr12",132686876,132689310,132688093,2434
"7637","chr8",38175890,38177125,38176507,1235
"7638","chr3",136250198,136250723,136250460,525
"7639","chr17",28335045,28336022,28335533,977
"7640","chr9",37034138,37034854,37034496,716
"7641","chr10",117139694,117140818,117140256,1124
"7642","chr6",29864072,29864309,29864190,237
"7643","chr1",19338516,19338782,19338649,266
"7644","chr15",53759458,53759807,53759632,349
"7645","chr11",68386341,68386705,68386523,364
"7646","chr1",119647754,119648628,119648191,874
"7647","chr13",50129549,50130889,50130219,1340
"7648","chr2",170771046,170771552,170771299,506
"7649","chr2",80304242,80304594,80304418,352
"7650","chr3",123584492,123585371,123584931,879
"7651","chr9",36400254,36401330,36400792,1076
"7652","chr6",136249982,136250676,136250329,694
"7653","chr20",62656645,62657128,62656886,483
"7654","chr15",45114269,45114684,45114476,415
"7655","chr8",64580653,64581895,64581274,1242
"7656","chr3",129314697,129316803,129315750,2106
"7657","chr1",65265728,65266166,65265947,438
"7658","chr1",58781789,58785268,58783528,3479
"7659","chr11",131691043,131691719,131691381,676
"7660","chr9",137589767,137591269,137590518,1502
"7661","chrX",149540733,149541633,149541183,900
"7662","chr1",118989368,118989573,118989470,205
"7663","chr1",205455701,205457360,205456530,1659
"7664","chr6",30884082,30884417,30884249,335
"7665","chr20",279148,279507,279327,359
"7666","chr1",117605336,117607046,117606191,1710
"7667","chr19",7927007,7927294,7927150,287
"7668","chr20",46200867,46201209,46201038,342
"7669","chr14",56579754,56580086,56579920,332
"7670","chrX",19990403,19991322,19990862,919
"7671","chr4",3500653,3500884,3500768,231
"7672","chr3",42590672,42591175,42590923,503
"7673","chr16",68022679,68023450,68023064,771
"7674","chr19",12610718,12611302,12611010,584
"7675","chr13",49443985,49444602,49444293,617
"7676","chr8",141417477,141418251,141417864,774
"7677","chr19",2424007,2427985,2425996,3978
"7678","chr10",1736590,1737824,1737207,1234
"7679","chrX",124332835,124333347,124333091,512
"7680","chr9",38392512,38393190,38392851,678
"7681","chr12",27974957,27975642,27975299,685
"7682","chr3",50320022,50320252,50320137,230
"7683","chrX",25022761,25023245,25023003,484
"7684","chr8",143439188,143439438,143439313,250
"7685","chr6",19836783,19839083,19837933,2300
"7686","chr8",108787200,108787613,108787406,413
"7687","chr8",11692349,11693076,11692712,727
"7688","chr8",56445567,56446856,56446211,1289
"7689","chr3",69385775,69386432,69386103,657
"7690","chr16",31819286,31819867,31819576,581
"7691","chr15",69452710,69453407,69453058,697
"7692","chr7",152925258,152926220,152925739,962
"7693","chr12",21657554,21657832,21657693,278
"7694","chr2",240596267,240596536,240596401,269
"7695","chr7",4834473,4835464,4834968,991
"7696","chr16",89247055,89248187,89247621,1132
"7697","chr19",11243284,11243686,11243485,402
"7698","chr19",40389561,40389886,40389723,325
"7699","chr4",16360793,16361143,16360968,350
"7700","chr2",128486411,128486630,128486520,219
"7701","chr2",172088081,172088432,172088256,351
"7702","chr19",13774366,13774979,13774672,613
"7703","chr11",74170854,74171527,74171190,673
"7704","chr16",66695922,66697359,66696640,1437
"7705","chr2",582399,582647,582523,248
"7706","chr9",129823912,129824291,129824101,379
"7707","chr4",188106455,188106879,188106667,424
"7708","chr2",70789896,70790844,70790370,948
"7709","chr16",651828,652037,651932,209
"7710","chr2",28390097,28393881,28391989,3784
"7711","chr2",58240978,58241497,58241237,519
"7712","chr7",66591464,66592418,66591941,954
"7713","chr6",116253743,116254204,116253973,461
"7714","chr16",28945803,28946024,28945913,221
"7715","chr7",2631522,2632303,2631912,781
"7716","chr9",136701393,136701678,136701535,285
"7717","chr8",26578479,26579269,26578874,790
"7718","chr10",132781789,132782190,132781989,401
"7719","chr12",42590285,42590578,42590431,293
"7720","chr15",40952687,40953806,40953246,1119
"7721","chr2",18560202,18560698,18560450,496
"7722","chr12",6620082,6621144,6620613,1062
"7723","chr3",122680808,122681343,122681075,535
"7724","chr11",73787902,73788220,73788061,318
"7725","chr2",233743600,233744074,233743837,474
"7726","chr20",32819725,32820318,32820021,593
"7727","chr11",115759680,115760399,115760039,719
"7728","chr5",180136199,180136779,180136489,580
"7729","chr8",19939332,19940495,19939913,1163
"7730","chr19",39313981,39315260,39314620,1279
"7731","chr6",2764969,2766541,2765755,1572
"7732","chr18",76402595,76402835,76402715,240
"7733","chr20",62599663,62599865,62599764,202
"7734","chr10",1056204,1057401,1056802,1197
"7735","chr2",173075686,173076543,173076114,857
"7736","chr20",13995122,13996422,13995772,1300
"7737","chr11",89730281,89730522,89730401,241
"7738","chr7",154304879,154305196,154305037,317
"7739","chr15",45152289,45152507,45152398,218
"7740","chr19",37078050,37078647,37078348,597
"7741","chr16",30369756,30370631,30370193,875
"7742","chr13",99967987,99972053,99970020,4066
"7743","chr17",68200886,68201137,68201011,251
"7744","chr5",1206930,1207414,1207172,484
"7745","chr4",183658768,183659491,183659129,723
"7746","chr3",9792308,9793301,9792804,993
"7747","chr8",23457188,23457977,23457582,789
"7748","chr6",97282820,97283323,97283071,503
"7749","chr6",100880871,100881575,100881223,704
"7750","chr17",81032784,81033035,81032909,251
"7751","chr12",124314250,124314678,124314464,428
"7752","chr18",78504381,78504603,78504492,222
"7753","chr19",42080794,42081065,42080929,271
"7754","chr8",29337082,29337407,29337244,325
"7755","chr16",2500046,2500507,2500276,461
"7756","chr21",26844333,26845798,26845065,1465
"7757","chr17",78781428,78782683,78782055,1255
"7758","chr13",113076839,113077269,113077054,430
"7759","chr10",95295371,95295691,95295531,320
"7760","chr12",113966197,113966572,113966384,375
"7761","chr19",1753217,1758078,1755647,4861
"7762","chr11",506353,508009,507181,1656
"7763","chr7",24756922,24757868,24757395,946
"7764","chr3",191329159,191329921,191329540,762
"7765","chr15",28788732,28789564,28789148,832
"7766","chr13",110561242,110562130,110561686,888
"7767","chr19",3964253,3964991,3964622,738
"7768","chr3",127455532,127456101,127455816,569
"7769","chr17",58277846,58278141,58277993,295
"7770","chr17",44758408,44759564,44758986,1156
"7771","chr19",6108810,6109062,6108936,252
"7772","chr11",62371149,62371401,62371275,252
"7773","chr17",77255876,77256098,77255987,222
"7774","chr11",127000330,127000656,127000493,326
"7775","chr7",64464022,64464363,64464192,341
"7776","chr16",88502859,88503083,88502971,224
"7777","chr19",34926797,34927313,34927055,516
"7778","chr9",21335126,21335458,21335292,332
"7779","chr13",113413491,113413781,113413636,290
"7780","chr8",132479864,132481339,132480601,1475
"7781","chr20",30300234,30300532,30300383,298
"7782","chr19",51593999,51594747,51594373,748
"7783","chr18",70288456,70289826,70289141,1370
"7784","chr6",170289126,170297391,170293258,8265
"7785","chr15",66842485,66843142,66842813,657
"7786","chr3",122415838,122416237,122416037,399
"7787","chr6",50842929,50843281,50843105,352
"7788","chr6",34143958,34146167,34145062,2209
"7789","chr16",28974560,28975340,28974950,780
"7790","chr11",86671653,86672544,86672098,891
"7791","chr12",53251935,53252142,53252038,207
"7792","chr11",35662756,35663354,35663055,598
"7793","chr2",84458881,84459627,84459254,746
"7794","chr19",18009804,18010031,18009917,227
"7795","chr18",11821869,11822208,11822038,339
"7796","chr8",1849240,1850609,1849924,1369
"7797","chr12",101697266,101698588,101697927,1322
"7798","chr11",60906125,60906712,60906418,587
"7799","chr22",49918120,49918651,49918385,531
"7800","chr12",9283621,9284058,9283839,437
"7801","chr19",40609539,40609861,40609700,322
"7802","chr19",48398222,48398866,48398544,644
"7803","chr7",74964438,74965554,74964996,1116
"7804","chr2",189822014,189822279,189822146,265
"7805","chr17",55845373,55845778,55845575,405
"7806","chr7",127391800,127392842,127392321,1042
"7807","chr19",17555383,17556169,17555776,786
"7808","chr7",877995,878222,878108,227
"7809","chr2",234951473,234953072,234952272,1599
"7810","chr1",207958982,207959772,207959377,790
"7811","chr3",108222083,108222656,108222369,573
"7812","chr3",147409201,147411212,147410206,2011
"7813","chr3",180912364,180913208,180912786,844
"7814","chr3",196867705,196868615,196868160,910
"7815","chr9",128829472,128829967,128829719,495
"7816","chr6",37499619,37500024,37499821,405
"7817","chr6",3455827,3457729,3456778,1902
"7818","chr2",70552917,70554445,70553681,1528
"7819","chr7",149270,150038,149654,768
"7820","chr8",1350172,1352315,1351243,2143
"7821","chr8",13132581,13133405,13132993,824
"7822","chr2",219253215,219254612,219253913,1397
"7823","chr8",81111620,81112141,81111880,521
"7824","chr1",150234623,150235494,150235058,871
"7825","chr12",6937074,6937903,6937488,829
"7826","chr13",46552835,46554571,46553703,1736
"7827","chr22",19986751,19987233,19986992,482
"7828","chr6",34234790,34238416,34236603,3626
"7829","chr17",62137414,62139424,62138419,2010
"7830","chr11",3641822,3642572,3642197,750
"7831","chr3",197002087,197004007,197003047,1920
"7832","chr2",71560300,71560767,71560533,467
"7833","chr2",203014526,203015168,203014847,642
"7834","chr3",112561175,112562103,112561639,928
"7835","chr19",19305884,19306136,19306010,252
"7836","chr13",49585250,49585970,49585610,720
"7837","chr2",240590545,240590928,240590736,383
"7838","chr3",167380139,167380410,167380274,271
"7839","chr10",376240,376471,376355,231
"7840","chr6",42564246,42564554,42564400,308
"7841","chr11",6456373,6456948,6456660,575
"7842","chr22",31160138,31160480,31160309,342
"7843","chr3",57078721,57079880,57079300,1159
"7844","chr2",14632253,14635685,14633969,3432
"7845","chr10",75234134,75236195,75235164,2061
"7846","chr1",26225026,26225703,26225364,677
"7847","chr7",151008671,151009041,151008856,370
"7848","chr20",33667005,33668183,33667594,1178
"7849","chr19",40398537,40399048,40398792,511
"7850","chr13",77697653,77698771,77698212,1118
"7851","chr2",42792525,42793369,42792947,844
"7852","chr11",7513323,7514496,7513909,1173
"7853","chr1",226870344,226871205,226870774,861
"7854","chr22",50218079,50218591,50218335,512
"7855","chr2",101252561,101253540,101253050,979
"7856","chr14",105385414,105385650,105385532,236
"7857","chr11",129364221,129364451,129364336,230
"7858","chr19",33235748,33236194,33235971,446
"7859","chr7",635932,636458,636195,526
"7860","chrY",18992717,18993154,18992935,437
"7861","chrX",135051533,135052307,135051920,774
"7862","chr6",13873534,13874031,13873782,497
"7863","chr19",7788046,7788900,7788473,854
"7864","chr19",35124508,35124761,35124634,253
"7865","chr1",110555444,110555740,110555592,296
"7866","chr12",95548130,95549203,95548666,1073
"7867","chr5",180590099,180592062,180591080,1963
"7868","chr17",10697108,10697882,10697495,774
"7869","chr2",2189738,2189944,2189841,206
"7870","chr3",187737542,187738055,187737798,513
"7871","chr15",43800539,43800942,43800740,403
"7872","chr20",56003547,56005622,56004584,2075
"7873","chr12",132345531,132345857,132345694,326
"7874","chr4",116705400,116705954,116705677,554
"7875","chr20",1313037,1313684,1313360,647
"7876","chr2",216498801,216499103,216498952,302
"7877","chr11",59171573,59172835,59172204,1262
"7878","chr10",73096100,73097227,73096663,1127
"7879","chr12",95956740,95956943,95956841,203
"7880","chr3",113532852,113533443,113533147,591
"7881","chr2",180980064,180981199,180980631,1135
"7882","chr20",37693766,37694184,37693975,418
"7883","chr15",48877947,48878513,48878230,566
"7884","chr16",400834,401140,400987,306
"7885","chr18",58255755,58256836,58256295,1081
"7886","chr18",23689305,23690385,23689845,1080
"7887","chr2",213284233,213284702,213284467,469
"7888","chr15",65184456,65185717,65185086,1261
"7889","chr19",13951973,13952791,13952382,818
"7890","chr22",48575045,48577135,48576090,2090
"7891","chr2",16508095,16508554,16508324,459
"7892","chr15",89377562,89379537,89378549,1975
"7893","chr19",51421745,51422159,51421952,414
"7894","chr19",11578611,11579114,11578862,503
"7895","chrX",47836693,47836965,47836829,272
"7896","chr7",74173922,74175011,74174466,1089
"7897","chr2",70293336,70293867,70293601,531
"7898","chr2",11656724,11657110,11656917,386
"7899","chr7",151232302,151233065,151232683,763
"7900","chr5",177516524,177517507,177517015,983
"7901","chr2",25131414,25131908,25131661,494
"7902","chr2",64751103,64751790,64751446,687
"7903","chr9",125143033,125143668,125143350,635
"7904","chr3",66998031,66998849,66998440,818
"7905","chr12",122421857,122422885,122422371,1028
"7906","chr10",132942159,132943348,132942753,1189
"7907","chr2",130341896,130343290,130342593,1394
"7908","chr11",60767437,60767665,60767551,228
"7909","chr1",34985048,34985436,34985242,388
"7910","chrX",41253565,41253886,41253725,321
"7911","chr2",20350252,20351302,20350777,1050
"7912","chr1",110067643,110070681,110069162,3038
"7913","chr15",72783245,72784322,72783783,1077
"7914","chr8",38900939,38901862,38901400,923
"7915","chr15",50354240,50355545,50354892,1305
"7916","chr19",56228155,56228423,56228289,268
"7917","chr12",49537840,49539854,49538847,2014
"7918","chr2",42102299,42102513,42102406,214
"7919","chr2",156341556,156342834,156342195,1278
"7920","chrX",86147939,86148873,86148406,934
"7921","chr16",82011281,82011701,82011491,420
"7922","chr15",99992940,99993167,99993053,227
"7923","chr16",1770310,1773953,1772131,3643
"7924","chr10",132281983,132282316,132282149,333
"7925","chr9",137199728,137201234,137200481,1506
"7926","chr2",236507447,236507739,236507593,292
"7927","chr7",128135577,128136390,128135983,813
"7928","chr15",34754242,34755211,34754726,969
"7929","chr4",4857905,4858464,4858184,559
"7930","chr10",124447240,124450327,124448783,3087
"7931","chr2",72924071,72924931,72924501,860
"7932","chr4",140373512,140374120,140373816,608
"7933","chr10",43648408,43649250,43648829,842
"7934","chr3",153160479,153163297,153161888,2818
"7935","chr3",109117948,109118242,109118095,294
"7936","chr16",87708304,87708546,87708425,242
"7937","chr16",11254684,11256946,11255815,2262
"7938","chr10",92691572,92691980,92691776,408
"7939","chr13",41132066,41132984,41132525,918
"7940","chr18",35267320,35268166,35267743,846
"7941","chr6",8102271,8102699,8102485,428
"7942","chr19",457800,461273,459536,3473
"7943","chr8",142613069,142614805,142613937,1736
"7944","chr15",90275057,90275266,90275161,209
"7945","chr2",75710531,75711013,75710772,482
"7946","chr19",35899711,35900687,35900199,976
"7947","chr19",41310120,41310445,41310282,325
"7948","chr16",67028710,67030109,67029409,1399
"7949","chr12",131779072,131779311,131779191,239
"7950","chr16",89647503,89648442,89647972,939
"7951","chr6",144215932,144216470,144216201,538
"7952","chr9",121651233,121651914,121651573,681
"7953","chr11",3164901,3165538,3165219,637
"7954","chr22",19479880,19480288,19480084,408
"7955","chr22",26483492,26484068,26483780,576
"7956","chr2",24793010,24793758,24793384,748
"7957","chr2",174012837,174013189,174013013,352
"7958","chr14",100882048,100882361,100882204,313
"7959","chr4",127964849,127965816,127965332,967
"7960","chr16",58039912,58040125,58040018,213
"7961","chr19",4279045,4280237,4279641,1192
"7962","chr19",41025899,41026146,41026022,247
"7963","chr9",129868045,129868544,129868294,499
"7964","chr11",94768200,94769530,94768865,1330
"7965","chr3",40524638,40525198,40524918,560
"7966","chr5",180648688,180649906,180649297,1218
"7967","chr16",29900026,29900801,29900413,775
"7968","chr15",52179383,52180113,52179748,730
"7969","chr9",136831765,136831988,136831876,223
"7970","chr1",3858513,3858805,3858659,292
"7971","chr22",23716829,23717456,23717142,627
"7972","chrX",137547385,137548144,137547764,759
"7973","chr9",214586,215431,215008,845
"7974","chr12",132673393,132673657,132673525,264
"7975","chr11",1694531,1694772,1694651,241
"7976","chr5",109689264,109691000,109690132,1736
"7977","chr3",49020892,49022553,49021722,1661
"7978","chr1",9539291,9540385,9539838,1094
"7979","chr12",68932906,68933752,68933329,846
"7980","chr3",139389407,139390143,139389775,736
"7981","chr12",110688806,110689542,110689174,736
"7982","chr16",1790622,1792687,1791654,2065
"7983","chr22",45866185,45867867,45867026,1682
"7984","chr8",101205089,101206233,101205661,1144
"7985","chr2",163736134,163737001,163736567,867
"7986","chr3",194315603,194315908,194315755,305
"7987","chr8",42152205,42153580,42152892,1375
"7988","chr11",19712390,19713791,19713090,1401
"7989","chr9",22154478,22154744,22154611,266
"7990","chr18",78504687,78505107,78504897,420
"7991","chr12",131298548,131299654,131299101,1106
"7992","chr16",57985759,57986108,57985933,349
"7993","chrX",45157732,45157933,45157832,201
"7994","chr2",149010140,149010376,149010258,236
"7995","chr6",112253889,112254281,112254085,392
"7996","chr10",133441243,133441519,133441381,276
"7997","chr12",53046795,53047922,53047358,1127
"7998","chr19",3532435,3532668,3532551,233
"7999","chr2",24490841,24492299,24491570,1458
"8000","chr17",79927266,79927534,79927400,268
"8001","chr19",4676404,4676706,4676555,302
"8002","chr6",33411056,33411390,33411223,334
"8003","chr2",176269294,176269784,176269539,490
"8004","chr7",149239708,149240239,149239973,531
"8005","chr19",48872227,48872671,48872449,444
"8006","chr17",42609041,42609743,42609392,702
"8007","chr15",89361591,89362819,89362205,1228
"8008","chr3",120285036,120285579,120285307,543
"8009","chr15",78264063,78265200,78264631,1137
"8010","chr3",108090528,108091696,108091112,1168
"8011","chr17",81190588,81191384,81190986,796
"8012","chr7",76500078,76500304,76500191,226
"8013","chr2",108942509,108942730,108942619,221
"8014","chr3",141051044,141052238,141051641,1194
"8015","chr7",135509819,135510561,135510190,742
"8016","chr17",82848813,82849341,82849077,528
"8017","chr16",2176078,2176350,2176214,272
"8018","chr19",418898,419191,419044,293
"8019","chr1",2595800,2596064,2595932,264
"8020","chr2",95121344,95122206,95121775,862
"8021","chr9",107487467,107490379,107488923,2912
"8022","chr17",75046482,75047649,75047065,1167
"8023","chr19",11798587,11799026,11798806,439
"8024","chr16",88939926,88942192,88941059,2266
"8025","chr12",52291161,52291382,52291271,221
"8026","chr19",55173508,55173949,55173728,441
"8027","chr16",929785,930198,929991,413
"8028","chr10",103668747,103668955,103668851,208
"8029","chr2",628909,629190,629049,281
"8030","chr4",20700194,20700713,20700453,519
"8031","chr4",189940436,189941320,189940878,884
"8032","chr2",420051,421142,420596,1091
"8033","chr16",1332915,1334734,1333824,1819
"8034","chr19",18117788,18118474,18118131,686
"8035","chr16",88915402,88915741,88915571,339
"8036","chr7",107044368,107045320,107044844,952
"8037","chr15",40755012,40755489,40755250,477
"8038","chr3",173397614,173397985,173397799,371
"8039","chr20",45297954,45298531,45298242,577
"8040","chr18",79785027,79785257,79785142,230
"8041","chr12",25195105,25195465,25195285,360
"8042","chr2",70125072,70125399,70125235,327
"8043","chr1",2540656,2541147,2540901,491
"8044","chr13",21075569,21076206,21075887,637
"8045","chr7",105876398,105877517,105876957,1119
"8046","chr20",31605051,31606222,31605636,1171
"8047","chr3",195542730,195543540,195543135,810
"8048","chr3",146250547,146251221,146250884,674
"8049","chr12",64824465,64825363,64824914,898
"8050","chr2",27409017,27409955,27409486,938
"8051","chr2",86336996,86337945,86337470,949
"8052","chr4",8644106,8644337,8644221,231
"8053","chr10",133207114,133207428,133207271,314
"8054","chr2",157875673,157876833,157876253,1160
"8055","chr5",138491710,138492512,138492111,802
"8056","chr7",112450067,112451357,112450712,1290
"8057","chr18",3771354,3771571,3771462,217
"8058","chr19",19192541,19192813,19192677,272
"8059","chr3",130746634,130746856,130746745,222
"8060","chr12",53380335,53380819,53380577,484
"8061","chr16",1217865,1218605,1218235,740
"8062","chr3",132721869,132722369,132722119,500
"8063","chr20",38472528,38473099,38472813,571
"8064","chr22",17084627,17086100,17085363,1473
"8065","chr6",167662190,167662649,167662419,459
"8066","chr13",45311619,45311968,45311793,349
"8067","chr7",114922115,114922775,114922445,660
"8068","chr3",169773046,169773418,169773232,372
"8069","chr4",946825,947269,947047,444
"8070","chr13",52599893,52600539,52600216,646
"8071","chr6",52284351,52284927,52284639,576
"8072","chr21",44299632,44300681,44300156,1049
"8073","chr19",33795279,33797757,33796518,2478
"8074","chr2",176107060,176108161,176107610,1101
"8075","chr2",73828814,73829193,73829003,379
"8076","chr2",219483566,219485062,219484314,1496
"8077","chr11",130159846,130160367,130160106,521
"8078","chr7",73623198,73624627,73623912,1429
"8079","chr7",7566741,7567392,7567066,651
"8080","chr14",67359422,67360809,67360115,1387
"8081","chr19",19643475,19643698,19643586,223
"8082","chr4",4142848,4143940,4143394,1092
"8083","chr7",94004127,94004598,94004362,471
"8084","chr7",2605890,2606131,2606010,241
"8085","chr11",118910488,118911023,118910755,535
"8086","chr2",130692600,130692943,130692771,343
"8087","chr19",57389723,57390149,57389936,426
"8088","chr11",102451798,102453031,102452414,1233
"8089","chr17",15563045,15563742,15563393,697
"8090","chr3",48609187,48609971,48609579,784
"8091","chr14",104574970,104575224,104575097,254
"8092","chrX",18675032,18675479,18675255,447
"8093","chr1",145996590,145996793,145996691,203
"8094","chr8",142700163,142700806,142700484,643
"8095","chr1",156907977,156908350,156908163,373
"8096","chr19",5707304,5707513,5707408,209
"8097","chr2",240568046,240569210,240568628,1164
"8098","chr2",241314884,241316611,241315747,1727
"8099","chr3",10320822,10321257,10321039,435
"8100","chr11",77179737,77179940,77179838,203
"8101","chr7",66114777,66115213,66114995,436
"8102","chr16",77788478,77789237,77788857,759
"8103","chr7",4767229,4767455,4767342,226
"8104","chr6",170275003,170275219,170275111,216
"8105","chr19",36666730,36667217,36666973,487
"8106","chr2",241881295,241881819,241881557,524
"8107","chr2",64988464,64990078,64989271,1614
"8108","chr2",142130155,142130984,142130569,829
"8109","chr10",117240924,117242019,117241471,1095
"8110","chr10",128125549,128126698,128126123,1149
"8111","chr7",66995125,66995816,66995470,691
"8112","chr4",165873393,165874189,165873791,796
"8113","chr3",157088899,157089280,157089089,381
"8114","chr19",39824286,39824504,39824395,218
"8115","chr3",13637567,13637836,13637701,269
"8116","chr19",43408015,43408483,43408249,468
"8117","chr4",21948462,21949242,21948852,780
"8118","chr6",168190152,168190714,168190433,562
"8119","chr7",152903411,152903865,152903638,454
"8120","chr2",96500471,96500923,96500697,452
"8121","chr10",367911,368225,368068,314
"8122","chr14",23419935,23420199,23420067,264
"8123","chr2",112584107,112584876,112584491,769
"8124","chr4",47425675,47425888,47425781,213
"8125","chr6",31403138,31403901,31403519,763
"8126","chr12",114682969,114685073,114684021,2104
"8127","chr2",121755411,121755950,121755680,539
"8128","chr21",46285713,46286697,46286205,984
"8129","chr5",76819685,76820264,76819974,579
"8130","chr20",36092081,36093626,36092853,1545
"8131","chr12",132084062,132085170,132084616,1108
"8132","chr12",69738560,69739779,69739169,1219
"8133","chr16",7518193,7518411,7518302,218
"8134","chr20",63864890,63865843,63865366,953
"8135","chr11",119664849,119665282,119665065,433
"8136","chr20",62550874,62551783,62551328,909
"8137","chr5",140691219,140691743,140691481,524
"8138","chr22",20981892,20982650,20982271,758
"8139","chr10",68406449,68407585,68407017,1136
"8140","chr1",242890295,242890770,242890532,475
"8141","chr16",1452627,1452857,1452742,230
"8142","chr2",104871910,104873527,104872718,1617
"8143","chr11",3160344,3160890,3160617,546
"8144","chr2",72825508,72826098,72825803,590
"8145","chr7",65239608,65240280,65239944,672
"8146","chr6",36594130,36594635,36594382,505
"8147","chr6",169248451,169248952,169248701,501
"8148","chr22",32043059,32043455,32043257,396
"8149","chr6",42783004,42783694,42783349,690
"8150","chr12",113591513,113591947,113591730,434
"8151","chr21",45286776,45288836,45287806,2060
"8152","chr1",153678354,153679899,153679126,1545
"8153","chr12",121296242,121297366,121296804,1124
"8154","chr1",108199778,108200579,108200178,801
"8155","chr22",41699410,41700185,41699797,775
"8156","chr17",8079313,8080242,8079777,929
"8157","chr3",58306086,58306658,58306372,572
"8158","chr6",13014741,13014971,13014856,230
"8159","chr1",203026344,203027057,203026700,713
"8160","chr9",136670547,136670834,136670690,287
"8161","chr20",44909975,44910419,44910197,444
"8162","chr9",122346728,122347365,122347046,637
"8163","chr11",62600982,62603019,62602000,2037
"8164","chr19",35637200,35637514,35637357,314
"8165","chr7",157897867,157898078,157897972,211
"8166","chr3",39152960,39153891,39153425,931
"8167","chr6",31580659,31581500,31581079,841
"8168","chr21",44319756,44320044,44319900,288
"8169","chr10",123991896,123992468,123992182,572
"8170","chr1",156646761,156647154,156646957,393
"8171","chr15",101086129,101086647,101086388,518
"8172","chr12",132303380,132305667,132304523,2287
"8173","chr19",18521488,18522643,18522065,1155
"8174","chr6",157380030,157382345,157381187,2315
"8175","chr7",159171148,159172332,159171740,1184
"8176","chr13",114009336,114009658,114009497,322
"8177","chr7",1910643,1910846,1910744,203
"8178","chr1",112955744,112956703,112956223,959
"8179","chr19",1103723,1109611,1106667,5888
"8180","chr13",114033440,114033683,114033561,243
"8181","chr13",111547865,111548546,111548205,681
"8182","chr1",59814415,59815376,59814895,961
"8183","chr19",56476944,56478372,56477658,1428
"8184","chr5",1212352,1212553,1212452,201
"8185","chr14",21024576,21026111,21025343,1535
"8186","chr17",6640034,6641243,6640638,1209
"8187","chr3",62369640,62369859,62369749,219
"8188","chr17",7393185,7395147,7394166,1962
"8189","chr7",1498584,1499315,1498949,731
"8190","chr1",90835422,90836334,90835878,912
"8191","chr6",26183808,26184108,26183958,300
"8192","chr1",155934281,155934516,155934398,235
"8193","chr19",13747632,13748090,13747861,458
"8194","chr19",34677240,34678074,34677657,834
"8195","chr7",12686531,12687623,12687077,1092
"8196","chr9",114587607,114588108,114587857,501
"8197","chr1",61724975,61725270,61725122,295
"8198","chr7",99011370,99011599,99011484,229
"8199","chr8",144397764,144398110,144397937,346
"8200","chr11",19346350,19346687,19346518,337
"8201","chr1",155859318,155859640,155859479,322
"8202","chr10",87341958,87343261,87342609,1303
"8203","chr3",152834813,152835923,152835368,1110
"8204","chr21",43943592,43943918,43943755,326
"8205","chr1",4772291,4772493,4772392,202
"8206","chr16",4682218,4682486,4682352,268
"8207","chr19",7522385,7522939,7522662,554
"8208","chr21",37915643,37916964,37916303,1321
"8209","chr13",23578760,23580001,23579380,1241
"8210","chr17",81460904,81461579,81461241,675
"8211","chr5",140841422,140841796,140841609,374
"8212","chr16",74296635,74297416,74297025,781
"8213","chr13",35475433,35476022,35475727,589
"8214","chr4",146638036,146640749,146639392,2713
"8215","chr20",45890258,45891722,45890990,1464
"8216","chr1",94820046,94820763,94820404,717
"8217","chr19",58009386,58009856,58009621,470
"8218","chr2",240586205,240587418,240586811,1213
"8219","chr20",33685751,33686699,33686225,948
"8220","chr9",130265458,130266284,130265871,826
"8221","chr19",10557591,10557906,10557748,315
"8222","chr1",3706754,3706957,3706855,203
"8223","chr21",43728573,43728864,43728718,291
"8224","chr11",10293732,10294386,10294059,654
"8225","chr19",17807928,17808289,17808108,361
"8226","chr5",108748286,108749502,108748894,1216
"8227","chr12",54029643,54029928,54029785,285
"8228","chr3",184248784,184249008,184248896,224
"8229","chr1",6279888,6280208,6280048,320
"8230","chr12",2679448,2679713,2679580,265
"8231","chr4",189810492,189811043,189810767,551
"8232","chr5",177131851,177134651,177133251,2800
"8233","chr2",10121942,10123354,10122648,1412
"8234","chr19",38483299,38483516,38483407,217
"8235","chr10",27240289,27241173,27240731,884
"8236","chr19",49689242,49689545,49689393,303
"8237","chr20",6005753,6006651,6006202,898
"8238","chr4",94207506,94208138,94207822,632
"8239","chr15",89749990,89751502,89750746,1512
"8240","chr18",37253591,37254643,37254117,1052
"8241","chr12",49264463,49265392,49264927,929
"8242","chr6",38702800,38703199,38702999,399
"8243","chr20",46894962,46895381,46895171,419
"8244","chr19",57664255,57664736,57664495,481
"8245","chr5",181189157,181192114,181190635,2957
"8246","chr15",48177810,48178375,48178092,565
"8247","chr16",282514,282760,282637,246
"8248","chr1",47725084,47725377,47725230,293
"8249","chr15",51737033,51737938,51737485,905
"8250","chr7",23468565,23470093,23469329,1528
"8251","chr11",34356682,34358176,34357429,1494
"8252","chr4",118033255,118034052,118033653,797
"8253","chr4",26319147,26319386,26319266,239
"8254","chr3",64685411,64688281,64686846,2870
"8255","chr19",29844339,29845328,29844833,989
"8256","chr6",49550602,49551473,49551037,871
"8257","chr4",73853370,73853622,73853496,252
"8258","chr16",1185566,1187262,1186414,1696
"8259","chr9",35812093,35812392,35812242,299
"8260","chr2",164840960,164842383,164841671,1423
"8261","chr2",54255787,54256297,54256042,510
"8262","chr5",179858250,179859416,179858833,1166
"8263","chr12",132337689,132337898,132337793,209
"8264","chr3",26624459,26624673,26624566,214
"8265","chr6",109009082,109009834,109009458,752
"8266","chr11",1763575,1764323,1763949,748
"8267","chr12",45726943,45727849,45727396,906
"8268","chr13",91174995,91175465,91175230,470
"8269","chr12",30926309,30926944,30926626,635
"8270","chr6",109290788,109291027,109290907,239
"8271","chr10",60778212,60779104,60778658,892
"8272","chr6",18122019,18122763,18122391,744
"8273","chr11",69985465,69986378,69985921,913
"8274","chr19",55516979,55517457,55517218,478
"8275","chr3",12484250,12484847,12484548,597
"8276","chr15",57591800,57592160,57591980,360
"8277","chr5",1099828,1100649,1100238,821
"8278","chr14",36661976,36662265,36662120,289
"8279","chr11",121451829,121452593,121452211,764
"8280","chr16",79598722,79601640,79600181,2918
"8281","chr4",8269487,8270364,8269925,877
"8282","chr4",7591642,7591859,7591750,217
"8283","chr5",90558473,90559139,90558806,666
"8284","chr19",3453365,3453958,3453661,593
"8285","chr13",113074988,113075202,113075095,214
"8286","chr12",5143109,5143404,5143256,295
"8287","chr16",3020094,3021304,3020699,1210
"8288","chr8",1553291,1553505,1553398,214
"8289","chr2",27735340,27735856,27735598,516
"8290","chr6",44073277,44073731,44073504,454
"8291","chr16",4474137,4474711,4474424,574
"8292","chr10",6144557,6145892,6145224,1335
"8293","chr7",106867612,106868288,106867950,676
"8294","chr6",151451908,151452935,151452421,1027
"8295","chr19",2731693,2731969,2731831,276
"8296","chr19",19543958,19546009,19544983,2051
"8297","chr7",1022860,1023330,1023095,470
"8298","chr18",59308610,59308928,59308769,318
"8299","chr7",55018448,55020412,55019430,1964
"8300","chr3",134485678,134486597,134486137,919
"8301","chr16",67893015,67893793,67893404,778
"8302","chr20",43590876,43591348,43591112,472
"8303","chr16",89171536,89171923,89171729,387
"8304","chr10",16436804,16437304,16437054,500
"8305","chr2",1743061,1744846,1743953,1785
"8306","chr15",40108656,40109097,40108876,441
"8307","chr15",34101613,34102063,34101838,450
"8308","chr19",1486839,1487382,1487110,543
"8309","chr6",104940315,104941670,104940992,1355
"8310","chr17",40443494,40444054,40443774,560
"8311","chr17",45429462,45433014,45431238,3552
"8312","chr22",42519506,42519993,42519749,487
"8313","chr15",88769519,88769952,88769735,433
"8314","chr5",134003909,134005818,134004863,1909
"8315","chr7",6271691,6272178,6271934,487
"8316","chr12",130641303,130641514,130641408,211
"8317","chr19",6746063,6746281,6746172,218
"8318","chr7",55571584,55572906,55572245,1322
"8319","chr19",57599861,57600402,57600131,541
"8320","chr5",135535050,135536361,135535705,1311
"8321","chr15",78340229,78341747,78340988,1518
"8322","chr20",52104771,52105373,52105072,602
"8323","chr6",21587190,21588944,21588067,1754
"8324","chr19",5060973,5061231,5061102,258
"8325","chr5",176877964,176878165,176878064,201
"8326","chr4",758241,760000,759120,1759
"8327","chr19",41935878,41936082,41935980,204
"8328","chr7",5603317,5603553,5603435,236
"8329","chr12",124554573,124554798,124554685,225
"8330","chr20",63944371,63944699,63944535,328
"8331","chr19",12440657,12441063,12440860,406
"8332","chr1",46543903,46544460,46544181,557
"8333","chr5",141854001,141854329,141854165,328
"8334","chr2",224038504,224040018,224039261,1514
"8335","chr19",1236394,1238312,1237353,1918
"8336","chr5",180802375,180803147,180802761,772
"8337","chr11",111926827,111927306,111927066,479
"8338","chr3",195908488,195910024,195909256,1536
"8339","chr7",43112421,43113741,43113081,1320
"8340","chr20",41617706,41619202,41618454,1496
"8341","chrX",37491731,37492241,37491986,510
"8342","chr4",8592685,8593050,8592867,365
"8343","chr5",179374297,179374815,179374556,518
"8344","chr17",61863464,61863706,61863585,242
"8345","chr17",66834968,66835401,66835184,433
"8346","chr12",76763738,76764625,76764181,887
"8347","chr12",99984465,99985129,99984797,664
"8348","chr6",88047574,88048161,88047867,587
"8349","chr19",34905034,34905572,34905303,538
"8350","chr7",105012672,105014519,105013595,1847
"8351","chr11",116772593,116773176,116772884,583
"8352","chr19",43798513,43799024,43798768,511
"8353","chr19",1004325,1005606,1004965,1281
"8354","chr11",61680127,61680801,61680464,674
"8355","chr5",181243373,181243996,181243684,623
"8356","chr6",131950686,131951426,131951056,740
"8357","chr20",62816333,62817666,62816999,1333
"8358","chr17",29622411,29623259,29622835,848
"8359","chr21",42653091,42653446,42653268,355
"8360","chr7",158704466,158705320,158704893,854
"8361","chr4",41751652,41751930,41751791,278
"8362","chr15",74803008,74803219,74803113,211
"8363","chr17",80857705,80858064,80857884,359
"8364","chr7",151251676,151252191,151251933,515
"8365","chr7",128790653,128791816,128791234,1163
"8366","chr19",4493981,4494494,4494237,513
"8367","chr17",19744728,19745179,19744953,451
"8368","chr1",120176143,120176534,120176338,391
"8369","chr11",134223670,134225597,134224633,1927
"8370","chr10",51699491,51699999,51699745,508
"8371","chr13",52617270,52617737,52617503,467
"8372","chr12",114674209,114674822,114674515,613
"8373","chr6",3231361,3232055,3231708,694
"8374","chr13",30306762,30307802,30307282,1040
"8375","chr6",168825754,168826324,168826039,570
"8376","chr4",153792385,153793088,153792736,703
"8377","chr13",113118413,113118698,113118555,285
"8378","chr4",182448123,182449306,182448714,1183
"8379","chr8",144791542,144793279,144792410,1737
"8380","chr19",2116572,2116809,2116690,237
"8381","chr1",6235468,6236201,6235834,733
"8382","chr6",5996794,5997181,5996987,387
"8383","chr11",106077370,106078089,106077729,719
"8384","chr9",136694576,136694804,136694690,228
"8385","chr19",11155554,11156050,11155802,496
"8386","chr20",56358771,56359314,56359042,543
"8387","chr5",163505448,163505940,163505694,492
"8388","chr21",33642532,33643378,33642955,846
"8389","chr13",111623215,111623447,111623331,232
"8390","chr22",31212258,31212542,31212400,284
"8391","chr10",97292177,97292733,97292455,556
"8392","chr1",93908813,93909911,93909362,1098
"8393","chr19",14405914,14406652,14406283,738
"8394","chr19",35856142,35857199,35856670,1057
"8395","chr1",92784381,92785539,92784960,1158
"8396","chr11",60852451,60853638,60853044,1187
"8397","chr16",74984498,74985347,74984922,849
"8398","chr19",43595981,43596688,43596334,707
"8399","chr10",92592910,92593402,92593156,492
"8400","chr2",27771603,27772077,27771840,474
"8401","chr20",35146764,35147477,35147120,713
"8402","chr11",119339580,119340948,119340264,1368
"8403","chr16",4415873,4416888,4416380,1015
"8404","chr10",97974901,97975339,97975120,438
"8405","chr15",63042034,63043864,63042949,1830
"8406","chr13",18874865,18875178,18875021,313
"8407","chr16",88705829,88706787,88706308,958
"8408","chr22",31276434,31276828,31276631,394
"8409","chr12",102965470,102965851,102965660,381
"8410","chr10",14837770,14839042,14838406,1272
"8411","chr3",101686465,101686844,101686654,379
"8412","chr5",134845793,134846560,134846176,767
"8413","chr19",2754547,2754940,2754743,393
"8414","chr8",143942249,143942748,143942498,499
"8415","chr12",95072874,95073688,95073281,814
"8416","chr22",20015998,20017172,20016585,1174
"8417","chr1",16206422,16208085,16207253,1663
"8418","chr17",74872797,74873578,74873187,781
"8419","chr5",181222487,181222768,181222627,281
"8420","chr1",38872807,38873677,38873242,870
"8421","chr19",33621373,33623447,33622410,2074
"8422","chr12",118016974,118017191,118017082,217
"8423","chr8",140338741,140339096,140338918,355
"8424","chr2",170928964,170929666,170929315,702
"8425","chr18",39841496,39841865,39841680,369
"8426","chr10",73413653,73414192,73413922,539
"8427","chr9",136198574,136203626,136201100,5052
"8428","chr3",105868435,105869374,105868904,939
"8429","chr14",53953466,53956240,53954853,2774
"8430","chr8",66542310,66542756,66542533,446
"8431","chr12",125114760,125115079,125114919,319
"8432","chr19",6424440,6425158,6424799,718
"8433","chr6",30571206,30571710,30571458,504
"8434","chr20",25057071,25058484,25057777,1413
"8435","chr16",31442016,31442299,31442157,283
"8436","chr2",112764341,112764997,112764669,656
"8437","chr19",10491604,10492202,10491903,598
"8438","chr18",3067299,3067535,3067417,236
"8439","chr5",112976690,112977309,112976999,619
"8440","chr11",130209304,130209746,130209525,442
"8441","chr12",1864573,1865273,1864923,700
"8442","chr19",13149748,13154110,13151929,4362
"8443","chr6",154039451,154039873,154039662,422
"8444","chr2",11746123,11747081,11746602,958
"8445","chr17",16406992,16407645,16407318,653
"8446","chr17",48892333,48892763,48892548,430
"8447","chr10",110530189,110530547,110530368,358
"8448","chrX",135021966,135022572,135022269,606
"8449","chr7",945977,946277,946127,300
"8450","chr17",82333144,82334518,82333831,1374
"8451","chr7",130440686,130441330,130441008,644
"8452","chr6",16238358,16239000,16238679,642
"8453","chr19",42301984,42302719,42302351,735
"8454","chr19",38647422,38647930,38647676,508
"8455","chr7",27124200,27124479,27124339,279
"8456","chr7",48088449,48090364,48089406,1915
"8457","chrX",49234083,49234496,49234289,413
"8458","chr17",48576691,48577007,48576849,316
"8459","chr11",1226600,1226910,1226755,310
"8460","chr19",11965214,11965551,11965382,337
"8461","chr5",177961752,177962249,177962000,497
"8462","chr12",132282881,132283366,132283123,485
"8463","chr16",31148255,31148688,31148471,433
"8464","chr10",52871451,52871666,52871558,215
"8465","chr5",119268776,119269139,119268957,363
"8466","chr22",36775722,36776625,36776173,903
"8467","chr1",15247124,15247457,15247290,333
"8468","chr9",131260825,131261051,131260938,226
"8469","chr13",33817990,33818356,33818173,366
"8470","chr5",174751100,174751925,174751512,825
"8471","chr4",1801349,1803945,1802647,2596
"8472","chr10",1184873,1185274,1185073,401
"8473","chr18",22164975,22172402,22168688,7427
"8474","chr21",14083964,14084535,14084249,571
"8475","chr13",52850806,52851860,52851333,1054
"8476","chr1",1040116,1044925,1042520,4809
"8477","chr5",157574460,157574748,157574604,288
"8478","chr2",111224298,111224758,111224528,460
"8479","chr1",31586870,31587170,31587020,300
"8480","chr2",152175419,152176381,152175900,962
"8481","chr16",29074899,29075113,29075006,214
"8482","chr7",73521282,73522760,73522021,1478
"8483","chr1",171485378,171486100,171485739,722
"8484","chr1",230279596,230279943,230279769,347
"8485","chr18",57121728,57121963,57121845,235
"8486","chr19",19170189,19170751,19170470,562
"8487","chr1",186680679,186680949,186680814,270
"8488","chr15",90934887,90935753,90935320,866
"8489","chr6",30071104,30071700,30071402,596
"8490","chr16",1485924,1486575,1486249,651
"8491","chr1",20552401,20554002,20553201,1601
"8492","chr2",241609958,241610580,241610269,622
"8493","chr1",214187264,214187585,214187424,321
"8494","chr18",78781147,78781888,78781517,741
"8495","chr5",4866204,4866517,4866360,313
"8496","chr7",44309641,44310117,44309879,476
"8497","chr1",1454175,1454509,1454342,334
"8498","chr2",101697087,101698366,101697726,1279
"8499","chr11",65720189,65720877,65720533,688
"8500","chr11",92969623,92970268,92969945,645
"8501","chr5",62403523,62404050,62403786,527
"8502","chr16",74998859,75000309,74999584,1450
"8503","chr2",96868363,96870533,96869448,2170
"8504","chr12",124445326,124445615,124445470,289
"8505","chr22",19854360,19855487,19854923,1127
"8506","chr8",9903240,9904133,9903686,893
"8507","chr11",43575440,43575786,43575613,346
"8508","chr13",98576090,98577575,98576832,1485
"8509","chrX",152637754,152638493,152638123,739
"8510","chr6",158167855,158168417,158168136,562
"8511","chr12",56128456,56128670,56128563,214
"8512","chr16",85208777,85209028,85208902,251
"8513","chr2",241803183,241804343,241803763,1160
"8514","chr1",15944096,15945087,15944591,991
"8515","chr1",176206575,176207675,176207125,1100
"8516","chr5",75717137,75717690,75717413,553
"8517","chr19",5110576,5110842,5110709,266
"8518","chr6",15244646,15245802,15245224,1156
"8519","chr4",2399780,2400032,2399906,252
"8520","chr5",6737591,6737891,6737741,300
"8521","chr1",46340667,46341164,46340915,497
"8522","chr11",20669033,20670299,20669666,1266
"8523","chr6",29976625,29977392,29977008,767
"8524","chr18",46104147,46104881,46104514,734
"8525","chr7",1495981,1496463,1496222,482
"8526","chr12",107581065,107581528,107581296,463
"8527","chr11",46347100,46348110,46347605,1010
"8528","chr6",53544322,53545301,53544811,979
"8529","chr20",50930531,50931988,50931259,1457
"8530","chr4",113979199,113979654,113979426,455
"8531","chr5",34838816,34839519,34839167,703
"8532","chr11",93740919,93741909,93741414,990
"8533","chr11",64765464,64766291,64765877,827
"8534","chr13",113510903,113511147,113511025,244
"8535","chr14",50531859,50532993,50532426,1134
"8536","chr18",78562675,78563015,78562845,340
"8537","chr7",124032009,124033637,124032823,1628
"8538","chr2",162344065,162344515,162344290,450
"8539","chr6",34224004,34224402,34224203,398
"8540","chr4",55125235,55126004,55125619,769
"8541","chr4",76948287,76950969,76949628,2682
"8542","chr16",30834329,30834873,30834601,544
"8543","chr6",110958441,110959007,110958724,566
"8544","chrX",6226079,6227865,6226972,1786
"8545","chr4",55395530,55396336,55395933,806
"8546","chr3",128680638,128681312,128680975,674
"8547","chr5",171630067,171630336,171630201,269
"8548","chr12",4562143,4562538,4562340,395
"8549","chr1",228321852,228322062,228321957,210
"8550","chr2",147843711,147844533,147844122,822
"8551","chr18",46071830,46072489,46072159,659
"8552","chr10",77711204,77711667,77711435,463
"8553","chr4",9691758,9691979,9691868,221
"8554","chr16",75229597,75229987,75229792,390
"8555","chr13",41193691,41194626,41194158,935
"8556","chr6",32843717,32844062,32843889,345
"8557","chr5",181097612,181098276,181097944,664
"8558","chr19",53520614,53521306,53520960,692
"8559","chr1",244862882,244864718,244863800,1836
"8560","chr11",746877,748032,747454,1155
"8561","chr7",151048915,151049294,151049104,379
"8562","chr18",12947392,12948655,12948023,1263
"8563","chr13",113393883,113394356,113394119,473
"8564","chr19",41927764,41928330,41928047,566
"8565","chr2",85888467,85889204,85888835,737
"8566","chr10",79242278,79243930,79243104,1652
"8567","chr6",116571072,116571771,116571421,699
"8568","chr18",3261710,3262673,3262191,963
"8569","chr5",69189388,69189750,69189569,362
"8570","chr1",3814894,3815451,3815172,557
"8571","chr16",89101355,89101583,89101469,228
"8572","chr1",116909581,116910830,116910205,1249
"8573","chr1",117929217,117930097,117929657,880
"8574","chr11",34174442,34174709,34174575,267
"8575","chr2",74472113,74472782,74472447,669
"8576","chr16",81444172,81445594,81444883,1422
"8577","chr9",68307129,68307807,68307468,678
"8578","chr7",157794019,157794420,157794219,401
"8579","chr1",28232634,28233086,28232860,452
"8580","chr2",210002448,210002981,210002714,533
"8581","chr2",119759490,119760434,119759962,944
"8582","chr2",237966489,237967685,237967087,1196
"8583","chr2",112254531,112255207,112254869,676
"8584","chr19",43699406,43699835,43699620,429
"8585","chr8",2130061,2130439,2130250,378
"8586","chr16",1215151,1215661,1215406,510
"8587","chr1",4711592,4712485,4712038,893
"8588","chr19",13298508,13299317,13298912,809
"8589","chr18",75287695,75288133,75287914,438
"8590","chr6",33593115,33593412,33593263,297
"8591","chr7",2432610,2433932,2433271,1322
"8592","chr8",1373066,1373472,1373269,406
"8593","chr7",93890054,93890872,93890463,818
"8594","chr11",47248683,47249082,47248882,399
"8595","chr11",67288460,67289778,67289119,1318
"8596","chr17",81926803,81929208,81928005,2405
"8597","chr2",23562179,23562469,23562324,290
"8598","chr7",158203950,158204335,158204142,385
"8599","chr10",97445719,97446517,97446118,798
"8600","chr6",43174275,43174479,43174377,204
"8601","chr16",89256872,89257253,89257062,381
"8602","chr9",137453388,137453868,137453628,480
"8603","chr2",219218269,219219290,219218779,1021
"8604","chr8",80265706,80265956,80265831,250
"8605","chr21",45456254,45456838,45456546,584
"8606","chr6",63572246,63573831,63573038,1585
"8607","chr20",43188835,43190572,43189703,1737
"8608","chr11",1085138,1085362,1085250,224
"8609","chr2",8681860,8682609,8682234,749
"8610","chr2",20665529,20667829,20666679,2300
"8611","chrX",108735789,108736915,108736352,1126
"8612","chr16",22948105,22948555,22948330,450
"8613","chr10",92688936,92690722,92689829,1786
"8614","chr10",49761612,49762559,49762085,947
"8615","chr19",17327245,17329509,17328377,2264
"8616","chr5",177093156,177093621,177093388,465
"8617","chr6",34154698,34155172,34154935,474
"8618","chr17",76537851,76538484,76538167,633
"8619","chr20",59006847,59007540,59007193,693
"8620","chr2",233354082,233355332,233354707,1250
"8621","chr6",43769895,43772115,43771005,2220
"8622","chr18",76787360,76787685,76787522,325
"8623","chr20",3681663,3682540,3682101,877
"8624","chr6",52307124,52307357,52307240,233
"8625","chr5",67163207,67163767,67163487,560
"8626","chr1",200739193,200739820,200739506,627
"8627","chr1",160400322,160400894,160400608,572
"8628","chr22",43996429,43996789,43996609,360
"8629","chr5",1874793,1878918,1876855,4125
"8630","chr3",126355940,126358022,126356981,2082
"8631","chr2",199455779,199460051,199457915,4272
"8632","chr9",136723170,136723679,136723424,509
"8633","chr20",63266602,63266974,63266788,372
"8634","chr16",82170043,82170797,82170420,754
"8635","chr1",201506757,201507388,201507072,631
"8636","chr19",40425354,40426206,40425780,852
"8637","chr20",63346663,63346942,63346802,279
"8638","chr5",179849846,179850068,179849957,222
"8639","chr16",627367,628128,627747,761
"8640","chr5",81393813,81394409,81394111,596
"8641","chr10",132990717,132990944,132990830,227
"8642","chr7",101916122,101916345,101916233,223
"8643","chr5",1277352,1277598,1277475,246
"8644","chr10",43076556,43077986,43077271,1430
"8645","chr10",110918549,110920136,110919342,1587
"8646","chr9",124853187,124853595,124853391,408
"8647","chr22",50197876,50198568,50198222,692
"8648","chr7",158569217,158570278,158569747,1061
"8649","chr19",13758903,13759271,13759087,368
"8650","chr8",69831863,69835105,69833484,3242
"8651","chr1",162497809,162498237,162498023,428
"8652","chr22",38755452,38756471,38755961,1019
"8653","chr16",8962515,8964408,8963461,1893
"8654","chr2",119544126,119544879,119544502,753
"8655","chr19",57947318,57947851,57947584,533
"8656","chr1",1336997,1337254,1337125,257
"8657","chr10",116849088,116849667,116849377,579
"8658","chr22",41197019,41197911,41197465,892
"8659","chr16",53054804,53055367,53055085,563
"8660","chr10",43342339,43342696,43342517,357
"8661","chr5",69559982,69560334,69560158,352
"8662","chr11",10540678,10541395,10541036,717
"8663","chr20",63286147,63286416,63286281,269
"8664","chr1",4132573,4133183,4132878,610
"8665","chr9",95004367,95005673,95005020,1306
"8666","chr2",121648822,121650248,121649535,1426
"8667","chr5",142108719,142109354,142109036,635
"8668","chr2",60549461,60551022,60550241,1561
"8669","chr5",141332230,141332975,141332602,745
"8670","chr21",15729534,15730484,15730009,950
"8671","chr1",167820158,167820409,167820283,251
"8672","chr10",132453174,132453430,132453302,256
"8673","chrY",9505742,9506005,9505873,263
"8674","chr1",51518705,51519224,51518964,519
"8675","chr16",19086409,19086907,19086658,498
"8676","chr7",30594508,30595442,30594975,934
"8677","chr13",113001802,113002065,113001933,263
"8678","chr19",11505216,11506032,11505624,816
"8679","chr5",71455808,71456060,71455934,252
"8680","chr22",21032204,21032711,21032457,507
"8681","chr11",111937192,111937479,111937335,287
"8682","chr1",111515562,111515968,111515765,406
"8683","chr15",75208517,75208816,75208666,299
"8684","chr5",94111248,94111731,94111489,483
"8685","chr10",80356446,80357364,80356905,918
"8686","chr3",195895389,195896162,195895775,773
"8687","chr12",49188313,49189098,49188705,785
"8688","chr19",49495995,49496582,49496288,587
"8689","chr5",83077283,83077528,83077405,245
"8690","chr1",27392388,27392845,27392616,457
"8691","chr9",134407344,134407591,134407467,247
"8692","chr4",2303787,2304066,2303926,279
"8693","chr22",39152097,39153661,39152879,1564
"8694","chr7",159093676,159093904,159093790,228
"8695","chr12",118371519,118373216,118372367,1697
"8696","chr5",1552920,1553154,1553037,234
"8697","chr1",208243144,208244284,208243714,1140
"8698","chr19",39342641,39343033,39342837,392
"8699","chr19",31348729,31352143,31350436,3414
"8700","chr20",37520201,37521734,37520967,1533
"8701","chr17",58487493,58488530,58488011,1037
"8702","chr20",51022534,51023675,51023104,1141
"8703","chr1",1110664,1110960,1110812,296
"8704","chr1",8358262,8358490,8358376,228
"8705","chr1",39738640,39739067,39738853,427
"8706","chr10",102055745,102056348,102056046,603
"8707","chr1",2479686,2479965,2479825,279
"8708","chr16",88681339,88681610,88681474,271
"8709","chr7",32070451,32071298,32070874,847
"8710","chr20",45971166,45972568,45971867,1402
"8711","chr5",171418756,171421120,171419938,2364
"8712","chr2",112054232,112056037,112055134,1805
"8713","chr21",43803581,43803843,43803712,262
"8714","chr16",1911525,1912145,1911835,620
"8715","chr1",4161327,4161612,4161469,285
"8716","chr15",62224125,62224606,62224365,481
"8717","chr19",58439847,58440883,58440365,1036
"8718","chr4",158210356,158210584,158210470,228
"8719","chr17",42832990,42833905,42833447,915
"8720","chr7",6935126,6935332,6935229,206
"8721","chr1",6554076,6554775,6554425,699
"8722","chr7",50303299,50304923,50304111,1624
"8723","chr10",102119876,102120360,102120118,484
"8724","chr1",31762746,31764651,31763698,1905
"8725","chr16",3500773,3501274,3501023,501
"8726","chr16",662735,663047,662891,312
"8727","chr11",65121664,65122459,65122061,795
"8728","chr2",47402928,47403652,47403290,724
"8729","chr1",205749110,205750217,205749663,1107
"8730","chrX",155264018,155264622,155264320,604
"8731","chr7",128476613,128477258,128476935,645
"8732","chr1",30718125,30719113,30718619,988
"8733","chr1",182789260,182789962,182789611,702
"8734","chr16",11178389,11178646,11178517,257
"8735","chr10",133289791,133290050,133289920,259
"8736","chr7",98616493,98618447,98617470,1954
"8737","chr20",63034428,63035203,63034815,775
"8738","chr4",8152350,8152679,8152514,329
"8739","chr16",67909064,67909369,67909216,305
"8740","chr14",75578247,75578759,75578503,512
"8741","chr19",45591076,45591853,45591464,777
"8742","chr11",66311621,66313449,66312535,1828
"8743","chr17",35460382,35460641,35460511,259
"8744","chr19",48461745,48462535,48462140,790
"8745","chr5",177944362,177944611,177944486,249
"8746","chr5",134758479,134759081,134758780,602
"8747","chr2",171517307,171517689,171517498,382
"8748","chr17",80746200,80746427,80746313,227
"8749","chr21",42513479,42514722,42514100,1243
"8750","chr2",15561015,15561393,15561204,378
"8751","chr10",104232141,104232490,104232315,349
"8752","chr1",6418997,6420878,6419937,1881
"8753","chr17",10729472,10730173,10729822,701
"8754","chr16",22297270,22298044,22297657,774
"8755","chr12",51814050,51814889,51814469,839
"8756","chr5",160370381,160370690,160370535,309
"8757","chr9",135931390,135931680,135931535,290
"8758","chr8",64373510,64374102,64373806,592
"8759","chr22",40418812,40419098,40418955,286
"8760","chr2",44167844,44169490,44168667,1646
"8761","chr6",170138700,170139711,170139205,1011
"8762","chr6",165726513,165726805,165726659,292
"8763","chr19",31279013,31279307,31279160,294
"8764","chr2",113979276,113980112,113979694,836
"8765","chr5",141702286,141703025,141702655,739
"8766","chr17",74987526,74988496,74988011,970
"8767","chr6",63635585,63636560,63636072,975
"8768","chr19",12139879,12140402,12140140,523
"8769","chr15",74127529,74130703,74129116,3174
"8770","chr8",53843016,53843617,53843316,601
"8771","chr2",176001965,176002460,176002212,495
"8772","chr8",86508344,86508887,86508615,543
"8773","chr2",201642416,201643547,201642981,1131
"8774","chr2",127400861,127401336,127401098,475
"8775","chr20",62238315,62239191,62238753,876
"8776","chr21",45914033,45914535,45914284,502
"8777","chr8",124301442,124301856,124301649,414
"8778","chr6",87589902,87590227,87590064,325
"8779","chr16",2577133,2577398,2577265,265
"8780","chr2",73984087,73985605,73984846,1518
"8781","chr21",26572691,26573327,26573009,636
"8782","chr16",86512753,86513026,86512889,273
"8783","chr2",241936451,241937003,241936727,552
"8784","chr19",57614162,57614534,57614348,372
"8785","chr14",69571391,69574945,69573168,3554
"8786","chr17",76121427,76122299,76121863,872
"8787","chr2",70248295,70249019,70248657,724
"8788","chr7",101321509,101321920,101321714,411
"8789","chr7",1483905,1484340,1484122,435
"8790","chr12",51083076,51083769,51083422,693
"8791","chr9",127692219,127692429,127692324,210
"8792","chr7",157299903,157300841,157300372,938
"8793","chr10",28925122,28925433,28925277,311
"8794","chr17",81245754,81246100,81245927,346
"8795","chr2",219176407,219178289,219177348,1882
"8796","chr1",206202466,206205885,206204175,3419
"8797","chr9",129620022,129620725,129620373,703
"8798","chr7",157336395,157337612,157337003,1217
"8799","chr8",142347640,142347863,142347751,223
"8800","chrX",153953367,153953721,153953544,354
"8801","chr6",43053387,43053956,43053671,569
"8802","chr19",42075783,42076524,42076153,741
"8803","chr4",81471456,81472272,81471864,816
"8804","chr17",443024,443541,443282,517
"8805","chr1",29121187,29125335,29123261,4148
"8806","chr9",15510178,15511234,15510706,1056
"8807","chr8",1041532,1041862,1041697,330
"8808","chr19",55849816,55851740,55850778,1924
"8809","chr5",173056112,173057410,173056761,1298
"8810","chr2",240672327,240673260,240672793,933
"8811","chr2",58428308,58428977,58428642,669
"8812","chr15",89654869,89655602,89655235,733
"8813","chr11",1574579,1574913,1574746,334
"8814","chr1",58576085,58577623,58576854,1538
"8815","chr7",1473303,1473580,1473441,277
"8816","chr11",460468,460715,460591,247
"8817","chr3",37243067,37243790,37243428,723
"8818","chr5",66596049,66597711,66596880,1662
"8819","chr2",184598119,184598862,184598490,743
"8820","chr12",51238705,51239378,51239041,673
"8821","chrX",80335221,80335508,80335364,287
"8822","chr2",111117629,111123388,111120508,5759
"8823","chr14",23094769,23095515,23095142,746
"8824","chr20",62554379,62554696,62554537,317
"8825","chr22",15760286,15760675,15760480,389
"8826","chr20",25623179,25624551,25623865,1372
"8827","chr20",63572298,63573226,63572762,928
"8828","chr10",15088387,15088914,15088650,527
"8829","chr4",16225902,16227522,16226712,1620
"8830","chr7",97117455,97117878,97117666,423
"8831","chr17",29761009,29761589,29761299,580
"8832","chr8",22130019,22131500,22130759,1481
"8833","chr20",4760699,4761299,4760999,600
"8834","chr17",81165701,81166564,81166132,863
"8835","chr6",106086261,106086510,106086385,249
"8836","chr8",38381671,38383152,38382411,1481
"8837","chr1",109910521,109911267,109910894,746
"8838","chr11",636435,640628,638531,4193
"8839","chr16",84294913,84295114,84295013,201
"8840","chr3",11642718,11643456,11643087,738
"8841","chr12",119593689,119595407,119594548,1718
"8842","chr8",94262182,94262427,94262304,245
"8843","chr22",37097664,37098134,37097899,470
"8844","chr1",210328743,210329449,210329096,706
"8845","chr3",38024252,38025331,38024791,1079
"8846","chr12",6329106,6329765,6329435,659
"8847","chr5",177433861,177434097,177433979,236
"8848","chr19",2432849,2434079,2433464,1230
"8849","chr9",105694419,105695155,105694787,736
"8850","chr20",38033432,38034093,38033762,661
"8851","chr19",1205369,1207423,1206396,2054
"8852","chr2",219279157,219279911,219279534,754
"8853","chr1",38708707,38709268,38708987,561
"8854","chr18",47150099,47150686,47150392,587
"8855","chr15",65982196,65982500,65982348,304
"8856","chr13",111114501,111116259,111115380,1758
"8857","chr20",38601880,38602099,38601989,219
"8858","chr11",114439279,114439864,114439571,585
"8859","chr1",40477112,40477715,40477413,603
"8860","chr5",134225449,134226790,134226119,1341
"8861","chr1",81800313,81803363,81801838,3050
"8862","chr20",5000956,5001744,5001350,788
"8863","chr4",164188282,164188690,164188486,408
"8864","chr13",112648992,112649226,112649109,234
"8865","chr19",1905107,1905836,1905471,729
"8866","chr19",54416728,54417051,54416889,323
"8867","chr5",178165654,178165985,178165819,331
"8868","chr16",85011124,85011830,85011477,706
"8869","chr11",118572301,118572916,118572608,615
"8870","chr1",218346945,218347164,218347054,219
"8871","chr6",41636845,41638925,41637885,2080
"8872","chr3",120596111,120596643,120596377,532
"8873","chr1",1782200,1782702,1782451,502
"8874","chr5",176133202,176133731,176133466,529
"8875","chr12",110468074,110469378,110468726,1304
"8876","chr5",17354291,17354629,17354460,338
"8877","chr22",42553586,42554298,42553942,712
"8878","chr3",156554847,156555310,156555078,463
"8879","chr5",132496663,132497202,132496932,539
"8880","chr12",53321349,53321732,53321540,383
"8881","chr21",45898595,45898986,45898790,391
"8882","chr11",134341865,134342717,134342291,852
"8883","chr2",238100431,238100720,238100575,289
"8884","chr2",172735553,172736242,172735897,689
"8885","chr1",39954815,39955694,39955254,879
"8886","chr16",89489407,89491345,89490376,1938
"8887","chr9",127611829,127612606,127612217,777
"8888","chr7",42236404,42237855,42237129,1451
"8889","chr12",49389182,49389410,49389296,228
"8890","chr10",123134559,123137850,123136204,3291
"8891","chr5",96702505,96703180,96702842,675
"8892","chr13",21060380,21061768,21061074,1388
"8893","chr1",2968497,2968719,2968608,222
"8894","chr10",100229370,100229776,100229573,406
"8895","chr6",10694384,10695119,10694751,735
"8896","chr1",30807274,30807665,30807469,391
"8897","chr19",39409499,39410248,39409873,749
"8898","chr6",42960480,42961072,42960776,592
"8899","chr10",37780658,37781018,37780838,360
"8900","chr11",111765870,111766490,111766180,620
"8901","chr6",27312015,27312856,27312435,841
"8902","chr19",14081175,14081960,14081567,785
"8903","chr4",143513096,143514190,143513643,1094
"8904","chr16",54122041,54122268,54122154,227
"8905","chr9",137370909,137371576,137371242,667
"8906","chr13",113088422,113088705,113088563,283
"8907","chr11",235918,237290,236604,1372
"8908","chr1",3543310,3543705,3543507,395
"8909","chr4",651015,651311,651163,296
"8910","chr22",30396898,30397323,30397110,425
"8911","chr16",89570738,89571332,89571035,594
"8912","chr12",49366438,49367653,49367045,1215
"8913","chr19",54415229,54415654,54415441,425
"8914","chr2",101001785,101002196,101001990,411
"8915","chr12",113221233,113221852,113221542,619
"8916","chr8",65633823,65634165,65633994,342
"8917","chr10",419988,420456,420222,468
"8918","chr7",27130091,27131019,27130555,928
"8919","chr1",179025723,179026782,179026252,1059
"8920","chr8",143085054,143085370,143085212,316
"8921","chr1",9234342,9235393,9234867,1051
"8922","chr12",25386249,25386490,25386369,241
"8923","chr17",81406559,81406923,81406741,364
"8924","chr16",2696894,2697110,2697002,216
"8925","chr22",38843004,38844420,38843712,1416
"8926","chr1",230642331,230642847,230642589,516
"8927","chr4",141132173,141133447,141132810,1274
"8928","chr6",5084282,5086798,5085540,2516
"8929","chr11",66069783,66071178,66070480,1395
"8930","chr3",58332767,58333465,58333116,698
"8931","chr21",44723527,44723893,44723710,366
"8932","chr2",42360932,42361735,42361333,803
"8933","chr9",136977785,136979061,136978423,1276
"8934","chr6",116680935,116681634,116681284,699
"8935","chr13",102596463,102597642,102597052,1179
"8936","chr7",88219688,88220279,88219983,591
"8937","chr19",12333218,12333734,12333476,516
"8938","chr8",60173566,60173768,60173667,202
"8939","chr19",10106136,10106664,10106400,528
"8940","chr8",89757307,89758229,89757768,922
"8941","chr10",73874028,73875038,73874533,1010
"8942","chr1",196878028,196878288,196878158,260
"8943","chr1",91500706,91501442,91501074,736
"8944","chr19",9309573,9309905,9309739,332
"8945","chr7",6058793,6059351,6059072,558
"8946","chr19",10418951,10421328,10420139,2377
"8947","chr22",37849334,37849674,37849504,340
"8948","chr19",47745472,47745853,47745662,381
"8949","chr6",6002287,6004772,6003529,2485
"8950","chr21",25562111,25562493,25562302,382
"8951","chr16",59754888,59755168,59755028,280
"8952","chr7",6081198,6081767,6081482,569
"8953","chr4",1346286,1347683,1346984,1397
"8954","chr2",38074133,38077376,38075754,3243
"8955","chr1",6701235,6702071,6701653,836
"8956","chr19",703859,704279,704069,420
"8957","chr7",157663097,157663352,157663224,255
"8958","chr1",230066747,230068462,230067604,1715
"8959","chr5",20305453,20305827,20305640,374
"8960","chr2",732036,733096,732566,1060
"8961","chr8",143858061,143866649,143862355,8588
"8962","chr9",92715014,92715426,92715220,412
"8963","chr21",13979587,13980337,13979962,750
"8964","chr11",130427506,130428622,130428064,1116
"8965","chr1",156859012,156861310,156860161,2298
"8966","chr16",1705823,1706678,1706250,855
"8967","chr1",215567164,215567923,215567543,759
"8968","chr11",6570730,6571553,6571141,823
"8969","chr22",41946403,41947274,41946838,871
"8970","chr1",211382597,211382990,211382793,393
"8971","chr11",18455751,18456209,18455980,458
"8972","chr2",241355262,241356786,241356024,1524
"8973","chr3",47380592,47381689,47381140,1097
"8974","chr7",151204464,151204892,151204678,428
"8975","chr12",54019206,54019562,54019384,356
"8976","chr5",74685142,74685696,74685419,554
"8977","chr1",203305169,203306210,203305689,1041
"8978","chr9",132198128,132198618,132198373,490
"8979","chr8",73008623,73009317,73008970,694
"8980","chr1",229507966,229508546,229508256,580
"8981","chr8",90645161,90646551,90645856,1390
"8982","chr11",44949497,44951134,44950315,1637
"8983","chr1",165352466,165353081,165352773,615
"8984","chr10",120948997,120949386,120949191,389
"8985","chr1",151008259,151008616,151008437,357
"8986","chr19",35030258,35031303,35030780,1045
"8987","chr5",172959295,172959539,172959417,244
"8988","chr7",92589746,92590559,92590152,813
"8989","chr19",7647151,7647469,7647310,318
"8990","chr5",122076805,122078394,122077599,1589
"8991","chr8",102123686,102124547,102124116,861
"8992","chr1",17119156,17119593,17119374,437
"8993","chr5",51399150,51399518,51399334,368
"8994","chr5",139403803,139404223,139404013,420
"8995","chr6",5851377,5851608,5851492,231
"8996","chr4",212588,213103,212845,515
"8997","chr11",66267280,66269337,66268308,2057
"8998","chr6",75204989,75206671,75205830,1682
"8999","chr19",1014274,1014579,1014426,305
"9000","chrX",118879014,118879316,118879165,302
"9001","chr6",27519033,27519290,27519161,257
"9002","chr2",128736785,128737500,128737142,715
"9003","chr4",48341072,48342312,48341692,1240
"9004","chr7",773990,774755,774372,765
"9005","chr19",36113457,36116004,36114730,2547
"9006","chr2",110678530,110678852,110678691,322
"9007","chr11",17544219,17544505,17544362,286
"9008","chr2",65129601,65130840,65130220,1239
"9009","chr22",43862231,43862732,43862481,501
"9010","chr16",88737394,88737704,88737549,310
"9011","chr1",50977639,50978364,50978001,725
"9012","chr3",62368616,62369337,62368976,721
"9013","chr13",114075443,114076105,114075774,662
"9014","chr8",73878107,73879177,73878642,1070
"9015","chr2",7430940,7431511,7431225,571
"9016","chr7",150974510,150975282,150974896,772
"9017","chr2",218568044,218569371,218568707,1327
"9018","chrX",153672993,153674089,153673541,1096
"9019","chr9",130579242,130580109,130579675,867
"9020","chr6",145963659,145964565,145964112,906
"9021","chr2",209808568,209808822,209808695,254
"9022","chrX",65822054,65822462,65822258,408
"9023","chr3",194583822,194584322,194584072,500
"9024","chr8",28622118,28623281,28622699,1163
"9025","chr11",9003548,9004768,9004158,1220
"9026","chr2",85772234,85772506,85772370,272
"9027","chr17",17205457,17206982,17206219,1525
"9028","chr3",49029140,49029550,49029345,410
"9029","chr10",18659184,18659782,18659483,598
"9030","chr12",53006088,53007112,53006600,1024
"9031","chr7",21427028,21428188,21427608,1160
"9032","chr4",2007987,2009701,2008844,1714
"9033","chr9",136118016,136119465,136118740,1449
"9034","chr1",121395924,121397197,121396560,1273
"9035","chr1",19882314,19882969,19882641,655
"9036","chr16",56931822,56932511,56932166,689
"9037","chrX",40735263,40736205,40735734,942
"9038","chr4",336373,338279,337326,1906
"9039","chr2",74502272,74504039,74503155,1767
"9040","chr2",868244,869405,868824,1161
"9041","chr13",112587397,112588342,112587869,945
"9042","chr5",55176393,55176701,55176547,308
"9043","chr7",135977093,135977524,135977308,431
"9044","chr1",36306229,36307408,36306818,1179
"9045","chr3",184525297,184526118,184525707,821
"9046","chr7",101688362,101688624,101688493,262
"9047","chr19",9768476,9769060,9768768,584
"9048","chr2",131217818,131218058,131217938,240
"9049","chr1",21814406,21814914,21814660,508
"9050","chr12",26114125,26114586,26114355,461
"9051","chr1",1978829,1982361,1980595,3532
"9052","chr16",89668577,89668781,89668679,204
"9053","chr19",56339288,56339852,56339570,564
"9054","chr14",49633597,49635291,49634444,1694
"9055","chr2",55923205,55923813,55923509,608
"9056","chrX",104250329,104250628,104250478,299
"9057","chr4",128060655,128062323,128061489,1668
"9058","chr11",68839296,68839862,68839579,566
"9059","chr1",217089656,217089872,217089764,216
"9060","chr6",10389937,10390332,10390134,395
"9061","chr19",17859504,17860314,17859909,810
"9062","chr19",18605419,18607933,18606676,2514
"9063","chr16",2127127,2127328,2127227,201
"9064","chr3",50226253,50226476,50226364,223
"9065","chr6",30717059,30717726,30717392,667
"9066","chr20",40687399,40687682,40687540,283
"9067","chr4",99653246,99653497,99653371,251
"9068","chr1",153958070,153958654,153958362,584
"9069","chr16",1390473,1390688,1390580,215
"9070","chr1",161314328,161314661,161314494,333
"9071","chr17",11598314,11599011,11598662,697
"9072","chr1",85259018,85259841,85259429,823
"9073","chr5",1270663,1270986,1270824,323
"9074","chr11",68433650,68433853,68433751,203
"9075","chrY",6520342,6520611,6520476,269
"9076","chr20",46406084,46406779,46406431,695
"9077","chr1",77759158,77759965,77759561,807
"9078","chr11",65872364,65873903,65873133,1539
"9079","chr12",54280030,54281204,54280617,1174
"9080","chr2",241985293,241985902,241985597,609
"9081","chr7",149195332,149196189,149195760,857
"9082","chr21",40841584,40842020,40841802,436
"9083","chr1",19679017,19679372,19679194,355
"9084","chr15",89367290,89368946,89368118,1656
"9085","chr7",28853836,28854441,28854138,605
"9086","chr17",2697681,2698686,2698183,1005
"9087","chr15",66039752,66040015,66039883,263
"9088","chr1",200669484,200670256,200669870,772
"9089","chr12",84912841,84913050,84912945,209
"9090","chr3",47008996,47010119,47009557,1123
"9091","chr19",58562046,58563388,58562717,1342
"9092","chr3",11846325,11847064,11846694,739
"9093","chr9",101449175,101449548,101449361,373
"9094","chr11",129372634,129376500,129374567,3866
"9095","chr9",136799531,136800628,136800079,1097
"9096","chr1",156813731,156814245,156813988,514
"9097","chr1",20786215,20787628,20786921,1413
"9098","chr9",127404533,127404912,127404722,379
"9099","chr7",155812031,155812401,155812216,370
"9100","chr3",126523940,126524170,126524055,230
"9101","chr1",14923877,14925049,14924463,1172
"9102","chr7",66628361,66629332,66628846,971
"9103","chr1",155227119,155227743,155227431,624
"9104","chr22",39519617,39520992,39520304,1375
"9105","chrX",57909244,57910487,57909865,1243
"9106","chr8",103414666,103415595,103415130,929
"9107","chr1",203487656,203487931,203487793,275
"9108","chr5",81749978,81752030,81751004,2052
"9109","chr21",43757639,43757846,43757742,207
"9110","chr19",37817238,37817886,37817562,648
"9111","chr1",36450195,36450723,36450459,528
"9112","chr20",48636396,48636680,48636538,284
"9113","chr12",132731902,132733748,132732825,1846
"9114","chr3",196712003,196712863,196712433,860
"9115","chr5",755758,756139,755948,381
"9116","chr1",220093972,220094592,220094282,620
"9117","chr6",30101973,30102383,30102178,410
"9118","chr2",88055321,88056055,88055688,734
"9119","chr17",40177606,40178543,40178074,937
"9120","chrX",139931703,139933332,139932517,1629
"9121","chr1",201226902,201227139,201227020,237
"9122","chr11",125111423,125111873,125111648,450
"9123","chr19",1862257,1864943,1863600,2686
"9124","chr11",133832650,133833813,133833231,1163
"9125","chr11",111878846,111879354,111879100,508
"9126","chr19",5843853,5844362,5844107,509
"9127","chr1",180953779,180954556,180954167,777
"9128","chr22",20917075,20918328,20917701,1253
"9129","chr14",23006713,23007218,23006965,505
"9130","chr1",116534420,116534677,116534548,257
"9131","chr8",1546939,1547167,1547053,228
"9132","chr2",121225750,121226164,121225957,414
"9133","chr5",170861875,170862643,170862259,768
"9134","chr8",81841819,81842241,81842030,422
"9135","chr10",58267247,58269481,58268364,2234
"9136","chr21",31731143,31732662,31731902,1519
"9137","chr11",20363615,20364127,20363871,512
"9138","chr8",109333687,109334675,109334181,988
"9139","chr5",58459507,58460976,58460241,1469
"9140","chr1",47433453,47433726,47433589,273
"9141","chr2",178413600,178413942,178413771,342
"9142","chr10",21499704,21500659,21500181,955
"9143","chr10",959471,959885,959678,414
"9144","chr20",44115682,44116383,44116032,701
"9145","chr8",143739841,143740635,143740238,794
"9146","chr12",72271903,72273771,72272837,1868
"9147","chr1",59296430,59297122,59296776,692
"9148","chr16",1464411,1464858,1464634,447
"9149","chr5",60944952,60945663,60945307,711
"9150","chr1",3194583,3195345,3194964,762
"9151","chr17",4947647,4950612,4949129,2965
"9152","chr3",62378342,62378641,62378491,299
"9153","chr3",138187193,138188019,138187606,826
"9154","chr3",128075526,128077293,128076409,1767
"9155","chr1",154325562,154326068,154325815,506
"9156","chrX",49191378,49191948,49191663,570
"9157","chr19",461598,462256,461927,658
"9158","chr16",58515123,58516335,58515729,1212
"9159","chr1",52927208,52927973,52927590,765
"9160","chr1",25232072,25232687,25232379,615
"9161","chr2",100818517,100820991,100819754,2474
"9162","chr6",157822569,157824003,157823286,1434
"9163","chr1",9128444,9129417,9128930,973
"9164","chr19",47273113,47275483,47274298,2370
"9165","chr19",27805935,27806195,27806065,260
"9166","chr11",65711878,65712553,65712215,675
"9167","chr5",134524251,134527738,134525994,3487
"9168","chr17",48429982,48430237,48430109,255
"9169","chr8",144618560,144618908,144618734,348
"9170","chr8",134478543,134478843,134478693,300
"9171","chr17",7915620,7916445,7916032,825
"9172","chr1",936259,936492,936375,233
"9173","chr3",125595142,125595681,125595411,539
"9174","chr5",150297415,150298188,150297801,773
"9175","chr20",34302753,34303572,34303162,819
"9176","chr1",15409554,15410732,15410143,1178
"9177","chr17",62808047,62808496,62808271,449
"9178","chr5",178994224,178995336,178994780,1112
"9179","chr8",101080566,101080910,101080738,344
"9180","chr1",224929518,224930079,224929798,561
"9181","chr1",167553232,167553833,167553532,601
"9182","chr2",96815619,96817539,96816579,1920
"9183","chr8",41895822,41897732,41896777,1910
"9184","chr1",21176622,21177343,21176982,721
"9185","chr16",1157042,1157948,1157495,906
"9186","chr11",66842895,66843796,66843345,901
"9187","chr1",9495320,9495593,9495456,273
"9188","chr5",160418989,160419253,160419121,264
"9189","chr3",185823260,185826358,185824809,3098
"9190","chr17",68599977,68601437,68600707,1460
"9191","chrX",136496842,136497940,136497391,1098
"9192","chr1",152107521,152112739,152110130,5218
"9193","chr10",133047670,133048064,133047867,394
"9194","chr12",25250332,25251577,25250954,1245
"9195","chr2",202032663,202036149,202034406,3486
"9196","chr1",113811751,113812678,113812214,927
"9197","chr1",2411946,2413278,2412612,1332
"9198","chrX",100406655,100411383,100409019,4728
"9199","chr5",140807207,140807683,140807445,476
"9200","chr3",10358697,10358902,10358799,205
"9201","chr10",43436510,43437224,43436867,714
"9202","chr22",40950632,40951755,40951193,1123
"9203","chr4",99946171,99947005,99946588,834
"9204","chr12",123269502,123269826,123269664,324
"9205","chr8",96144535,96145747,96145141,1212
"9206","chr6",159800114,159800461,159800287,347
"9207","chr16",1006845,1007053,1006949,208
"9208","chrX",47482488,47483298,47482893,810
"9209","chr4",184733351,184734361,184733856,1010
"9210","chr12",121712742,121713185,121712963,443
"9211","chrX",74536395,74536949,74536672,554
"9212","chr5",133611053,133612776,133611914,1723
"9213","chr10",128149464,128150835,128150149,1371
"9214","chr16",67537507,67538825,67538166,1318
"9215","chr16",10941639,10942839,10942239,1200
"9216","chr19",49513274,49513594,49513434,320
"9217","chr3",8501515,8501893,8501704,378
"9218","chr2",199461948,199464958,199463453,3010
"9219","chr20",52191259,52192286,52191772,1027
"9220","chr6",105981236,105981897,105981566,661
"9221","chr3",79018913,79019416,79019164,503
"9222","chr19",612989,614016,613502,1027
"9223","chr6",156396937,156397413,156397175,476
"9224","chr2",496823,497038,496930,215
"9225","chr17",48107474,48107812,48107643,338
"9226","chr11",67443648,67443853,67443750,205
"9227","chr6",111259160,111259591,111259375,431
"9228","chr7",33129062,33129631,33129346,569
"9229","chr3",51715738,51716045,51715891,307
"9230","chr1",6148656,6148979,6148817,323
"9231","chr13",113974174,113974478,113974326,304
"9232","chr3",126982529,126984441,126983485,1912
"9233","chr12",131928793,131930256,131929524,1463
"9234","chr19",41844612,41845294,41844953,682
"9235","chr2",74529096,74530803,74529949,1707
"9236","chr7",134986368,134986999,134986683,631
"9237","chr11",117518471,117518756,117518613,285
"9238","chrX",151082405,151082730,151082567,325
"9239","chr4",24470077,24473306,24471691,3229
"9240","chr6",31901004,31902308,31901656,1304
"9241","chr10",68720947,68721841,68721394,894
"9242","chr12",104303570,104304206,104303888,636
"9243","chr4",116599275,116599564,116599419,289
"9244","chr4",14862884,14863177,14863030,293
"9245","chr16",89200983,89202457,89201720,1474
"9246","chr5",134371329,134372201,134371765,872
"9247","chr19",12294511,12294756,12294633,245
"9248","chr17",63773324,63774702,63774013,1378
"9249","chr16",29613066,29614070,29613568,1004
"9250","chr17",39596570,39596994,39596782,424
"9251","chr1",3690532,3690989,3690760,457
"9252","chr16",70380526,70381962,70381244,1436
"9253","chr20",59604753,59605732,59605242,979
"9254","chr3",132417129,132417775,132417452,646
"9255","chr11",19345106,19345799,19345452,693
"9256","chr3",49723430,49724462,49723946,1032
"9257","chr7",23473915,23474793,23474354,878
"9258","chr11",85854865,85855408,85855136,543
"9259","chr7",1845397,1845766,1845581,369
"9260","chr17",75666919,75667548,75667233,629
"9261","chr5",77958008,77958225,77958116,217
"9262","chr5",31193845,31194312,31194078,467
"9263","chr5",141478297,141478498,141478397,201
"9264","chr2",68251763,68252908,68252335,1145
"9265","chr3",172710626,172711160,172710893,534
"9266","chr3",155870220,155871813,155871016,1593
"9267","chr12",114400507,114401084,114400795,577
"9268","chr6",158536188,158537645,158536916,1457
"9269","chr6",111482353,111484306,111483329,1953
"9270","chr13",48975686,48976906,48976296,1220
"9271","chr17",76007098,76009413,76008255,2315
"9272","chr5",76174143,76174348,76174245,205
"9273","chr13",113633218,113633501,113633359,283
"9274","chr6",133891552,133891960,133891756,408
"9275","chr16",53373415,53373842,53373628,427
"9276","chr2",241677405,241677679,241677542,274
"9277","chr16",47460786,47461296,47461041,510
"9278","chr19",10353990,10354251,10354120,261
"9279","chr10",60943549,60944532,60944040,983
"9280","chr1",54542031,54542775,54542403,744
"9281","chr19",3938288,3938549,3938418,261
"9282","chr18",37566074,37567665,37566869,1591
"9283","chr5",177472787,177473635,177473211,848
"9284","chr3",158105184,158106047,158105615,863
"9285","chr6",26045416,26045805,26045610,389
"9286","chr17",81135898,81136111,81136004,213
"9287","chr2",213152026,213152381,213152203,355
"9288","chr10",104639809,104643054,104641431,3245
"9289","chr19",54461245,54461558,54461401,313
"9290","chr16",2428685,2429967,2429326,1282
"9291","chr6",150057702,150057912,150057807,210
"9292","chr5",172454131,172454814,172454472,683
"9293","chr3",44976018,44976644,44976331,626
"9294","chr2",136116516,136118454,136117485,1938
"9295","chr19",19618318,19619005,19618661,687
"9296","chr2",174729790,174730527,174730158,737
"9297","chr6",149749377,149750149,149749763,772
"9298","chr16",25691634,25693310,25692472,1676
"9299","chr3",66220650,66221292,66220971,642
"9300","chr14",93938889,93939824,93939356,935
"9301","chr19",37719206,37719791,37719498,585
"9302","chr22",19788673,19788931,19788802,258
"9303","chr6",93416554,93417813,93417183,1259
"9304","chrX",76029493,76029793,76029643,300
"9305","chr22",50165986,50166693,50166339,707
"9306","chr12",65729008,65729548,65729278,540
"9307","chr19",9854268,9854757,9854512,489
"9308","chr2",95526307,95527324,95526815,1017
"9309","chr8",117520616,117521072,117520844,456
"9310","chr5",76170779,76171092,76170935,313
"9311","chr16",88891852,88892150,88892001,298
"9312","chr20",57110281,57110776,57110528,495
"9313","chr5",172770479,172772603,172771541,2124
"9314","chr11",126062187,126063108,126062647,921
"9315","chr17",46260035,46260560,46260297,525
"9316","chr20",25584801,25585604,25585202,803
"9317","chr11",472781,473065,472923,284
"9318","chr18",79576081,79576282,79576181,201
"9319","chr6",26538268,26538787,26538527,519
"9320","chr19",10095948,10096675,10096311,727
"9321","chr10",35639382,35642965,35641173,3583
"9322","chr10",103396063,103396727,103396395,664
"9323","chr4",107035398,107036288,107035843,890
"9324","chr1",27568416,27569013,27568714,597
"9325","chr5",179023629,179024215,179023922,586
"9326","chr5",159096898,159097590,159097244,692
"9327","chr16",67935387,67936515,67935951,1128
"9328","chr5",132410533,132411184,132410858,651
"9329","chr7",6374303,6375089,6374696,786
"9330","chr10",11742015,11742938,11742476,923
"9331","chr16",234479,235396,234937,917
"9332","chr4",155953588,155953931,155953759,343
"9333","chr17",49996686,49997250,49996968,564
"9334","chr2",96115667,96117187,96116427,1520
"9335","chr4",48269345,48269812,48269578,467
"9336","chr17",49971589,49973252,49972420,1663
"9337","chr1",8878254,8879287,8878770,1033
"9338","chr1",203075594,203076262,203075928,668
"9339","chr1",40665439,40665816,40665627,377
"9340","chr16",679438,685815,682626,6377
"9341","chr18",11750954,11752757,11751855,1803
"9342","chr10",132065501,132065751,132065626,250
"9343","chr6",132814225,132814690,132814457,465
"9344","chr2",202376644,202377695,202377169,1051
"9345","chr11",61752269,61752882,61752575,613
"9346","chrX",8801136,8801518,8801327,382
"9347","chr6",109482891,109483289,109483090,398
"9348","chr2",99593685,99594029,99593857,344
"9349","chr4",140755766,140757016,140756391,1250
"9350","chr16",899658,899960,899809,302
"9351","chr4",3746497,3746854,3746675,357
"9352","chr19",7873447,7874894,7874170,1447
"9353","chr12",40692720,40693300,40693010,580
"9354","chrX",7147652,7148447,7148049,795
"9355","chr7",157784993,157785250,157785121,257
"9356","chr4",15778375,15779106,15778740,731
"9357","chr17",5468528,5468998,5468763,470
"9358","chr15",41230630,41231534,41231082,904
"9359","chr17",1491145,1492078,1491611,933
"9360","chr19",3556964,3558295,3557629,1331
"9361","chr8",56157128,56157488,56157308,360
"9362","chr2",127885526,127886833,127886179,1307
"9363","chr4",5887476,5888918,5888197,1442
"9364","chr5",1463228,1463736,1463482,508
"9365","chr15",89628434,89628673,89628553,239
"9366","chr4",535377,535767,535572,390
"9367","chr4",108171422,108171683,108171552,261
"9368","chrX",51894734,51894980,51894857,246
"9369","chr8",141173333,141173668,141173500,335
"9370","chr17",82000212,82000493,82000352,281
"9371","chr8",11769582,11770159,11769870,577
"9372","chr12",93570187,93573619,93571903,3432
"9373","chr10",133083186,133083647,133083416,461
"9374","chr17",47850845,47851344,47851094,499
"9375","chr16",49876298,49876952,49876625,654
"9376","chr8",12754053,12756053,12755053,2000
"9377","chr11",430814,431775,431294,961
"9378","chr16",85750256,85751525,85750890,1269
"9379","chr19",41363768,41364228,41363998,460
"9380","chr7",35253374,35255063,35254218,1689
"9381","chr19",11435127,11435723,11435425,596
"9382","chr4",76420857,76421554,76421205,697
"9383","chr2",161244928,161245204,161245066,276
"9384","chr16",3254351,3254696,3254523,345
"9385","chr11",64723134,64723674,64723404,540
"9386","chr4",53304,53778,53541,474
"9387","chr12",57752070,57752577,57752323,507
"9388","chr1",28643041,28643386,28643213,345
"9389","chrY",9907950,9908384,9908167,434
"9390","chr8",22599610,22600240,22599925,630
"9391","chr22",41998585,41999251,41998918,666
"9392","chr20",32018689,32019060,32018874,371
"9393","chr6",170280323,170280660,170280491,337
"9394","chr5",151531591,151531940,151531765,349
"9395","chr7",27156146,27156948,27156547,802
"9396","chr7",72942710,72943254,72942982,544
"9397","chr20",63562613,63567632,63565122,5019
"9398","chr4",118278465,118279038,118278751,573
"9399","chr5",1088128,1088349,1088238,221
"9400","chr16",1445038,1445365,1445201,327
"9401","chr5",33501949,33502258,33502103,309
"9402","chr6",106973340,106975878,106974609,2538
"9403","chr5",13810017,13810224,13810120,207
"9404","chr10",78303023,78303831,78303427,808
"9405","chr7",159005900,159006743,159006321,843
"9406","chr7",140696614,140697484,140697049,870
"9407","chr7",2146136,2146570,2146353,434
"9408","chr5",111092079,111092572,111092325,493
"9409","chr8",131040003,131042503,131041253,2500
"9410","chr7",149294564,149295090,149294827,526
"9411","chr17",45490247,45491005,45490626,758
"9412","chr6",151807687,151808636,151808161,949
"9413","chr7",156063336,156063655,156063495,319
"9414","chr18",34976690,34976945,34976817,255
"9415","chr8",1006288,1007205,1006746,917
"9416","chr16",77194440,77194752,77194596,312
"9417","chr10",21508703,21510412,21509557,1709
"9418","chr2",18584479,18584914,18584696,435
"9419","chr16",324732,325328,325030,596
"9420","chr12",81758541,81758895,81758718,354
"9421","chr17",82450444,82450940,82450692,496
"9422","chr18",74456371,74457482,74456926,1111
"9423","chr6",134174801,134175820,134175310,1019
"9424","chr13",63844301,63844546,63844423,245
"9425","chr11",61827524,61829238,61828381,1714
"9426","chr5",181195178,181195658,181195418,480
"9427","chr12",117155548,117155894,117155721,346
"9428","chr10",117541810,117545857,117543833,4047
"9429","chr16",15094078,15094472,15094275,394
"9430","chr12",70242837,70243969,70243403,1132
"9431","chr17",42659214,42659579,42659396,365
"9432","chr13",45464818,45465546,45465182,728
"9433","chrX",68498621,68499229,68498925,608
"9434","chr7",27245020,27246618,27245819,1598
"9435","chr10",131937895,131938130,131938012,235
"9436","chr5",147234720,147235081,147234900,361
"9437","chr4",118685322,118685655,118685488,333
"9438","chr7",96321467,96322324,96321895,857
"9439","chr12",49967584,49967869,49967726,285
"9440","chr16",32202221,32202961,32202591,740
"9441","chr5",154857448,154858802,154858125,1354
"9442","chr17",45169472,45169800,45169636,328
"9443","chr6",88165678,88167730,88166704,2052
"9444","chr22",36505977,36507251,36506614,1274
"9445","chr7",27251500,27252578,27252039,1078
"9446","chr12",991358,991619,991488,261
"9447","chr16",4740461,4740674,4740567,213
"9448","chr2",24084156,24084808,24084482,652
"9449","chr2",237626918,237628197,237627557,1279
"9450","chr12",101209609,101210155,101209882,546
"9451","chr15",40936244,40936674,40936459,430
"9452","chr9",133375435,133376678,133376056,1243
"9453","chr5",172055569,172055773,172055671,204
"9454","chr15",72796791,72797204,72796997,413
"9455","chr16",31537302,31537863,31537582,561
"9456","chrX",21940493,21941583,21941038,1090
"9457","chr1",241519173,241519812,241519492,639
"9458","chr2",127857905,127858430,127858167,525
"9459","chr11",49558380,49558727,49558553,347
"9460","chr21",39385676,39385974,39385825,298
"9461","chr22",49784072,49784573,49784322,501
"9462","chr1",89763185,89763614,89763399,429
"9463","chr11",69702163,69705161,69703662,2998
"9464","chr5",191677,192429,192053,752
"9465","chr22",30694213,30695347,30694780,1134
"9466","chr12",47079394,47080337,47079865,943
"9467","chr14",58151573,58152502,58152037,929
"9468","chr10",22003045,22003968,22003506,923
"9469","chr17",8189100,8190388,8189744,1288
"9470","chr17",47649307,47650856,47650081,1549
"9471","chr4",119212409,119213134,119212771,725
"9472","chr16",8953539,8954218,8953878,679
"9473","chr2",42047290,42048866,42048078,1576
"9474","chr21",41819995,41820230,41820112,235
"9475","chr5",138575244,138575948,138575596,704
"9476","chr3",160564717,160566086,160565401,1369
"9477","chr6",26204536,26204985,26204760,449
"9478","chr7",155787129,155787698,155787413,569
"9479","chr22",46149577,46151509,46150543,1932
"9480","chr5",181203981,181205569,181204775,1588
"9481","chr12",104756984,104757219,104757101,235
"9482","chr9",129675645,129675877,129675761,232
"9483","chr16",86554829,86555332,86555080,503
"9484","chr6",26613785,26614484,26614134,699
"9485","chr8",19313488,19314545,19314016,1057
"9486","chr1",226121258,226122775,226122016,1517
"9487","chrX",102599347,102599599,102599473,252
"9488","chr14",22886529,22887193,22886861,664
"9489","chr11",13962519,13964802,13963660,2283
"9490","chr16",1152414,1154624,1153519,2210
"9491","chr8",18083790,18084950,18084370,1160
"9492","chr4",186435822,186436079,186435950,257
"9493","chr16",1078223,1080394,1079308,2171
"9494","chr15",98647217,98651330,98649273,4113
"9495","chr16",3965000,3965231,3965115,231
"9496","chr5",6582769,6583694,6583231,925
"9497","chr21",36385198,36385815,36385506,617
"9498","chr10",92239374,92240244,92239809,870
"9499","chr6",125301558,125301971,125301764,413
"9500","chr20",62200686,62201096,62200891,410
"9501","chr11",64304760,64306442,64305601,1682
"9502","chr22",31630311,31630888,31630599,577
"9503","chr16",25066726,25067211,25066968,485
"9504","chr16",1070153,1070441,1070297,288
"9505","chr6",116279407,116280011,116279709,604
"9506","chr3",100400660,100402013,100401336,1353
"9507","chr5",79689601,79689959,79689780,358
"9508","chr16",85611341,85615421,85613381,4080
"9509","chr7",889658,890376,890017,718
"9510","chr19",14471607,14474286,14472946,2679
"9511","chr4",107989614,107990214,107989914,600
"9512","chr16",88655109,88655658,88655383,549
"9513","chr10",133077506,133079898,133078702,2392
"9514","chr21",46297313,46298145,46297729,832
"9515","chr10",99232375,99232930,99232652,555
"9516","chrX",48597554,48598206,48597880,652
"9517","chr2",105143856,105144560,105144208,704
"9518","chr2",152717229,152719039,152718134,1810
"9519","chr16",87668887,87669098,87668992,211
"9520","chr8",66505353,66505641,66505497,288
"9521","chr1",222589679,222589928,222589803,249
"9522","chr5",174311900,174312531,174312215,631
"9523","chr17",8435684,8436642,8436163,958
"9524","chr6",109978162,109980064,109979113,1902
"9525","chr3",46750371,46751028,46750699,657
"9526","chr15",24675466,24676105,24675785,639
"9527","chr4",1240084,1240632,1240358,548
"9528","chr6",105986109,105986584,105986346,475
"9529","chr19",5290392,5290594,5290493,202
"9530","chr17",9020850,9023603,9022226,2753
"9531","chr10",134642,136512,135577,1870
"9532","chr16",73057615,73058999,73058307,1384
"9533","chrX",109536825,109537184,109537004,359
"9534","chrX",104565113,104565486,104565299,373
"9535","chr4",3876351,3876554,3876452,203
"9536","chr13",24894939,24895250,24895094,311
"9537","chr19",836533,836899,836716,366
"9538","chr1",43358463,43359388,43358925,925
"9539","chr22",36028171,36029255,36028713,1084
"9540","chr7",29563493,29563712,29563602,219
"9541","chr5",149581234,149581640,149581437,406
"9542","chr10",1340305,1340811,1340558,506
"9543","chrX",40151776,40156950,40154363,5174
"9544","chr16",2682271,2682939,2682605,668
"9545","chr17",79735070,79735415,79735242,345
"9546","chr16",69132022,69133005,69132513,983
"9547","chr20",38434882,38435463,38435172,581
"9548","chr2",239124504,239125040,239124772,536
"9549","chr3",45224985,45226547,45225766,1562
"9550","chr7",6483433,6484266,6483849,833
"9551","chr12",10673932,10674187,10674059,255
"9552","chr15",63121719,63122439,63122079,720
"9553","chr15",41402295,41402558,41402426,263
"9554","chr17",28318834,28319579,28319206,745
"9555","chr16",10627550,10627790,10627670,240
"9556","chr17",73231921,73232935,73232428,1014
"9557","chr21",36695893,36701591,36698742,5698
"9558","chr2",231056699,231057258,231056978,559
"9559","chr15",99100389,99100823,99100606,434
"9560","chr11",1309160,1310268,1309714,1108
"9561","chr2",27049978,27052085,27051031,2107
"9562","chr1",201888786,201889178,201888982,392
"9563","chr5",140862488,140863422,140862955,934
"9564","chr17",16380613,16381454,16381033,841
"9565","chr2",105744575,105745761,105745168,1186
"9566","chr10",70672486,70672982,70672734,496
"9567","chr17",77140243,77141648,77140945,1405
"9568","chr1",2303869,2304228,2304048,359
"9569","chr13",40922451,40922670,40922560,219
"9570","chr5",177086650,177087432,177087041,782
"9571","chrX",155216243,155216492,155216367,249
"9572","chr22",26169468,26170020,26169744,552
"9573","chr7",102457480,102457937,102457708,457
"9574","chr10",130136574,130137060,130136817,486
"9575","chr16",70663671,70664460,70664065,789
"9576","chr2",2650336,2650586,2650461,250
"9577","chr17",82806750,82806966,82806858,216
"9578","chr1",111203691,111204681,111204186,990
"9579","chr15",34988316,34988636,34988476,320
"9580","chr5",177266339,177266630,177266484,291
"9581","chr5",135191237,135191729,135191483,492
"9582","chr2",97663477,97664408,97663942,931
"9583","chr3",149970090,149971750,149970920,1660
"9584","chrX",110795718,110796142,110795930,424
"9585","chr6",98827887,98828162,98828024,275
"9586","chr13",48303323,48304365,48303844,1042
"9587","chr17",81487708,81488797,81488252,1089
"9588","chr2",44361815,44362219,44362017,404
"9589","chr5",180618789,180621897,180620343,3108
"9590","chr3",71784917,71785502,71785209,585
"9591","chr9",125189112,125189984,125189548,872
"9592","chr1",214602913,214603592,214603252,679
"9593","chr14",31457054,31457604,31457329,550
"9594","chr8",56073997,56074749,56074373,752
"9595","chr3",32106334,32107382,32106858,1048
"9596","chr2",47782669,47784304,47783486,1635
"9597","chrX",152994008,152994298,152994153,290
"9598","chr17",43645851,43646458,43646154,607
"9599","chr6",31271075,31272343,31271709,1268
"9600","chr14",73591696,73592412,73592054,716
"9601","chr9",95729107,95729415,95729261,308
"9602","chr16",65120753,65123761,65122257,3008
"9603","chr7",26398107,26399095,26398601,988
"9604","chr20",62206136,62206437,62206286,301
"9605","chr21",46435979,46436230,46436104,251
"9606","chr16",1448348,1448609,1448478,261
"9607","chr16",71723046,71724263,71723654,1217
"9608","chr19",50333133,50334190,50333661,1057
"9609","chr3",39383205,39384567,39383886,1362
"9610","chr8",27633894,27634258,27634076,364
"9611","chr8",1163058,1164073,1163565,1015
"9612","chr7",100889108,100890536,100889822,1428
"9613","chr20",17225883,17226307,17226095,424
"9614","chrX",153723419,153726264,153724841,2845
"9615","chr10",102450338,102451228,102450783,890
"9616","chr4",2933734,2935247,2934490,1513
"9617","chr10",128710103,128710394,128710248,291
"9618","chrX",119791194,119792166,119791680,972
"9619","chr13",89363158,89363521,89363339,363
"9620","chr6",41072242,41073940,41073091,1698
"9621","chr2",61853757,61854228,61853992,471
"9622","chr10",126905040,126906479,126905759,1439
"9623","chr21",36319910,36320761,36320335,851
"9624","chr21",33324227,33325445,33324836,1218
"9625","chr7",128915275,128916596,128915935,1321
"9626","chr20",63687006,63687305,63687155,299
"9627","chr6",166008403,166008753,166008578,350
"9628","chr9",113275269,113275949,113275609,680
"9629","chr16",89111373,89111596,89111484,223
"9630","chr15",65422404,65423233,65422818,829
"9631","chr3",129121091,129122524,129121807,1433
"9632","chr6",537144,537522,537333,378
"9633","chr12",88579683,88580889,88580286,1206
"9634","chr5",134904564,134905624,134905094,1060
"9635","chr3",46979365,46979789,46979577,424
"9636","chr12",110403216,110403743,110403479,527
"9637","chr6",105994111,105995037,105994574,926
"9638","chr5",1282534,1283129,1282831,595
"9639","chr16",88186415,88186935,88186675,520
"9640","chr7",1368880,1369671,1369275,791
"9641","chr5",154473496,154473991,154473743,495
"9642","chr15",90067523,90068374,90067948,851
"9643","chr8",127315642,127315893,127315767,251
"9644","chr1",3411427,3412860,3412143,1433
"9645","chr8",143185912,143186407,143186159,495
"9646","chr20",63215491,63215705,63215598,214
"9647","chr16",53703705,53704323,53704014,618
"9648","chr18",26090007,26091311,26090659,1304
"9649","chr18",33440546,33440883,33440714,337
"9650","chr20",47238910,47239367,47239138,457
"9651","chr1",62318465,62319462,62318963,997
"9652","chr10",73674603,73674826,73674714,223
"9653","chr3",13878260,13880838,13879549,2578
"9654","chrX",133413539,133416256,133414897,2717
"9655","chr12",52903565,52904040,52903802,475
"9656","chr7",98210550,98212693,98211621,2143
"9657","chr1",32275109,32275943,32275526,834
"9658","chr8",134463975,134466776,134465375,2801
"9659","chr15",31453263,31453548,31453405,285
"9660","chr2",1489880,1490467,1490173,587
"9661","chr10",43702854,43703129,43702991,275
"9662","chr11",110295839,110297034,110296436,1195
"9663","chr12",64759089,64759709,64759399,620
"9664","chr5",10441493,10442400,10441946,907
"9665","chr4",1644159,1644597,1644378,438
"9666","chr15",56243453,56244052,56243752,599
"9667","chrX",23907473,23908198,23907835,725
"9668","chr17",74325809,74326322,74326065,513
"9669","chr17",11557754,11558120,11557937,366
"9670","chr17",1012345,1012739,1012542,394
"9671","chr4",625724,626123,625923,399
"9672","chr22",48745237,48745549,48745393,312
"9673","chr13",112194261,112194907,112194584,646
"9674","chr8",94894560,94896860,94895710,2300
"9675","chr15",48962787,48963367,48963077,580
"9676","chr20",63239429,63239826,63239627,397
"9677","chr17",82928987,82929514,82929250,527
"9678","chr17",44314955,44315711,44315333,756
"9679","chr21",37257751,37258206,37257978,455
"9680","chr7",73682796,73683850,73683323,1054
"9681","chr18",35949965,35950553,35950259,588
"9682","chr10",123132750,123133821,123133285,1071
"9683","chr5",131170637,131171093,131170865,456
"9684","chr5",143402506,143405506,143404006,3000
"9685","chr12",27970090,27970840,27970465,750
"9686","chr8",10404390,10404712,10404551,322
"9687","chr13",94705335,94705629,94705482,294
"9688","chr9",132989670,132989877,132989773,207
"9689","chr17",31858745,31859561,31859153,816
"9690","chr9",37784752,37785348,37785050,596
"9691","chr15",74995353,74996358,74995855,1005
"9692","chr7",55254469,55255860,55255164,1391
"9693","chr17",946967,947260,947113,293
"9694","chr20",1325255,1325910,1325582,655
"9695","chr16",67226841,67227252,67227046,411
"9696","chr1",40783418,40784489,40783953,1071
"9697","chr4",74098939,74099562,74099250,623
"9698","chr15",90884209,90884619,90884414,410
"9699","chr11",71435396,71435816,71435606,420
"9700","chr3",147424394,147424604,147424499,210
"9701","chr1",109493923,109494321,109494122,398
"9702","chr6",56432370,56432596,56432483,226
"9703","chr16",89074101,89074717,89074409,616
"9704","chr17",67717652,67718152,67717902,500
"9705","chr10",102230456,102232072,102231264,1616
"9706","chr8",93916290,93917664,93916977,1374
"9707","chr2",239066754,239067014,239066884,260
"9708","chr1",65525318,65526128,65525723,810
"9709","chr6",138987361,138988422,138987891,1061
"9710","chr12",122266222,122266681,122266451,459
"9711","chr7",1619404,1620209,1619806,805
"9712","chr1",21622181,21622770,21622475,589
"9713","chr15",63048057,63049265,63048661,1208
"9714","chr6",45377521,45378524,45378022,1003
"9715","chr5",79513524,79514645,79514084,1121
"9716","chr5",179120420,179121700,179121060,1280
"9717","chr22",45007008,45010491,45008749,3483
"9718","chr16",27203451,27204357,27203904,906
"9719","chr10",1163374,1163581,1163477,207
"9720","chr8",97624466,97624676,97624571,210
"9721","chr15",98548126,98548583,98548354,457
"9722","chr12",121274043,121274359,121274201,316
"9723","chr16",89999909,90000235,90000072,326
"9724","chr20",64042439,64043098,64042768,659
"9725","chr7",5500326,5501936,5501131,1610
"9726","chr12",4538678,4538887,4538782,209
"9727","chr10",27413439,27414189,27413814,750
"9728","chr13",49847963,49848165,49848064,202
"9729","chr4",169757793,169758104,169757948,311
"9730","chr12",107685665,107686116,107685890,451
"9731","chr9",129641593,129642464,129642028,871
"9732","chr5",178940619,178941724,178941171,1105
"9733","chr20",62658564,62658871,62658717,307
"9734","chr12",58919778,58920671,58920224,893
"9735","chr8",144526571,144530942,144528756,4371
"9736","chr4",824858,827107,825982,2249
"9737","chr5",141361607,141362171,141361889,564
"9738","chr20",59300262,59301071,59300666,809
"9739","chr22",49886391,49886728,49886559,337
"9740","chr3",122564155,122564747,122564451,592
"9741","chr1",155135531,155136135,155135833,604
"9742","chr2",218391226,218391487,218391356,261
"9743","chr5",271412,272370,271891,958
"9744","chr13",111519885,111520094,111519989,209
"9745","chr17",76500910,76501550,76501230,640
"9746","chr7",65770334,65770893,65770613,559
"9747","chr5",176194330,176195030,176194680,700
"9748","chr1",220046074,220046719,220046396,645
"9749","chr5",141224881,141225732,141225306,851
"9750","chr6",35259120,35260074,35259597,954
"9751","chr19",2273694,2274048,2273871,354
"9752","chr16",14070992,14071799,14071395,807
"9753","chr15",72197137,72197775,72197456,638
"9754","chr7",158556695,158557399,158557047,704
"9755","chr16",29815341,29816942,29816141,1601
"9756","chr2",56183730,56185404,56184567,1674
"9757","chr19",43718706,43719791,43719248,1085
"9758","chr20",45487365,45487687,45487526,322
"9759","chr3",185282769,185283108,185282938,339
"9760","chr11",77066522,77067406,77066964,884
"9761","chr8",56112987,56113984,56113485,997
"9762","chr18",79433463,79433764,79433613,301
"9763","chr9",122264536,122264971,122264753,435
"9764","chr9",86945669,86947732,86946700,2063
"9765","chr7",157527768,157527975,157527871,207
"9766","chr20",64062589,64063929,64063259,1340
"9767","chr20",58839540,58839841,58839690,301
"9768","chr10",62814900,62818923,62816911,4023
"9769","chr5",180970288,180970563,180970425,275
"9770","chr16",4846605,4848242,4847423,1637
"9771","chr13",37059258,37059829,37059543,571
"9772","chr15",59689035,59689596,59689315,561
"9773","chr5",127517601,127518233,127517917,632
"9774","chr8",143159441,143160696,143160068,1255
"9775","chr3",197027755,197027960,197027857,205
"9776","chr18",79548074,79548815,79548444,741
"9777","chr5",96433170,96433376,96433273,206
"9778","chr5",122311755,122312452,122312103,697
"9779","chr2",120741652,120742002,120741827,350
"9780","chr15",82262444,82263135,82262789,691
"9781","chr12",113153001,113153499,113153250,498
"9782","chr14",23047895,23048532,23048213,637
"9783","chr7",157422307,157422554,157422430,247
"9784","chr7",158488681,158489042,158488861,361
"9785","chr8",108082627,108083621,108083124,994
"9786","chr22",19121555,19122816,19122185,1261
"9787","chr13",112702385,112702815,112702600,430
"9788","chr3",127014125,127014577,127014351,452
"9789","chr17",74935634,74936506,74936070,872
"9790","chr21",37667474,37667692,37667583,218
"9791","chr9",95505926,95511216,95508571,5290
"9792","chr15",74614597,74616197,74615397,1600
"9793","chr17",1516148,1517140,1516644,992
"9794","chr15",78810373,78812286,78811329,1913
"9795","chr17",42964332,42964534,42964433,202
"9796","chr16",4652627,4652850,4652738,223
"9797","chrY",11979296,11979887,11979591,591
"9798","chr12",6470389,6471263,6470826,874
"9799","chr20",52152456,52152669,52152562,213
"9800","chr12",94873056,94874009,94873532,953
"9801","chr13",20136786,20137119,20136952,333
"9802","chr16",787376,789341,788358,1965
"9803","chr7",155509558,155510463,155510010,905
"9804","chr17",63437391,63438025,63437708,634
"9805","chr20",41316954,41317979,41317466,1025
"9806","chr13",113638236,113638571,113638403,335
"9807","chr17",10197717,10199123,10198420,1406
"9808","chrX",153885562,153886765,153886163,1203
"9809","chr6",33213233,33213479,33213356,246
"9810","chr17",7022081,7024208,7023144,2127
"9811","chr3",197498760,197499279,197499019,519
"9812","chr6",21666208,21666631,21666419,423
"9813","chr8",140634742,140636415,140635578,1673
"9814","chr20",36950934,36952048,36951491,1114
"9815","chr19",14057330,14057700,14057515,370
"9816","chr5",177400080,177400753,177400416,673
"9817","chr13",110712371,110716183,110714277,3812
"9818","chr4",2962732,2964287,2963509,1555
"9819","chr5",9544580,9546069,9545324,1489
"9820","chr6",26033246,26033559,26033402,313
"9821","chr2",70871607,70871878,70871742,271
"9822","chr16",31475831,31477646,31476738,1815
"9823","chr10",43229080,43230165,43229622,1085
"9824","chr5",88889407,88889772,88889589,365
"9825","chr6",24645703,24646363,24646033,660
"9826","chr8",28385400,28386766,28386083,1366
"9827","chr22",45309630,45310735,45310182,1105
"9828","chr15",88604429,88605967,88605198,1538
"9829","chr19",12833972,12834485,12834228,513
"9830","chr1",245685237,245685801,245685519,564
"9831","chr10",70052562,70053937,70053249,1375
"9832","chr7",151166879,151168424,151167651,1545
"9833","chr19",3505822,3506772,3506297,950
"9834","chr7",100965711,100965955,100965833,244
"9835","chr16",2284107,2284346,2284226,239
"9836","chr16",2715618,2715854,2715736,236
"9837","chr7",27199071,27200692,27199881,1621
"9838","chr17",47840728,47841408,47841068,680
"9839","chrX",114390497,114390700,114390598,203
"9840","chr11",86244766,86245475,86245120,709
"9841","chr7",66505035,66506434,66505734,1399
"9842","chr13",21140150,21140976,21140563,826
"9843","chr1",609358,611269,610313,1911
"9844","chr16",84656826,84657893,84657359,1067
"9845","chr15",45377772,45378831,45378301,1059
"9846","chr6",27132395,27133345,27132870,950
"9847","chr13",112467315,112467550,112467432,235
"9848","chr19",42273084,42273598,42273341,514
"9849","chr11",617226,617797,617511,571
"9850","chr7",48454764,48455156,48454960,392
"9851","chr7",1474139,1474416,1474277,277
"9852","chr1",46247243,46247773,46247508,530
"9853","chr5",115625632,115626272,115625952,640
"9854","chr21",26965537,26967918,26966727,2381
"9855","chr15",25989450,25989780,25989615,330
"9856","chr1",143497155,143498908,143498031,1753
"9857","chr11",70717559,70717781,70717670,222
"9858","chr5",37370844,37371150,37370997,306
"9859","chr10",133229717,133231488,133230602,1771
"9860","chr17",79860264,79860569,79860416,305
"9861","chr17",58249324,58249901,58249612,577
"9862","chr10",104254773,104255329,104255051,556
"9863","chr1",2934100,2934308,2934204,208
"9864","chr2",235042808,235043170,235042989,362
"9865","chr17",48592072,48592449,48592260,377
"9866","chr4",73069227,73069933,73069580,706
"9867","chr19",17687870,17688520,17688195,650
"9868","chr17",12789420,12790373,12789896,953
"9869","chr10",132919097,132920273,132919685,1176
"9870","chr12",42482852,42484391,42483621,1539
"9871","chr19",15440038,15440248,15440143,210
"9872","chr1",165117519,165117789,165117654,270
"9873","chr1",178037695,178038149,178037922,454
"9874","chr1",3907655,3907892,3907773,237
"9875","chr22",19447274,19448033,19447653,759
"9876","chr6",157322972,157324185,157323578,1213
"9877","chr18",35376800,35377442,35377121,642
"9878","chr12",69239492,69240315,69239903,823
"9879","chr16",89587010,89588284,89587647,1274
"9880","chr19",58183134,58183740,58183437,606
"9881","chr17",42107503,42107959,42107731,456
"9882","chr15",100918081,100920018,100919049,1937
"9883","chr7",2049958,2050246,2050102,288
"9884","chr10",133179617,133179820,133179718,203
"9885","chrX",51332628,51333479,51333053,851
"9886","chr1",36397610,36398002,36397806,392
"9887","chr17",62703780,62704573,62704176,793
"9888","chr6",31308464,31308749,31308606,285
"9889","chr11",123654025,123654977,123654501,952
"9890","chr1",34761427,34761675,34761551,248
"9891","chr1",1090997,1091245,1091121,248
"9892","chr17",80941762,80942082,80941922,320
"9893","chr15",78872925,78873715,78873320,790
"9894","chr13",31952745,31953236,31952990,491
"9895","chr2",31233874,31234787,31234330,913
"9896","chr12",77065167,77066162,77065664,995
"9897","chr5",3592277,3592530,3592403,253
"9898","chr14",54396705,54397536,54397120,831
"9899","chr1",43991478,43992100,43991789,622
"9900","chr15",43746314,43746924,43746619,610
"9901","chr12",125065126,125065765,125065445,639
"9902","chr17",18314507,18315742,18315124,1235
"9903","chr9",69759492,69760187,69759839,695
"9904","chr15",43185318,43185618,43185468,300
"9905","chr4",71186526,71187752,71187139,1226
"9906","chr22",50026379,50026580,50026479,201
"9907","chr14",60721398,60724054,60722726,2656
"9908","chrX",13569529,13570102,13569815,573
"9909","chr7",27087881,27088749,27088315,868
"9910","chr22",19148780,19150999,19149889,2219
"9911","chr1",42681829,42683345,42682587,1516
"9912","chr2",131491877,131493402,131492639,1525
"9913","chr7",148339402,148339756,148339579,354
"9914","chr17",38351739,38353056,38352397,1317
"9915","chr2",179861145,179861738,179861441,593
"9916","chr10",101779081,101780231,101779656,1150
"9917","chr1",41361008,41362618,41361813,1610
"9918","chr6",44245958,44247970,44246964,2012
"9919","chr22",28800094,28800974,28800534,880
"9920","chr6",3226791,3229454,3228122,2663
"9921","chr15",48644613,48646380,48645496,1767
"9922","chr8",23224443,23225462,23224952,1019
"9923","chr7",131327701,131328431,131328066,730
"9924","chr22",23070045,23071411,23070728,1366
"9925","chr1",43978963,43979950,43979456,987
"9926","chr4",52037885,52038746,52038315,861
"9927","chr16",21300847,21302012,21301429,1165
"9928","chr14",53152147,53153520,53152833,1373
"9929","chr3",115783878,115784734,115784306,856
"9930","chr2",102250633,102251367,102251000,734
"9931","chr3",96813179,96814781,96813980,1602
"9932","chr16",46843888,46844642,46844265,754
"9933","chr16",89507546,89508960,89508253,1414
"9934","chr7",122885694,122886905,122886299,1211
"9935","chr17",29390117,29391019,29390568,902
"9936","chr1",52920952,52921851,52921401,899
"9937","chr1",239997537,239998316,239997926,779
"9938","chr7",137164307,137164599,137164453,292
"9939","chr3",53881704,53882238,53881971,534
"9940","chr1",226407632,226408238,226407935,606
"9941","chr6",39114651,39115278,39114964,627
"9942","chr10",100482223,100482802,100482512,579
"9943","chr13",94967629,94968723,94968176,1094
"9944","chr1",25617483,25618281,25617882,798
"9945","chr15",77818499,77820511,77819505,2012
"9946","chr10",100346425,100347965,100347195,1540
"9947","chr5",177496803,177498338,177497570,1535
"9948","chr1",12063431,12064091,12063761,660
"9949","chr16",32845920,32846956,32846438,1036
"9950","chr17",7329011,7329832,7329421,821
"9951","chr8",141356950,141357760,141357355,810
"9952","chr12",110742201,110743223,110742712,1022
"9953","chr4",4290046,4290768,4290407,722
"9954","chr2",118845040,118848010,118846525,2970
"9955","chr15",56733199,56733952,56733575,753
"9956","chr10",89535190,89536168,89535679,978
"9957","chr18",22348453,22349366,22348909,913
"9958","chr16",180302,181762,181032,1460
"9959","chr4",77113174,77113436,77113305,262
"9960","chr5",60743760,60744008,60743884,248
"9961","chr4",182141125,182141328,182141226,203
"9962","chr9",135960793,135961593,135961193,800
"9963","chr2",73232957,73234739,73233848,1782
"9964","chr1",228445681,228446426,228446053,745
"9965","chr7",65374071,65374300,65374185,229
"9966","chr19",50431647,50432420,50432033,773
"9967","chr16",87680994,87681709,87681351,715
"9968","chr17",81683164,81684417,81683790,1253
"9969","chr9",129719193,129719466,129719329,273
"9970","chr16",1020956,1021221,1021088,265
"9971","chr1",42145814,42146020,42145917,206
"9972","chr6",41503820,41505553,41504686,1733
"9973","chr1",2204478,2205912,2205195,1434
"9974","chr6",70413189,70414117,70413653,928
"9975","chr6",35342373,35342909,35342641,536
"9976","chr5",72460379,72460798,72460588,419
"9977","chr10",33334192,33337269,33335730,3077
"9978","chr18",54959286,54959618,54959452,332
"9979","chr7",39733240,39733653,39733446,413
"9980","chr3",9932695,9934038,9933366,1343
"9981","chr14",21456083,21456409,21456246,326
"9982","chr1",245577691,245577902,245577796,211
"9983","chr16",50245817,50246694,50246255,877
"9984","chr1",84689922,84690657,84690289,735
"9985","chr3",179148280,179149120,179148700,840
"9986","chr3",149983117,149983365,149983241,248
"9987","chrX",3712365,3712579,3712472,214
"9988","chr19",1510494,1510726,1510610,232
"9989","chr14",101964299,101965561,101964930,1262
"9990","chr8",46954747,46955145,46954946,398
"9991","chr12",95942467,95942790,95942628,323
"9992","chr2",620639,621993,621316,1354
"9993","chr5",528268,528867,528567,599
"9994","chr17",72115838,72116167,72116002,329
"9995","chr18",79964352,79964836,79964594,484
"9996","chr4",136356055,136356332,136356193,277
"9997","chr7",73769049,73770785,73769917,1736
"9998","chr7",87152308,87152878,87152593,570
"9999","chr12",54125984,54126673,54126328,689
"10000","chr1",24416181,24416549,24416365,368
"10001","chr15",101488655,101490405,101489530,1750
"10002","chr16",720620,722158,721389,1538
"10003","chr4",55545826,55547190,55546508,1364
"10004","chr17",83066246,83066484,83066365,238
"10005","chr4",81214734,81215381,81215057,647
"10006","chr10",117126054,117126781,117126417,727
"10007","chr2",127408070,127408622,127408346,552
"10008","chr1",156082281,156082799,156082540,518
"10009","chr17",82242728,82243000,82242864,272
"10010","chr21",43694517,43694723,43694620,206
"10011","chr1",23902625,23903047,23902836,422
"10012","chr7",556414,556734,556574,320
"10013","chr10",43266475,43267233,43266854,758
"10014","chr21",44948136,44948425,44948280,289
"10015","chr1",16913543,16914475,16914009,932
"10016","chr14",44962425,44962912,44962668,487
"10017","chr8",144545359,144545781,144545570,422
"10018","chrX",31266387,31266902,31266644,515
"10019","chr13",41960744,41961325,41961034,581
"10020","chr8",11802167,11803286,11802726,1119
"10021","chr10",69801546,69803120,69802333,1574
"10022","chr4",168831897,168833384,168832640,1487
"10023","chr15",28003423,28004020,28003721,597
"10024","chr6",3153906,3154512,3154209,606
"10025","chr12",114698120,114698545,114698332,425
"10026","chr14",103846824,103848653,103847738,1829
"10027","chr8",104588225,104589476,104588850,1251
"10028","chr14",23550793,23551933,23551363,1140
"10029","chr15",55289574,55290373,55289973,799
"10030","chr16",88446106,88446408,88446257,302
"10031","chr21",45474902,45476398,45475650,1496
"10032","chr1",25616170,25616675,25616422,505
"10033","chr18",77249600,77251866,77250733,2266
"10034","chr12",57522539,57523020,57522779,481
"10035","chr1",234214138,234214725,234214431,587
"10036","chr3",186107673,186109095,186108384,1422
"10037","chr1",154974266,154975010,154974638,744
"10038","chr17",4898970,4902107,4900538,3137
"10039","chr3",196966894,196967329,196967111,435
"10040","chr1",3240945,3241736,3241340,791
"10041","chr18",35972759,35972989,35972874,230
"10042","chr1",235327023,235328845,235327934,1822
"10043","chr7",87875785,87877178,87876481,1393
"10044","chr6",30672654,30673076,30672865,422
"10045","chr17",82905451,82905867,82905659,416
"10046","chr7",73303668,73303914,73303791,246
"10047","chr1",95072695,95072995,95072845,300
"10048","chr8",22141198,22142031,22141614,833
"10049","chr6",35468033,35469307,35468670,1274
"10050","chr6",135497363,135498022,135497692,659
"10051","chr6",1381508,1384976,1383242,3468
"10052","chr1",37793423,37794755,37794089,1332
"10053","chr1",6612726,6615681,6614203,2955
"10054","chr9",112945748,112945958,112945853,210
"10055","chr16",2148454,2149128,2148791,674
"10056","chr19",58002087,58003130,58002608,1043
"10057","chr6",167989893,167990885,167990389,992
"10058","chr22",30905715,30906146,30905930,431
"10059","chr6",168555737,168556520,168556128,783
"10060","chr16",2614551,2614818,2614684,267
"10061","chr8",406374,407674,407024,1300
"10062","chr1",201538651,201540189,201539420,1538
"10063","chr1",175599240,175599672,175599456,432
"10064","chr12",50504838,50505381,50505109,543
"10065","chr9",130659147,130667022,130663084,7875
"10066","chr5",139341644,139342559,139342101,915
"10067","chr7",22822781,22823005,22822893,224
"10068","chr12",116878584,116879900,116879242,1316
"10069","chr3",181712213,181713288,181712750,1075
"10070","chr1",213389396,213389615,213389505,219
"10071","chr2",54557889,54558832,54558360,943
"10072","chr12",2794223,2796023,2795123,1800
"10073","chr7",128240697,128241322,128241009,625
"10074","chr8",104367338,104367758,104367548,420
"10075","chr3",50298900,50299448,50299174,548
"10076","chr9",125706826,125707356,125707091,530
"10077","chr17",41786223,41786924,41786573,701
"10078","chr2",85611616,85612138,85611877,522
"10079","chr12",2752616,2753306,2752961,690
"10080","chr17",28842508,28842776,28842642,268
"10081","chr1",150974020,150975474,150974747,1454
"10082","chr17",35119407,35120044,35119725,637
"10083","chr1",2384914,2385310,2385112,396
"10084","chr7",44796127,44797199,44796663,1072
"10085","chr12",189062,189334,189198,272
"10086","chr19",18588612,18589744,18589178,1132
"10087","chr1",119000433,119000831,119000632,398
"10088","chr8",1973708,1974557,1974132,849
"10089","chr6",28988329,28988801,28988565,472
"10090","chrX",53686123,53686849,53686486,726
"10091","chr4",3308278,3308508,3308393,230
"10092","chr3",179604558,179605000,179604779,442
"10093","chr6",27867412,27867683,27867547,271
"10094","chr12",101407269,101408375,101407822,1106
"10095","chr7",100483070,100483736,100483403,666
"10096","chr17",2711026,2712336,2711681,1310
"10097","chr20",32207479,32208038,32207758,559
"10098","chr10",132258467,132258689,132258578,222
"10099","chr9",132589199,132590853,132590026,1654
"10100","chr1",32870665,32871157,32870911,492
"10101","chr7",64666337,64666616,64666476,279
"10102","chrX",103063673,103064376,103064024,703
"10103","chr16",2267444,2268999,2268221,1555
"10104","chr6",44265143,44265710,44265426,567
"10105","chr8",142297600,142297917,142297758,317
"10106","chr12",56224211,56224590,56224400,379
"10107","chrX",7927036,7927567,7927301,531
"10108","chr7",150857331,150857653,150857492,322
"10109","chr8",23528707,23529873,23529290,1166
"10110","chr18",6284375,6284616,6284495,241
"10111","chr18",79579076,79579348,79579212,272
"10112","chr2",241866253,241866466,241866359,213
"10113","chr12",127280731,127280970,127280850,239
"10114","chr17",49230378,49230914,49230646,536
"10115","chr2",85437697,85437932,85437814,235
"10116","chr7",128862661,128863222,128862941,561
"10117","chr20",1180981,1181277,1181129,296
"10118","chr16",15858200,15858566,15858383,366
"10119","chr12",401357,401625,401491,268
"10120","chr18",580179,580899,580539,720
"10121","chr7",30504368,30505389,30504878,1021
"10122","chr3",186782949,186784259,186783604,1310
"10123","chr2",86807535,86807766,86807650,231
"10124","chr11",99020813,99021091,99020952,278
"10125","chr13",52011178,52012431,52011804,1253
"10126","chr16",800227,800806,800516,579
"10127","chr20",63156808,63157317,63157062,509
"10128","chr17",81511209,81515400,81513304,4191
"10129","chr7",43249035,43249349,43249192,314
"10130","chr12",67269261,67270267,67269764,1006
"10131","chr11",134466398,134466608,134466503,210
"10132","chr8",1182761,1182983,1182872,222
"10133","chr17",7219719,7220399,7220059,680
"10134","chr3",138451666,138452203,138451934,537
"10135","chr2",219294908,219295255,219295081,347
"10136","chr17",38572401,38573037,38572719,636
"10137","chr8",1668355,1668710,1668532,355
"10138","chr8",43140105,43141448,43140776,1343
"10139","chr8",141252357,141253139,141252748,782
"10140","chr6",7541285,7543239,7542262,1954
"10141","chr7",100158193,100158836,100158514,643
"10142","chr1",226109586,226110885,226110235,1299
"10143","chr8",38974073,38974834,38974453,761
"10144","chr4",3954936,3956548,3955742,1612
"10145","chrX",134914676,134915242,134914959,566
"10146","chr16",87490835,87493334,87492084,2499
"10147","chr16",29594643,29595624,29595133,981
"10148","chr21",36155907,36157552,36156729,1645
"10149","chr8",127793835,127794653,127794244,818
"10150","chr15",82680087,82681113,82680600,1026
"10151","chr2",21043797,21044089,21043943,292
"10152","chr6",5003751,5004138,5003944,387
"10153","chr19",19033115,19034018,19033566,903
"10154","chrX",112380603,112380814,112380708,211
"10155","chr19",45144699,45145565,45145132,866
"10156","chr8",37796530,37798582,37797556,2052
"10157","chr10",99520184,99520625,99520404,441
"10158","chr14",102362819,102363536,102363177,717
"10159","chr13",27170949,27172331,27171640,1382
"10160","chr19",56507374,56508137,56507755,763
"10161","chr17",7909178,7909400,7909289,222
"10162","chr16",1819076,1819296,1819186,220
"10163","chr21",46131923,46132715,46132319,792
"10164","chr2",176066847,176067935,176067391,1088
"10165","chr2",102187212,102188096,102187654,884
"10166","chr8",54470079,54470629,54470354,550
"10167","chr10",126504742,126504962,126504852,220
"10168","chr3",48717144,48717471,48717307,327
"10169","chr17",48816931,48817447,48817189,516
"10170","chr4",18020812,18022650,18021731,1838
"10171","chr4",186371271,186372424,186371847,1153
"10172","chr8",120445113,120445417,120445265,304
"10173","chr4",37685779,37686991,37686385,1212
"10174","chr4",188282560,188283320,188282940,760
"10175","chr10",128500595,128500895,128500745,300
"10176","chr10",45418926,45419435,45419180,509
"10177","chr5",1253622,1253836,1253729,214
"10178","chr19",39247049,39248648,39247848,1599
"10179","chr6",96836954,96837906,96837430,952
"10180","chr3",150761947,150764101,150763024,2154
"10181","chr11",76235294,76236539,76235916,1245
"10182","chr22",46035765,46036329,46036047,564
"10183","chr16",1038437,1038780,1038608,343
"10184","chr2",41697452,41697809,41697630,357
"10185","chr8",17922523,17923763,17923143,1240
"10186","chr8",21750566,21750823,21750694,257
"10187","chr10",78029380,78029683,78029531,303
"10188","chr10",122460822,122462724,122461773,1902
"10189","chr10",132916294,132916518,132916406,224
"10190","chr16",482467,482669,482568,202
"10191","chr14",74018622,74019653,74019137,1031
"10192","chr4",185534829,185535710,185535269,881
"10193","chr20",45833825,45834530,45834177,705
"10194","chr10",7579755,7579987,7579871,232
"10195","chr14",58646602,58646922,58646762,320
"10196","chr16",68737131,68738441,68737786,1310
"10197","chr16",34161895,34163956,34162925,2061
"10198","chr12",57845479,57847263,57846371,1784
"10199","chr2",170973400,170974198,170973799,798
"10200","chr9",127912267,127912679,127912473,412
"10201","chr12",79689751,79691374,79690562,1623
"10202","chr8",9898667,9899483,9899075,816
"10203","chr7",155830964,155831200,155831082,236
"10204","chr8",144353438,144354463,144353950,1025
"10205","chr19",16519118,16519345,16519231,227
"10206","chr2",126886224,126886528,126886376,304
"10207","chr15",56464981,56465185,56465083,204
"10208","chr14",54901829,54903195,54902512,1366
"10209","chr20",642444,642754,642599,310
"10210","chr2",53767754,53768032,53767893,278
"10211","chr6",167978068,167978364,167978216,296
"10212","chr14",75002612,75003179,75002895,567
"10213","chr4",168877759,168878474,168878116,715
"10214","chr17",62652284,62652908,62652596,624
"10215","chrY",15455699,15456737,15456218,1038
"10216","chr14",22598534,22598864,22598699,330
"10217","chrX",119482463,119482923,119482693,460
"10218","chr2",176116037,176116695,176116366,658
"10219","chr7",2403157,2404376,2403766,1219
"10220","chr15",74461072,74461638,74461355,566
"10221","chrX",48957005,48958632,48957818,1627
"10222","chr2",219496740,219498532,219497636,1792
"10223","chr4",120066462,120067001,120066731,539
"10224","chr16",71808020,71809198,71808609,1178
"10225","chr20",23637269,23638049,23637659,780
"10226","chr2",201118475,201118986,201118730,511
"10227","chr1",75134989,75135730,75135359,741
"10228","chr4",103076051,103076850,103076450,799
"10229","chr4",61200165,61203083,61201624,2918
"10230","chr14",75294047,75294511,75294279,464
"10231","chr21",45867098,45867512,45867305,414
"10232","chr10",52411011,52411218,52411114,207
"10233","chr9",135701779,135702407,135702093,628
"10234","chr5",140966520,140967346,140966933,826
"10235","chr21",45923801,45925225,45924513,1424
"10236","chr2",1666219,1666431,1666325,212
"10237","chr17",48596170,48596819,48596494,649
"10238","chr17",49013675,49014212,49013943,537
"10239","chr4",36244009,36244767,36244388,758
"10240","chr14",67674255,67675165,67674710,910
"10241","chr19",7595837,7596708,7596272,871
"10242","chr19",29665131,29665888,29665509,757
"10243","chr10",793668,794270,793969,602
"10244","chr15",75682664,75683022,75682843,358
"10245","chr19",58228577,58229188,58228882,611
"10246","chr1",109397452,109398272,109397862,820
"10247","chr15",31026082,31026329,31026205,247
"10248","chr7",45575475,45575905,45575690,430
"10249","chr15",100554315,100559288,100556801,4973
"10250","chr17",273005,273635,273320,630
"10251","chr2",241813185,241813491,241813338,306
"10252","chr14",105477813,105479363,105478588,1550
"10253","chr7",1086942,1087274,1087108,332
"10254","chr7",128361292,128362012,128361652,720
"10255","chr2",226797366,226800196,226798781,2830
"10256","chr11",57752861,57753281,57753071,420
"10257","chr19",52962477,52963070,52962773,593
"10258","chr16",807341,808025,807683,684
"10259","chr6",56247390,56247646,56247518,256
"10260","chr11",62444517,62444724,62444620,207
"10261","chr6",34696295,34696993,34696644,698
"10262","chr14",88385539,88385941,88385740,402
"10263","chrX",119694075,119694294,119694184,219
"10264","chr14",104085529,104086141,104085835,612
"10265","chr12",119877043,119877365,119877204,322
"10266","chr17",6655993,6657484,6656738,1491
"10267","chr7",66654088,66655417,66654752,1329
"10268","chr14",79278810,79279546,79279178,736
"10269","chr16",89052393,89052744,89052568,351
"10270","chr2",218880264,218880929,218880596,665
"10271","chr2",88350728,88351167,88350947,439
"10272","chrX",48539371,48540141,48539756,770
"10273","chr8",25457770,25459512,25458641,1742
"10274","chr17",68457208,68457996,68457602,788
"10275","chr12",39442409,39443697,39443053,1288
"10276","chr2",241701428,241703041,241702234,1613
"10277","chr16",648826,650244,649535,1418
"10278","chr15",66621903,66622546,66622224,643
"10279","chr17",45261757,45262465,45262111,708
"10280","chr10",32055622,32056642,32056132,1020
"10281","chr14",52707034,52707394,52707214,360
"10282","chr18",12991062,12991697,12991379,635
"10283","chr2",636121,637112,636616,991
"10284","chr21",41766120,41767276,41766698,1156
"10285","chr7",99472672,99473236,99472954,564
"10286","chr3",141797213,141797797,141797505,584
"10287","chr13",48094709,48095256,48094982,547
"10288","chr14",104158911,104159185,104159048,274
"10289","chr15",69073981,69074456,69074218,475
"10290","chr16",21278098,21278378,21278238,280
"10291","chr8",38996181,38997597,38996889,1416
"10292","chr11",75815351,75815881,75815616,530
"10293","chr2",27442072,27442803,27442437,731
"10294","chr3",174440805,174441558,174441181,753
"10295","chr9",131096283,131096679,131096481,396
"10296","chr2",233853850,233854933,233854391,1083
"10297","chr20",62959464,62959858,62959661,394
"10298","chr4",98260358,98262048,98261203,1690
"10299","chr8",54466368,54467626,54466997,1258
"10300","chr4",6245474,6246155,6245814,681
"10301","chrX",53000529,53000914,53000721,385
"10302","chr2",176121696,176123530,176122613,1834
"10303","chr2",226835597,226836399,226835998,802
"10304","chr17",7614372,7615430,7614901,1058
"10305","chr14",105867283,105868061,105867672,778
"10306","chr17",36544301,36545601,36544951,1300
"10307","chr8",39522706,39523014,39522860,308
"10308","chr21",41506824,41508747,41507785,1923
"10309","chr19",39480706,39481078,39480892,372
"10310","chr14",35403841,35404784,35404312,943
"10311","chr7",55887242,55887694,55887468,452
"10312","chr4",99563570,99564127,99563848,557
"10313","chr4",1309702,1310047,1309874,345
"10314","chr15",78944698,78945229,78944963,531
"10315","chr17",78900996,78901216,78901106,220
"10316","chr19",13097529,13099711,13098620,2182
"10317","chr6",41470324,41470856,41470590,532
"10318","chr1",54489405,54489614,54489509,209
"10319","chrX",54808328,54808577,54808452,249
"10320","chr17",42288170,42288996,42288583,826
"10321","chr8",9002690,9003232,9002961,542
"10322","chr20",45791858,45792229,45792043,371
"10323","chr1",175023229,175023660,175023444,431
"10324","chr14",103715041,103716615,103715828,1574
"10325","chr10",70458244,70458728,70458486,484
"10326","chr1",19288504,19289166,19288835,662
"10327","chr17",32342006,32342268,32342137,262
"10328","chr14",37622234,37622971,37622602,737
"10329","chr15",85758718,85758982,85758850,264
"10330","chr8",1873436,1873748,1873592,312
"10331","chr9",124502891,124505380,124504135,2489
"10332","chr15",37097974,37098179,37098076,205
"10333","chr17",1627816,1629935,1628875,2119
"10334","chr6",12012510,12012834,12012672,324
"10335","chr17",80991616,80992684,80992150,1068
"10336","chr14",64387485,64388306,64387895,821
"10337","chr4",184168534,184168836,184168685,302
"10338","chr4",54228154,54228426,54228290,272
"10339","chr16",32289620,32290143,32289881,523
"10340","chr3",132660239,132660799,132660519,560
"10341","chr16",3182835,3184048,3183441,1213
"10342","chr17",17694510,17695084,17694797,574
"10343","chr7",97927918,97928572,97928245,654
"10344","chr1",156767243,156768221,156767732,978
"10345","chr17",36641387,36642304,36641845,917
"10346","chr4",110628723,110629047,110628885,324
"10347","chr18",49561509,49562158,49561833,649
"10348","chr13",42271717,42272671,42272194,954
"10349","chrX",151694707,151695606,151695156,899
"10350","chr16",68843455,68843914,68843684,459
"10351","chr15",100601770,100602932,100602351,1162
"10352","chr19",360071,361949,361010,1878
"10353","chr17",8151232,8152517,8151874,1285
"10354","chr12",64222044,64222606,64222325,562
"10355","chr12",57175940,57176158,57176049,218
"10356","chr17",82697459,82699359,82698409,1900
"10357","chr4",25160159,25160668,25160413,509
"10358","chr9",136940964,136944988,136942976,4024
"10359","chr8",101223925,101224721,101224323,796
"10360","chr6",90586639,90587362,90587000,723
"10361","chr1",32426827,32427234,32427030,407
"10362","chr4",155667145,155668140,155667642,995
"10363","chr18",78313274,78313558,78313416,284
"10364","chr10",31759327,31760495,31759911,1168
"10365","chr1",16440503,16441308,16440905,805
"10366","chr6",142088336,142088975,142088655,639
"10367","chr1",155003371,155004060,155003715,689
"10368","chr12",6723892,6724325,6724108,433
"10369","chr2",223052858,223053319,223053088,461
"10370","chr3",121993210,121993458,121993334,248
"10371","chr2",74002350,74002869,74002609,519
"10372","chr20",64186737,64187539,64187138,802
"10373","chr7",967523,967922,967722,399
"10374","chr12",56629841,56630449,56630145,608
"10375","chr1",27668216,27668520,27668368,304
"10376","chr9",69248034,69248244,69248139,210
"10377","chr1",1478654,1479152,1478903,498
"10378","chrX",107936000,107936427,107936213,427
"10379","chr1",40039739,40041031,40040385,1292
"10380","chr21",36069842,36070480,36070161,638
"10381","chr13",99501111,99501884,99501497,773
"10382","chr19",17419841,17420726,17420283,885
"10383","chr16",3726133,3726547,3726340,414
"10384","chr7",120857066,120857916,120857491,850
"10385","chr1",46394052,46394619,46394335,567
"10386","chr16",25031809,25032118,25031963,309
"10387","chr8",143872388,143872659,143872523,271
"10388","chr1",113389958,113391448,113390703,1490
"10389","chr5",139378125,139378651,139378388,526
"10390","chr17",39730202,39730757,39730479,555
"10391","chr10",23694437,23696049,23695243,1612
"10392","chr12",19941203,19941424,19941313,221
"10393","chr1",63593266,63594242,63593754,976
"10394","chr16",172370,173448,172909,1078
"10395","chr3",122022114,122022403,122022258,289
"10396","chr9",105656305,105656653,105656479,348
"10397","chr8",22244650,22245629,22245139,979
"10398","chr22",35551656,35551949,35551802,293
"10399","chr8",144580627,144581329,144580978,702
"10400","chr14",105150650,105150972,105150811,322
"10401","chr7",24979380,24980636,24980008,1256
"10402","chr8",31032844,31033709,31033276,865
"10403","chr3",31980477,31981872,31981174,1395
"10404","chr3",65356528,65357209,65356868,681
"10405","chr14",103928192,103928897,103928544,705
"10406","chr7",149261767,149262800,149262283,1033
"10407","chr1",2860592,2860796,2860694,204
"10408","chr21",36707641,36709533,36708587,1892
"10409","chr13",106917827,106918323,106918075,496
"10410","chr9",137494872,137495299,137495085,427
"10411","chr12",122974604,122975485,122975044,881
"10412","chr3",44477346,44477876,44477611,530
"10413","chr9",133554394,133554663,133554528,269
"10414","chr19",48558288,48558512,48558400,224
"10415","chr1",112743704,112744550,112744127,846
"10416","chr17",50541750,50542433,50542091,683
"10417","chr6",13769254,13769886,13769570,632
"10418","chr12",53984912,53986318,53985615,1406
"10419","chr4",173500873,173501292,173501082,419
"10420","chr12",49567847,49568436,49568141,589
"10421","chr2",222303934,222304289,222304111,355
"10422","chr17",45949161,45949372,45949266,211
"10423","chr20",34363178,34364163,34363670,985
"10424","chr14",64503249,64505462,64504355,2213
"10425","chr9",35790826,35791152,35790989,326
"10426","chr1",1173934,1174765,1174349,831
"10427","chr16",2852828,2853361,2853094,533
"10428","chr1",168056270,168056484,168056377,214
"10429","chr7",139482734,139483966,139483350,1232
"10430","chr20",25077652,25078090,25077871,438
"10431","chr1",13513010,13514118,13513564,1108
"10432","chr20",63460973,63461233,63461103,260
"10433","chr12",57619388,57619869,57619628,481
"10434","chr16",1447449,1447936,1447692,487
"10435","chr1",99849864,99850453,99850158,589
"10436","chr4",75514225,75514793,75514509,568
"10437","chr1",37634005,37635192,37634598,1187
"10438","chr1",146049360,146049712,146049536,352
"10439","chr4",6269553,6270455,6270004,902
"10440","chr6",89352321,89353167,89352744,846
"10441","chr20",5610613,5611229,5610921,616
"10442","chr12",105330494,105331274,105330884,780
"10443","chr14",77457527,77458253,77457890,726
"10444","chr6",31834821,31835046,31834933,225
"10445","chr19",1157316,1159011,1158163,1695
"10446","chr16",4114807,4117011,4115909,2204
"10447","chr2",53859639,53860129,53859884,490
"10448","chr19",7556753,7557242,7556997,489
"10449","chr12",105235719,105236321,105236020,602
"10450","chr1",1435560,1436069,1435814,509
"10451","chr19",3491053,3492504,3491778,1451
"10452","chr6",144007779,144008710,144008244,931
"10453","chr1",15943405,15943764,15943584,359
"10454","chr19",21463526,21463734,21463630,208
"10455","chr1",148263174,148263476,148263325,302
"10456","chr3",72847789,72848642,72848215,853
"10457","chr21",40846922,40847296,40847109,374
"10458","chr1",153967167,153967504,153967335,337
"10459","chr6",73314679,73315297,73314988,618
"10460","chr7",76047723,76048449,76048086,726
"10461","chr1",156193881,156194261,156194071,380
"10462","chr1",7770991,7771786,7771388,795
"10463","chr11",1029083,1029390,1029236,307
"10464","chr18",78126577,78126801,78126689,224
"10465","chr17",63621647,63623368,63622507,1721
"10466","chr3",131526877,131527177,131527027,300
"10467","chr18",79898912,79900000,79899456,1088
"10468","chr8",144700025,144700716,144700370,691
"10469","chr5",96934733,96936421,96935577,1688
"10470","chr4",10145413,10145707,10145560,294
"10471","chr19",52725720,52725942,52725831,222
"10472","chr2",127674620,127675916,127675268,1296
"10473","chr7",5227290,5227675,5227482,385
"10474","chr12",49069658,49070206,49069932,548
"10475","chr2",55268937,55269429,55269183,492
"10476","chr14",93114738,93116452,93115595,1714
"10477","chr1",43706997,43708092,43707544,1095
"10478","chr14",21476755,21477653,21477204,898
"10479","chr7",64882278,64882725,64882501,447
"10480","chr6",127343047,127343610,127343328,563
"10481","chr19",21750632,21751051,21750841,419
"10482","chr4",170027335,170027757,170027546,422
"10483","chr16",2009325,2010031,2009678,706
"10484","chr20",61926908,61927115,61927011,207
"10485","chr3",128123475,128124064,128123769,589
"10486","chr2",241271874,241273087,241272480,1213
"10487","chr22",50627837,50628510,50628173,673
"10488","chr6",89638448,89638845,89638646,397
"10489","chr19",38975206,38976003,38975604,797
"10490","chr4",876907,877181,877044,274
"10491","chr17",80889769,80890013,80889891,244
"10492","chr8",7091827,7092517,7092172,690
"10493","chrX",48969369,48970186,48969777,817
"10494","chr1",243917238,243917791,243917514,553
"10495","chr17",82458128,82459383,82458755,1255
"10496","chr21",45379992,45380931,45380461,939
"10497","chr4",184951822,184952313,184952067,491
"10498","chr12",132178777,132179203,132178990,426
"10499","chr14",93223579,93223919,93223749,340
"10500","chr19",38930423,38930975,38930699,552
"10501","chr2",105881331,105882121,105881726,790
"10502","chr16",2531725,2532647,2532186,922
"10503","chr3",143001394,143001917,143001655,523
"10504","chr19",48171808,48172095,48171951,287
"10505","chr7",27185431,27186010,27185720,579
"10506","chr2",159615577,159616225,159615901,648
"10507","chr11",73376184,73377237,73376710,1053
"10508","chr19",12847338,12848077,12847707,739
"10509","chr3",48556589,48557420,48557004,831
"10510","chr2",69961379,69961594,69961486,215
"10511","chr3",49104501,49104940,49104720,439
"10512","chr17",42458728,42459014,42458871,286
"10513","chr10",99840130,99840469,99840299,339
"10514","chr2",232386651,232388704,232387677,2053
"10515","chr16",813278,813917,813597,639
"10516","chr3",47282257,47283158,47282707,901
"10517","chr20",57664504,57664720,57664612,216
"10518","chr19",39924387,39924704,39924545,317
"10519","chr16",66873114,66873369,66873241,255
"10520","chr2",208266024,208266412,208266218,388
"10521","chr5",140787506,140788554,140788030,1048
"10522","chr2",196170865,196171659,196171262,794
"10523","chr21",44510583,44510922,44510752,339
"10524","chr3",23806201,23806886,23806543,685
"10525","chr12",121452955,121453341,121453148,386
"10526","chr14",77097622,77098385,77098003,763
"10527","chr2",23628970,23629219,23629094,249
"10528","chr3",49171196,49171763,49171479,567
"10529","chr12",100716085,100717844,100716964,1759
"10530","chr9",137053454,137054485,137053969,1031
"10531","chr19",19732673,19733134,19732903,461
"10532","chr11",75667371,75668837,75668104,1466
"10533","chr5",176629519,176630675,176630097,1156
"10534","chr2",238426519,238427622,238427070,1103
"10535","chr14",103333472,103335324,103334398,1852
"10536","chr19",9093570,9093814,9093692,244
"10537","chr4",16082572,16084112,16083342,1540
"10538","chr4",84496506,84499646,84498076,3140
"10539","chr10",116609067,116609912,116609489,845
"10540","chr1",51729356,51730149,51729752,793
"10541","chr8",144826448,144827907,144827177,1459
"10542","chr3",10328754,10329122,10328938,368
"10543","chr7",27213062,27214216,27213639,1154
"10544","chr2",95076849,95077173,95077011,324
"10545","chr17",38702025,38706158,38704091,4133
"10546","chr2",86913663,86913953,86913808,290
"10547","chr16",2090586,2092169,2091377,1583
"10548","chr2",54628961,54629350,54629155,389
"10549","chr2",3285655,3285960,3285807,305
"10550","chr3",125212317,125212903,125212610,586
"10551","chr7",103148948,103149673,103149310,725
"10552","chr21",41907625,41907915,41907770,290
"10553","chr10",13299377,13300223,13299800,846
"10554","chr4",1402503,1407942,1405222,5439
"10555","chr2",75646855,75647294,75647074,439
"10556","chr2",169798779,169799247,169799013,468
"10557","chr22",50250731,50251738,50251234,1007
"10558","chr2",73175510,73177674,73176592,2164
"10559","chr16",29298600,29299090,29298845,490
"10560","chr19",2115421,2115784,2115602,363
"10561","chr19",10960440,10961664,10961052,1224
"10562","chr1",184051647,184051920,184051783,273
"10563","chr16",30400104,30400799,30400451,695
"10564","chr11",106021998,106022225,106022111,227
"10565","chr8",132129318,132129569,132129443,251
"10566","chr2",64524007,64524863,64524435,856
"10567","chr16",14694220,14694459,14694339,239
"10568","chr14",80941366,80941781,80941573,415
"10569","chr17",81393006,81400942,81396974,7936
"10570","chr1",32892868,32893848,32893358,980
"10571","chr17",67825010,67825922,67825466,912
"10572","chr17",48023431,48025538,48024484,2107
"10573","chr2",241102128,241102611,241102369,483
"10574","chr1",35883702,35884069,35883885,367
"10575","chr2",201451130,201452285,201451707,1155
"10576","chr5",37834569,37835026,37834797,457
"10577","chr11",63998586,64001194,63999890,2608
"10578","chr16",88376041,88376586,88376313,545
"10579","chr2",31581476,31581713,31581594,237
"10580","chr3",125969060,125969488,125969274,428
"10581","chr1",32361343,32362416,32361879,1073
"10582","chr6",75748720,75749550,75749135,830
"10583","chr20",45823937,45824523,45824230,586
"10584","chr19",3366643,3367471,3367057,828
"10585","chr10",632322,633575,632948,1253
"10586","chr7",549276,549907,549591,631
"10587","chr1",55214792,55216035,55215413,1243
"10588","chr12",57771780,57772179,57771979,399
"10589","chr7",22082942,22083353,22083147,411
"10590","chr12",52367050,52367315,52367182,265
"10591","chr8",142464084,142465101,142464592,1017
"10592","chrX",70133254,70134054,70133654,800
"10593","chr8",143577575,143578465,143578020,890
"10594","chr2",219597585,219598222,219597903,637
"10595","chr8",123540299,123541777,123541038,1478
"10596","chr2",135052222,135052688,135052455,466
"10597","chr19",52451208,52451592,52451400,384
"10598","chr3",195750840,195751112,195750976,272
"10599","chr4",154742657,154743163,154742910,506
"10600","chr3",12663560,12664388,12663974,828
"10601","chrX",15674981,15675950,15675465,969
"10602","chr21",45537401,45538002,45537701,601
"10603","chr10",93065789,93066563,93066176,774
"10604","chr19",22532461,22532774,22532617,313
"10605","chr17",41864818,41865671,41865244,853
"10606","chr10",46578059,46579625,46578842,1566
"10607","chr1",16960795,16961189,16960992,394
"10608","chr17",75524875,75526459,75525667,1584
"10609","chr17",45395161,45396977,45396069,1816
"10610","chr3",27712846,27713248,27713047,402
"10611","chr17",4986987,4987696,4987341,709
"10612","chr19",9827649,9828139,9827894,490
"10613","chr1",2290759,2291130,2290944,371
"10614","chr17",78168314,78169191,78168752,877
"10615","chr19",39390692,39391524,39391108,832
"10616","chr1",247518097,247518649,247518373,552
"10617","chr7",1544418,1544709,1544563,291
"10618","chr5",157690141,157691371,157690756,1230
"10619","chr2",216692079,216692451,216692265,372
"10620","chr14",96501817,96503034,96502425,1217
"10621","chr1",3164370,3164728,3164549,358
"10622","chr9",3181006,3181867,3181436,861
"10623","chr14",51651257,51652770,51652013,1513
"10624","chr1",24535212,24535430,24535321,218
"10625","chr3",46464671,46464926,46464798,255
"10626","chr11",554713,556560,555636,1847
"10627","chr14",75427605,75428646,75428125,1041
"10628","chr19",35224720,35225217,35224968,497
"10629","chr2",176088055,176088569,176088312,514
"10630","chr17",19579913,19580374,19580143,461
"10631","chr19",13873792,13874104,13873948,312
"10632","chr12",71839543,71839855,71839699,312
"10633","chr1",224356821,224357522,224357171,701
"10634","chr1",38012410,38013055,38012732,645
"10635","chr8",20197035,20197516,20197275,481
"10636","chr17",39864128,39864392,39864260,264
"10637","chr19",1428804,1429304,1429054,500
"10638","chr2",3594957,3595161,3595059,204
"10639","chr16",67644689,67645293,67644991,604
"10640","chr9",36166201,36166832,36166516,631
"10641","chr3",126474840,126476652,126475746,1812
"10642","chr14",52313969,52315291,52314630,1322
"10643","chr7",207548,207790,207669,242
"10644","chr16",49464978,49465494,49465236,516
"10645","chr1",111988937,111991151,111990044,2214
"10646","chr17",1648436,1649909,1649172,1473
"10647","chr14",75276980,75280095,75278537,3115
"10648","chr7",754580,754945,754762,365
"10649","chr14",25049218,25050406,25049812,1188
"10650","chr1",44354985,44355441,44355213,456
"10651","chrX",10117143,10117719,10117431,576
"10652","chr19",48480305,48480918,48480611,613
"10653","chr7",1744391,1747298,1745844,2907
"10654","chr3",32467773,32468033,32467903,260
"10655","chr17",1031177,1031832,1031504,655
"10656","chr12",50283471,50283755,50283613,284
"10657","chr9",21994102,21995911,21995006,1809
"10658","chr8",144462006,144467122,144464564,5116
"10659","chr12",45989778,45990973,45990375,1195
"10660","chr2",88764976,88765996,88765486,1020
"10661","chr16",2287990,2288481,2288235,491
"10662","chr12",122867094,122867371,122867232,277
"10663","chr2",1568179,1569351,1568765,1172
"10664","chr17",16653399,16653889,16653644,490
"10665","chrX",50281336,50281556,50281446,220
"10666","chr2",27380589,27381064,27380826,475
"10667","chrX",134546218,134546659,134546438,441
"10668","chr17",49506244,49506646,49506445,402
"10669","chr16",793069,793391,793230,322
"10670","chr20",31822744,31823029,31822886,285
"10671","chr19",15469571,15470052,15469811,481
"10672","chr20",35953680,35955090,35954385,1410
"10673","chr7",64569524,64570450,64569987,926
"10674","chr6",24126081,24126284,24126182,203
"10675","chr3",139344078,139344304,139344191,226
"10676","chr8",42391537,42392331,42391934,794
"10677","chr19",45692224,45693034,45692629,810
"10678","chr19",52028070,52028471,52028270,401
"10679","chr16",80540844,80541193,80541018,349
"10680","chr2",65227419,65228310,65227864,891
"10681","chr3",38496191,38496580,38496385,389
"10682","chr7",157655548,157655874,157655711,326
"10683","chr8",17026854,17027830,17027342,976
"10684","chr2",238966929,238967213,238967071,284
"10685","chr22",19764130,19764386,19764258,256
"10686","chr2",202265590,202266037,202265813,447
"10687","chr16",4313934,4314150,4314042,216
"10688","chr4",781283,782175,781729,892
"10689","chr11",77039648,77040731,77040189,1083
"10690","chr3",46756552,46756973,46756762,421
"10691","chr1",149811969,149812469,149812219,500
"10692","chr15",32029961,32030857,32030409,896
"10693","chr4",73998396,73998612,73998504,216
"10694","chr22",19979756,19980285,19980020,529
"10695","chr19",39846237,39846571,39846404,334
"10696","chrX",151227748,151227975,151227861,227
"10697","chr8",57212351,57212615,57212483,264
"10698","chr16",25111489,25112121,25111805,632
"10699","chr14",73058281,73059044,73058662,763
"10700","chr14",91303766,91304075,91303920,309
"10701","chr19",14031586,14032165,14031875,579
"10702","chr20",53660205,53660512,53660358,307
"10703","chr1",37995912,37996316,37996114,404
"10704","chr13",113208048,113210203,113209125,2155
"10705","chr19",48363931,48364350,48364140,419
"10706","chrX",76149360,76150030,76149695,670
"10707","chr22",41909613,41911250,41910431,1637
"10708","chr18",79327463,79328162,79327812,699
"10709","chr14",101781323,101781942,101781632,619
"10710","chr2",216109082,216109541,216109311,459
"10711","chr1",27012388,27012950,27012669,562
"10712","chr4",681054,682302,681678,1248
"10713","chr6",32894379,32895008,32894693,629
"10714","chr15",38252075,38253035,38252555,960
"10715","chr19",44259825,44260159,44259992,334
"10716","chr22",20405453,20406633,20406043,1180
"10717","chr2",241507602,241509143,241508372,1541
"10718","chrX",48831179,48832417,48831798,1238
"10719","chr14",52950390,52951621,52951005,1231
"10720","chr2",74147711,74148130,74147920,419
"10721","chr11",47185637,47187625,47186631,1988
"10722","chr2",37670999,37672687,37671843,1688
"10723","chr11",62805091,62805677,62805384,586
"10724","chrX",68686269,68686633,68686451,364
"10725","chr19",1811955,1812760,1812357,805
"10726","chr22",19730704,19731228,19730966,524
"10727","chr7",31003,31442,31222,439
"10728","chr22",44620163,44620608,44620385,445
"10729","chr14",24132289,24132491,24132390,202
"10730","chr3",4466924,4467280,4467102,356
"10731","chr7",47536711,47537612,47537161,901
"10732","chr2",130144547,130144772,130144659,225
"10733","chrX",12791478,12792213,12791845,735
"10734","chr20",44531698,44532176,44531937,478
"10735","chr2",169361804,169363035,169362419,1231
"10736","chr12",57896449,57896773,57896611,324
"10737","chr8",1816162,1817312,1816737,1150
"10738","chr3",52455636,52455992,52455814,356
"10739","chr4",56592469,56592862,56592665,393
"10740","chr8",42139925,42140894,42140409,969
"10741","chr3",53156493,53156748,53156620,255
"10742","chr18",112309,112529,112419,220
"10743","chr16",87868848,87869854,87869351,1006
"10744","chr8",1437039,1437274,1437156,235
"10745","chr1",37514311,37514964,37514637,653
"10746","chr5",1285983,1286240,1286111,257
"10747","chr17",42744640,42745216,42744928,576
"10748","chr7",149027955,149029069,149028512,1114
"10749","chr19",10086020,10087181,10086600,1161
"10750","chr7",88759174,88759969,88759571,795
"10751","chr3",27483443,27484689,27484066,1246
"10752","chr7",38630839,38631561,38631200,722
"10753","chrX",134237039,134237448,134237243,409
"10754","chr16",19521659,19522194,19521926,535
"10755","chr9",129036448,129037001,129036724,553
"10756","chr8",1882582,1882842,1882712,260
"10757","chr20",32536186,32537074,32536630,888
"10758","chr7",98955123,98955339,98955231,216
"10759","chr4",76306201,76307329,76306765,1128
"10760","chr8",22056764,22057014,22056889,250
"10761","chr15",100544223,100544973,100544598,750
"10762","chr13",35471794,35472006,35471900,212
"10763","chr7",5071989,5072457,5072223,468
"10764","chr16",32309951,32310916,32310433,965
"10765","chr1",90710847,90711144,90710995,297
"10766","chrX",141176765,141177220,141176992,455
"10767","chr12",24562022,24563360,24562691,1338
"10768","chr7",94907537,94908165,94907851,628
"10769","chr17",61395699,61405614,61400656,9915
"10770","chr10",100519405,100519973,100519689,568
"10771","chr8",138496552,138497531,138497041,979
"10772","chr14",24147113,24147906,24147509,793
"10773","chr4",1992935,1993145,1993040,210
"10774","chr7",155371862,155375159,155373510,3297
"10775","chr2",558069,558469,558269,400
"10776","chr3",180828378,180829128,180828753,750
"10777","chr2",70899590,70902079,70900834,2489
"10778","chr14",103126897,103127586,103127241,689
"10779","chr6",158559944,158560798,158560371,854
"10780","chr19",32224478,32224784,32224631,306
"10781","chr7",23181787,23182361,23182074,574
"10782","chr4",15703017,15703377,15703197,360
"10783","chr9",35489707,35490703,35490205,996
"10784","chr4",1370358,1370561,1370459,203
"10785","chr22",41620771,41621780,41621275,1009
"10786","chr18",62596147,62597015,62596581,868
"10787","chr17",7242160,7243390,7242775,1230
"10788","chr4",40629723,40630513,40630118,790
"10789","chr10",133334692,133337061,133335876,2369
"10790","chr16",55019004,55019210,55019107,206
"10791","chr7",79453632,79454534,79454083,902
"10792","chr8",22689703,22695914,22692808,6211
"10793","chr6",73263096,73263304,73263200,208
"10794","chr13",114109723,114109943,114109833,220
"10795","chr20",46010496,46011349,46010922,853
"10796","chr7",155451351,155451662,155451506,311
"10797","chr14",60647384,60649834,60648609,2450
"10798","chr7",135233567,135233902,135233734,335
"10799","chr13",110705733,110706547,110706140,814
"10800","chr14",100537730,100539344,100538537,1614
"10801","chr7",45088380,45089181,45088780,801
"10802","chr10",26215454,26218505,26216979,3051
"10803","chr4",7481815,7482517,7482166,702
"10804","chr7",80918990,80919410,80919200,420
"10805","chr14",52790946,52791901,52791423,955
"10806","chr21",41167440,41168945,41168192,1505
"10807","chr14",104640124,104640329,104640226,205
"10808","chr7",128830152,128831107,128830629,955
"10809","chr7",75073517,75074094,75073805,577
"10810","chr3",50350528,50351250,50350889,722
"10811","chr6",9398860,9399366,9399113,506
"10812","chr14",49852708,49852914,49852811,206
"10813","chr19",55481210,55485549,55483379,4339
"10814","chr11",59062590,59063266,59062928,676
"10815","chr7",17298628,17299477,17299052,849
"10816","chr16",81076880,81077638,81077259,758
"10817","chr18",77058395,77058634,77058514,239
"10818","chr13",43970856,43971212,43971034,356
"10819","chr19",10717981,10718664,10718322,683
"10820","chr8",100559287,100559876,100559581,589
"10821","chr6",168229366,168229710,168229538,344
"10822","chr14",57268388,57268986,57268687,598
"10823","chrX",107324132,107324358,107324245,226
"10824","chrX",112840336,112840652,112840494,316
"10825","chr7",117427349,117427612,117427480,263
"10826","chr16",23835620,23836781,23836200,1161
"10827","chr12",118376209,118377034,118376621,825
"10828","chr19",14136087,14137708,14136897,1621
"10829","chr16",4680261,4680486,4680373,225
"10830","chr7",99325612,99326352,99325982,740
"10831","chr9",32782938,32783627,32783282,689
"10832","chr18",75576,76027,75801,451
"10833","chr7",1080344,1080612,1080478,268
"10834","chr19",3870790,3871045,3870917,255
"10835","chr12",121209902,121210461,121210181,559
"10836","chr3",52057263,52057636,52057449,373
"10837","chr17",5191544,5192161,5191852,617
"10838","chr2",32009584,32011030,32010307,1446
"10839","chr19",32971809,32972402,32972105,593
"10840","chr14",75546487,75546861,75546674,374
"10841","chr11",125165039,125166779,125165909,1740
"10842","chr18",70430570,70430860,70430715,290
"10843","chr16",88130078,88130312,88130195,234
"10844","chr10",2315054,2315277,2315165,223
"10845","chr18",13641585,13642416,13642000,831
"10846","chr5",135578488,135579178,135578833,690
"10847","chr2",206084988,206085804,206085396,816
"10848","chr16",70188047,70188787,70188417,740
"10849","chr1",53061992,53063302,53062647,1310
"10850","chr13",113979130,113979340,113979235,210
"10851","chr6",149746187,149746630,149746408,443
"10852","chr10",133070922,133071142,133071032,220
"10853","chrX",48826234,48827654,48826944,1420
"10854","chr4",189984078,189984969,189984523,891
"10855","chr7",1059398,1060059,1059728,661
"10856","chr19",35545100,35546087,35545593,987
"10857","chr17",78186996,78187368,78187182,372
"10858","chrX",153610292,153610690,153610491,398
"10859","chr14",68977922,68980109,68979015,2187
"10860","chrX",145822004,145822231,145822117,227
"10861","chr10",114403632,114404840,114404236,1208
"10862","chr3",197791112,197791911,197791511,799
"10863","chr17",44014775,44015064,44014919,289
"10864","chr16",83898777,83899806,83899291,1029
"10865","chr7",29806265,29807135,29806700,870
"10866","chr19",50728375,50728712,50728543,337
"10867","chr12",53197470,53197983,53197726,513
"10868","chr22",43411394,43412449,43411921,1055
"10869","chr21",45018225,45019428,45018826,1203
"10870","chr17",2776453,2777218,2776835,765
"10871","chr14",67599867,67600417,67600142,550
"10872","chr4",112231356,112232500,112231928,1144
"10873","chr6",35786936,35787137,35787036,201
"10874","chr14",67532851,67533723,67533287,872
"10875","chr4",112636876,112637525,112637200,649
"10876","chr6",43229073,43229602,43229337,529
"10877","chr13",52194160,52194719,52194439,559
"10878","chr8",42896069,42897989,42897029,1920
"10879","chr10",101133903,101135302,101134602,1399
"10880","chr14",93430471,93431120,93430795,649
"10881","chr19",19320157,19321385,19320771,1228
"10882","chr4",972944,974349,973646,1405
"10883","chr19",50718190,50719699,50718944,1509
"10884","chr5",43042005,43043375,43042690,1370
"10885","chr16",89048121,89048455,89048288,334
"10886","chr2",121284490,121285517,121285003,1027
"10887","chr6",1623950,1625233,1624591,1283
"10888","chr4",2755926,2756562,2756244,636
"10889","chr16",30417549,30418478,30418013,929
"10890","chr16",17470287,17471005,17470646,718
"10891","chrX",154019234,154020204,154019719,970
"10892","chr6",66094737,66094938,66094837,201
"10893","chr14",31419962,31420818,31420390,856
"10894","chr14",29927004,29928214,29927609,1210
"10895","chr16",90018701,90020011,90019356,1310
"10896","chr14",104171737,104172323,104172030,586
"10897","chr3",3798829,3801088,3799958,2259
"10898","chr9",133568258,133568517,133568387,259
"10899","chr13",26557431,26558540,26557985,1109
"10900","chr8",22864800,22866039,22865419,1239
"10901","chr3",8963180,8963586,8963383,406
"10902","chr11",45921962,45923222,45922592,1260
"10903","chr17",62667146,62667518,62667332,372
"10904","chr2",136764890,136766126,136765508,1236
"10905","chrX",131058157,131058761,131058459,604
"10906","chr3",57164215,57165458,57164836,1243
"10907","chr12",2890499,2891472,2890985,973
"10908","chr3",50336833,50338198,50337515,1365
"10909","chr2",218671687,218672090,218671888,403
"10910","chr15",97652791,97653161,97652976,370
"10911","chr14",73239591,73239969,73239780,378
"10912","chr9",135817930,135819253,135818591,1323
"10913","chr6",44270590,44271050,44270820,460
"10914","chr14",37594458,37596460,37595459,2002
"10915","chr2",240041984,240042448,240042216,464
"10916","chr6",30463785,30464548,30464166,763
"10917","chr7",99143455,99144367,99143911,912
"10918","chrX",153773326,153773568,153773447,242
"10919","chr3",33717714,33718419,33718066,705
"10920","chr7",76166560,76167128,76166844,568
"10921","chr5",180615430,180615965,180615697,535
"10922","chr10",131617156,131617380,131617268,224
"10923","chr14",93787606,93789387,93788496,1781
"10924","chrX",103607791,103608220,103608005,429
"10925","chr7",82324,82592,82458,268
"10926","chr7",32427822,32428336,32428079,514
"10927","chr19",52336225,52336684,52336454,459
"10928","chr7",1096108,1096356,1096232,248
"10929","chr19",929357,929839,929598,482
"10930","chr19",4246831,4247225,4247028,394
"10931","chr9",137204869,137206013,137205441,1144
"10932","chr21",37365924,37367925,37366924,2001
"10933","chr5",93604089,93604510,93604299,421
"10934","chr2",23642703,23642906,23642804,203
"10935","chr21",45555563,45556427,45555995,864
"10936","chr3",11488310,11488646,11488478,336
"10937","chr17",67377108,67379015,67378061,1907
"10938","chr7",141738204,141738593,141738398,389
"10939","chr1",156750955,156752277,156751616,1322
"10940","chr2",26244234,26245078,26244656,844
"10941","chr16",57244894,57245465,57245179,571
"10942","chr14",55411584,55411963,55411773,379
"10943","chr17",3471712,3471943,3471827,231
"10944","chr2",42492644,42495026,42493835,2382
"10945","chr3",37175562,37176541,37176051,979
"10946","chr22",19177548,19179303,19178425,1755
"10947","chr16",19523752,19524313,19524032,561
"10948","chr14",90382650,90384037,90383343,1387
"10949","chr17",263873,264090,263981,217
"10950","chr16",54936389,54938934,54937661,2545
"10951","chr14",76812230,76813066,76812648,836
"10952","chrX",125320053,125320301,125320177,248
"10953","chr9",125407886,125408873,125408379,987
"10954","chr3",52770543,52771112,52770827,569
"10955","chr19",50458494,50459315,50458904,821
"10956","chr16",68642547,68642940,68642743,393
"10957","chr14",53946818,53947046,53946932,228
"10958","chr22",17581174,17581411,17581292,237
"10959","chr13",22838068,22838384,22838226,316
"10960","chr4",83010489,83011041,83010765,552
"10961","chr5",140794988,140795303,140795145,315
"10962","chr10",44005533,44005822,44005677,289
"10963","chr14",94174002,94175311,94174656,1309
"10964","chr19",21835792,21836025,21835908,233
"10965","chr19",55383943,55386796,55385369,2853
"10966","chr19",2511394,2511784,2511589,390
"10967","chr3",42202438,42202879,42202658,441
"10968","chr3",47781431,47782334,47781882,903
"10969","chr17",67244609,67246382,67245495,1773
"10970","chr11",6603322,6603843,6603582,521
"10971","chr12",106581417,106581936,106581676,519
"10972","chr5",64505954,64506778,64506366,824
"10973","chr14",51240073,51240781,51240427,708
"10974","chrX",34146947,34147272,34147109,325
"10975","chr21",10405476,10405738,10405607,262
"10976","chr2",205681879,205682842,205682360,963
"10977","chr19",18416841,18420308,18418574,3467
"10978","chr16",88721156,88721374,88721265,218
"10979","chr7",120519,120758,120638,239
"10980","chr22",41446253,41447915,41447084,1662
"10981","chr21",34669006,34670925,34669965,1919
"10982","chr12",95003606,95003835,95003720,229
"10983","chr19",55858049,55858303,55858176,254
"10984","chr3",105353685,105354118,105353901,433
"10985","chr3",47849639,47850054,47849846,415
"10986","chr9",109640487,109641069,109640778,582
"10987","chr19",577755,578441,578098,686
"10988","chr6",127118862,127119927,127119394,1065
"10989","chr15",40507093,40507329,40507211,236
"10990","chrX",108734980,108735592,108735286,612
"10991","chr10",133158213,133158441,133158327,228
"10992","chr11",117178683,117179006,117178844,323
"10993","chr16",31713330,31713750,31713540,420
"10994","chr12",45215930,45216969,45216449,1039
"10995","chr16",50579197,50579790,50579493,593
"10996","chr10",11610835,11611963,11611399,1128
"10997","chr3",134312820,134313749,134313284,929
"10998","chr8",85642447,85644268,85643357,1821
"10999","chr1",200620424,200620996,200620710,572
"11000","chr19",16197746,16198502,16198124,756
"11001","chr1",165941403,165941741,165941572,338
"11002","chr21",36747492,36748441,36747966,949
"11003","chr19",48603554,48603921,48603737,367
"11004","chr14",105445372,105445732,105445552,360
"11005","chr19",14005720,14007205,14006462,1485
"11006","chr14",61762256,61762550,61762403,294
"11007","chr9",88534068,88535997,88535032,1929
"11008","chr19",13162838,13163302,13163070,464
"11009","chr17",38453491,38454185,38453838,694
"11010","chr15",39934009,39934430,39934219,421
"11011","chr1",182056469,182057376,182056922,907
"11012","chr17",82127164,82127457,82127310,293
"11013","chr9",136843824,136850166,136846995,6342
"11014","chr1",112395873,112396194,112396033,321
"11015","chr9",101398571,101399246,101398908,675
"11016","chr14",64294013,64294523,64294268,510
"11017","chr16",58128850,58129778,58129314,928
"11018","chr1",246723962,246724726,246724344,764
"11019","chr2",69642854,69644584,69643719,1730
"11020","chr10",61662780,61663347,61663063,567
"11021","chr12",80708255,80708937,80708596,682
"11022","chr13",95643889,95644805,95644347,916
"11023","chr1",154627287,154628029,154627658,742
"11024","chr16",18983834,18984255,18984044,421
"11025","chr12",114405217,114405805,114405511,588
"11026","chr20",62285676,62285943,62285809,267
"11027","chr15",34337374,34338195,34337784,821
"11028","chr6",154509426,154510867,154510146,1441
"11029","chr15",90665088,90665795,90665441,707
"11030","chr12",89525235,89526127,89525681,892
"11031","chr11",118971669,118972223,118971946,554
"11032","chr19",57499756,57500375,57500065,619
"11033","chr12",22333901,22335043,22334472,1142
"11034","chr17",17840098,17840674,17840386,576
"11035","chr12",48996834,48998658,48997746,1824
"11036","chr19",16876010,16876282,16876146,272
"11037","chr9",127396931,127398211,127397571,1280
"11038","chr7",66204978,66205639,66205308,661
"11039","chr1",8335283,8335575,8335429,292
"11040","chr1",27234214,27235123,27234668,909
"11041","chr9",34178953,34179482,34179217,529
"11042","chr3",155744128,155744772,155744450,644
"11043","chr1",107140267,107140509,107140388,242
"11044","chr3",112086018,112086233,112086125,215
"11045","chr17",751786,753467,752626,1681
"11046","chr1",39788011,39789500,39788755,1489
"11047","chr13",49247789,49248567,49248178,778
"11048","chr15",90881346,90881607,90881476,261
"11049","chr16",58501136,58501692,58501414,556
"11050","chr5",141394288,141394874,141394581,586
"11051","chr17",75896415,75897367,75896891,952
"11052","chr7",158245016,158245356,158245186,340
"11053","chr19",41882798,41884656,41883727,1858
"11054","chr15",92904273,92904593,92904433,320
"11055","chr3",133573359,133574598,133573978,1239
"11056","chr20",49278021,49278662,49278341,641
"11057","chr19",12880876,12881694,12881285,818
"11058","chr16",88533202,88535122,88534162,1920
"11059","chr1",19251390,19252214,19251802,824
"11060","chr1",18955454,18957389,18956421,1935
"11061","chr17",39151427,39151913,39151670,486
"11062","chr16",33554366,33555254,33554810,888
"11063","chr22",20670451,20671238,20670844,787
"11064","chr3",196208197,196208402,196208299,205
"11065","chr17",4738743,4740115,4739429,1372
"11066","chr4",154489471,154491340,154490405,1869
"11067","chr13",37869545,37870091,37869818,546
"11068","chr12",49827775,49828826,49828300,1051
"11069","chr12",96194061,96195367,96194714,1306
"11070","chr1",3404705,3405746,3405225,1041
"11071","chr15",74022837,74023370,74023103,533
"11072","chr14",95319415,95320089,95319752,674
"11073","chr1",206117302,206117793,206117547,491
"11074","chr22",19171190,19172209,19171699,1019
"11075","chr21",43973511,43973741,43973626,230
"11076","chr4",184456442,184456656,184456549,214
"11077","chr3",130263902,130264247,130264074,345
"11078","chr14",36656014,36656456,36656235,442
"11079","chr19",18571564,18572224,18571894,660
"11080","chr9",64368261,64369990,64369125,1729
"11081","chr16",53424,53996,53710,572
"11082","chr4",39458467,39459191,39458829,724
"11083","chr17",34980333,34981227,34980780,894
"11084","chr2",219160028,219160788,219160408,760
"11085","chr13",35470707,35471344,35471025,637
"11086","chr7",44986359,44987027,44986693,668
"11087","chr20",6212973,6213228,6213100,255
"11088","chr10",23438907,23440594,23439750,1687
"11089","chr2",237691214,237692787,237692000,1573
"11090","chr16",31179499,31180904,31180201,1405
"11091","chr12",98593415,98594425,98593920,1010
"11092","chr19",16355588,16355826,16355707,238
"11093","chrX",74292358,74292734,74292546,376
"11094","chr14",87992552,87993345,87992948,793
"11095","chrX",155612451,155613058,155612754,607
"11096","chr14",99479824,99481851,99480837,2027
"11097","chr19",45423403,45423933,45423668,530
"11098","chr4",146175725,146176410,146176067,685
"11099","chr4",9781411,9783336,9782373,1925
"11100","chr7",2843654,2844680,2844167,1026
"11101","chr1",114154264,114154563,114154413,299
"11102","chr7",116953478,116954271,116953874,793
"11103","chr14",100824186,100824531,100824358,345
"11104","chr14",31025588,31026850,31026219,1262
"11105","chr7",64794322,64794689,64794505,367
"11106","chr4",3316850,3317401,3317125,551
"11107","chr1",155294527,155295745,155295136,1218
"11108","chr21",41316598,41317158,41316878,560
"11109","chr19",17998085,17998463,17998274,378
"11110","chr1",37989560,37990097,37989828,537
"11111","chr16",31331131,31331819,31331475,688
"11112","chr8",23102871,23103414,23103142,543
"11113","chr10",21533921,21535481,21534701,1560
"11114","chr21",33266210,33266770,33266490,560
"11115","chr14",71320138,71321508,71320823,1370
"11116","chr16",28623119,28623710,28623414,591
"11117","chr20",58840080,58842098,58841089,2018
"11118","chr1",6245088,6246403,6245745,1315
"11119","chrX",17655265,17656363,17655814,1098
"11120","chr12",124387589,124387873,124387731,284
"11121","chr1",248906053,248906791,248906422,738
"11122","chr2",158456660,158458301,158457480,1641
"11123","chr2",149320299,149320705,149320502,406
"11124","chr12",129903064,129904230,129903647,1166
"11125","chrX",102516409,102516745,102516577,336
"11126","chr1",45686079,45687408,45686743,1329
"11127","chr9",135485377,135485606,135485491,229
"11128","chr15",89409040,89409830,89409435,790
"11129","chr5",73303131,73303829,73303480,698
"11130","chr12",3199646,3201104,3200375,1458
"11131","chr6",83192887,83194058,83193472,1171
"11132","chr19",6271948,6272165,6272056,217
"11133","chr10",101782954,101783533,101783243,579
"11134","chr19",55624407,55624641,55624524,234
"11135","chr14",52067863,52070004,52068933,2141
"11136","chr6",107459570,107460205,107459887,635
"11137","chr13",24160752,24161399,24161075,647
"11138","chr9",96719620,96720188,96719904,568
"11139","chr13",110678819,110679026,110678922,207
"11140","chr19",21940850,21941084,21940967,234
"11141","chr19",35673175,35673384,35673279,209
"11142","chr2",88284009,88284451,88284230,442
"11143","chrX",73003006,73004241,73003623,1235
"11144","chr1",174999353,175000488,174999920,1135
"11145","chr7",158919868,158920403,158920135,535
"11146","chr8",141221564,141221875,141221719,311
"11147","chrX",49199889,49200428,49200158,539
"11148","chr1",8025494,8026794,8026144,1300
"11149","chr6",147406946,147407184,147407065,238
"11150","chr19",1304767,1305063,1304915,296
"11151","chr19",50912746,50912993,50912869,247
"11152","chr12",130838605,130839315,130838960,710
"11153","chrX",93673547,93673787,93673667,240
"11154","chr1",26279871,26280422,26280146,551
"11155","chr16",6018913,6020400,6019656,1487
"11156","chr1",21884499,21884825,21884662,326
"11157","chr2",199470774,199471690,199471232,916
"11158","chr22",39381660,39381882,39381771,222
"11159","chrX",137569019,137569497,137569258,478
"11160","chr19",3982826,3983192,3983009,366
"11161","chr12",57736045,57736578,57736311,533
"11162","chr1",6241815,6242796,6242305,981
"11163","chr12",22335530,22335732,22335631,202
"11164","chr12",1645831,1646077,1645954,246
"11165","chr12",124928345,124928619,124928482,274
"11166","chrX",134459883,134460798,134460340,915
"11167","chr1",148245885,148246644,148246264,759
"11168","chr11",63985942,63986982,63986462,1040
"11169","chr14",89891786,89892044,89891915,258
"11170","chr3",20039966,20040934,20040450,968
"11171","chr1",51344655,51345015,51344835,360
"11172","chr19",14979204,14980061,14979632,857
"11173","chr3",57097616,57098379,57097997,763
"11174","chr14",24429667,24430172,24429919,505
"11175","chr19",10568458,10569360,10568909,902
"11176","chr2",146587233,146587811,146587522,578
"11177","chr4",39638536,39639303,39638919,767
"11178","chr16",75432952,75433629,75433290,677
"11179","chr9",124868864,124869985,124869424,1121
"11180","chr12",8697456,8698807,8698131,1351
"11181","chr19",3970849,3971480,3971164,631
"11182","chrX",40646924,40647730,40647327,806
"11183","chr4",67700885,67701358,67701121,473
"11184","chr17",42072361,42072878,42072619,517
"11185","chr16",67430485,67431559,67431022,1074
"11186","chr19",48485053,48485268,48485160,215
"11187","chr22",23767400,23768808,23768104,1408
"11188","chr2",119366665,119367711,119367188,1046
"11189","chr7",158484911,158485447,158485179,536
"11190","chr7",101162983,101165783,101164383,2800
"11191","chr7",117561,117866,117713,305
"11192","chr19",40629372,40629744,40629558,372
"11193","chr2",79512570,79513117,79512843,547
"11194","chr12",132212116,132213179,132212647,1063
"11195","chr1",54052928,54053626,54053277,698
"11196","chr19",15379045,15380221,15379633,1176
"11197","chr7",57179881,57180220,57180050,339
"11198","chr16",35170144,35170409,35170276,265
"11199","chr2",219627383,219628065,219627724,682
"11200","chr10",133432970,133433397,133433183,427
"11201","chr7",767699,768624,768161,925
"11202","chr12",6383723,6384356,6384039,633
"11203","chr1",83998540,83999549,83999044,1009
"11204","chr8",143470410,143470617,143470513,207
"11205","chr12",52032954,52033402,52033178,448
"11206","chrX",26557641,26558055,26557848,414
"11207","chr19",18895222,18896737,18895979,1515
"11208","chr19",44002927,44003148,44003037,221
"11209","chr7",97005310,97005603,97005456,293
"11210","chr3",129027056,129027492,129027274,436
"11211","chr3",52221349,52221747,52221548,398
"11212","chr8",144807325,144808458,144807891,1133
"11213","chr12",57772469,57772958,57772713,489
"11214","chr19",7924612,7926314,7925463,1702
"11215","chr2",95345384,95347449,95346416,2065
"11216","chr8",144059647,144060925,144060286,1278
"11217","chr16",11796468,11797665,11797066,1197
"11218","chr22",37206962,37207714,37207338,752
"11219","chr6",44297233,44297974,44297603,741
"11220","chr6",85593395,85594343,85593869,948
"11221","chrX",21655900,21658948,21657424,3048
"11222","chr1",21782636,21783768,21783202,1132
"11223","chr7",64192252,64192584,64192418,332
"11224","chr9",14693032,14693578,14693305,546
"11225","chr19",10230100,10231578,10230839,1478
"11226","chr1",27659794,27660297,27660045,503
"11227","chr19",2430283,2430600,2430441,317
"11228","chr8",143789816,143790091,143789953,275
"11229","chr7",542049,542305,542177,256
"11230","chr8",98046017,98046445,98046231,428
"11231","chr1",149840182,149843477,149841829,3295
"11232","chr8",665143,665352,665247,209
"11233","chr12",122021390,122023461,122022425,2071
"11234","chr17",81414634,81415127,81414880,493
"11235","chr14",30558927,30559606,30559266,679
"11236","chr16",28863344,28864237,28863790,893
"11237","chr8",132775195,132775790,132775492,595
"11238","chr4",84481611,84482022,84481816,411
"11239","chrX",53082099,53082834,53082466,735
"11240","chr1",162069428,162070262,162069845,834
"11241","chr1",28886926,28887788,28887357,862
"11242","chr17",56596572,56597005,56596788,433
"11243","chr7",107579899,107580177,107580038,278
"11244","chr15",65395701,65396201,65395951,500
"11245","chr19",11674227,11674467,11674347,240
"11246","chr17",47778186,47778656,47778421,470
"11247","chr17",1754153,1754383,1754268,230
"11248","chr3",50340372,50341109,50340740,737
"11249","chr2",42101349,42101687,42101518,338
"11250","chr6",291948,292839,292393,891
"11251","chr3",57597293,57597884,57597588,591
"11252","chr12",10722538,10723581,10723059,1043
"11253","chr4",720138,720348,720243,210
"11254","chr1",233613698,233614804,233614251,1106
"11255","chr6",133892821,133893213,133893017,392
"11256","chr1",173669523,173669906,173669714,383
"11257","chr2",178193884,178195417,178194650,1533
"11258","chr11",66051896,66052753,66052324,857
"11259","chr1",43068219,43068663,43068441,444
"11260","chr1",217630925,217631135,217631030,210
"11261","chr1",3624203,3625677,3624940,1474
"11262","chr1",27527800,27528452,27528126,652
"11263","chr16",25106670,25107278,25106974,608
"11264","chr12",2812683,2812961,2812822,278
"11265","chr19",12035215,12035834,12035524,619
"11266","chr3",87226722,87227436,87227079,714
"11267","chr6",26043975,26044241,26044108,266
"11268","chr10",1102027,1102331,1102179,304
"11269","chr1",84479249,84479667,84479458,418
"11270","chr10",87864120,87864328,87864224,208
"11271","chr9",85741225,85742450,85741837,1225
"11272","chrX",47619271,47620116,47619693,845
"11273","chr1",223748640,223749342,223748991,702
"11274","chr3",167734588,167735042,167734815,454
"11275","chr4",39976446,39978172,39977309,1726
"11276","chr6",27871920,27872291,27872105,371
"11277","chr19",30443915,30445719,30444817,1804
"11278","chr14",75982280,75983046,75982663,766
"11279","chr1",143729711,143729995,143729853,284
"11280","chr1",71046541,71048121,71047331,1580
"11281","chr3",174377205,174377468,174377336,263
"11282","chr19",52689886,52690692,52690289,806
"11283","chr9",25677496,25678686,25678091,1190
"11284","chr2",202634679,202635890,202635284,1211
"11285","chr14",99118068,99118673,99118370,605
"11286","chr18",58195421,58195641,58195531,220
"11287","chr13",113490163,113491310,113490736,1147
"11288","chr8",79767434,79768772,79768103,1338
"11289","chr5",73215893,73216615,73216254,722
"11290","chr19",46787328,46788726,46788027,1398
"11291","chr16",85517776,85518103,85517939,327
"11292","chr1",15834765,15836385,15835575,1620
"11293","chr20",33992993,33994784,33993888,1791
"11294","chr12",30200982,30201679,30201330,697
"11295","chr10",97043308,97043677,97043492,369
"11296","chr13",27966219,27967142,27966680,923
"11297","chr2",170815800,170818937,170817368,3137
"11298","chr16",90047574,90048012,90047793,438
"11299","chr10",132646770,132646975,132646872,205
"11300","chr19",1455227,1457313,1456270,2086
"11301","chr2",44768525,44768731,44768628,206
"11302","chr1",54474673,54475080,54474876,407
"11303","chr2",8676184,8677134,8676659,950
"11304","chr19",37906363,37907525,37906944,1162
"11305","chr10",101236277,101236889,101236583,612
"11306","chr7",5605292,5605511,5605401,219
"11307","chr19",5785388,5785808,5785598,420
"11308","chr1",6961941,6962248,6962094,307
"11309","chr8",143519521,143519725,143519623,204
"11310","chr19",12723845,12724060,12723952,215
"11311","chr1",205568623,205569438,205569030,815
"11312","chr20",35284153,35284936,35284544,783
"11313","chr3",196044585,196044842,196044713,257
"11314","chr16",69320959,69321283,69321121,324
"11315","chr19",9966355,9966768,9966561,413
"11316","chr19",52297146,52297618,52297382,472
"11317","chr1",1561381,1561606,1561493,225
"11318","chr22",46366838,46367073,46366955,235
"11319","chr21",43718412,43719950,43719181,1538
"11320","chr1",221742132,221743462,221742797,1330
"11321","chr3",75434651,75436138,75435394,1487
"11322","chr21",42106460,42106707,42106583,247
"11323","chr22",46053752,46054235,46053993,483
"11324","chr1",22451743,22452324,22452033,581
"11325","chr2",36355254,36357117,36356185,1863
"11326","chr1",150548873,150549892,150549382,1019
"11327","chr8",964817,965894,965355,1077
"11328","chr14",50311962,50312826,50312394,864
"11329","chr9",35616983,35617327,35617155,344
"11330","chr9",137017057,137018433,137017745,1376
"11331","chr14",70234097,70234333,70234215,236
"11332","chr13",32427112,32427740,32427426,628
"11333","chr3",45841729,45842368,45842048,639
"11334","chr6",165334274,165334481,165334377,207
"11335","chr11",61815101,61817256,61816178,2155
"11336","chr6",73309705,73310330,73310017,625
"11337","chr1",25267466,25267996,25267731,530
"11338","chr2",217978658,217979019,217978838,361
"11339","chr3",184491306,184491555,184491430,249
"11340","chr1",21436577,21436923,21436750,346
"11341","chr2",44937422,44939428,44938425,2006
"11342","chr7",64100041,64100498,64100269,457
"11343","chr14",91288936,91289220,91289078,284
"11344","chr9",136482658,136484722,136483690,2064
"11345","chr4",967559,968367,967963,808
"11346","chr2",113291251,113291478,113291364,227
"11347","chr19",7625823,7626219,7626021,396
"11348","chr16",85286968,85287169,85287068,201
"11349","chr6",158939593,158939920,158939756,327
"11350","chr10",21525857,21527599,21526728,1742
"11351","chr9",133893339,133893780,133893559,441
"11352","chr1",48471632,48472399,48472015,767
"11353","chr12",2115243,2115479,2115361,236
"11354","chr19",43639363,43640347,43639855,984
"11355","chr16",1989856,1993025,1991440,3169
"11356","chr21",33541997,33543376,33542686,1379
"11357","chr16",14833786,14834184,14833985,398
"11358","chr1",44775341,44776228,44775784,887
"11359","chr19",56120402,56121707,56121054,1305
"11360","chr2",70706156,70706431,70706293,275
"11361","chr20",43914457,43916497,43915477,2040
"11362","chrY",9868939,9869232,9869085,293
"11363","chr14",102304779,102305381,102305080,602
"11364","chr3",195761724,195763072,195762398,1348
"11365","chr3",141659876,141660429,141660152,553
"11366","chr14",37611034,37611473,37611253,439
"11367","chr2",102142346,102143117,102142731,771
"11368","chr2",222302486,222302841,222302663,355
"11369","chr2",202774204,202774434,202774319,230
"11370","chr17",17781702,17783926,17782814,2224
"11371","chr4",13524929,13525146,13525037,217
"11372","chr17",79784769,79785066,79784917,297
"11373","chr15",34436586,34437871,34437228,1285
"11374","chr3",49017781,49018884,49018332,1103
"11375","chr1",3408682,3409115,3408898,433
"11376","chr12",53054224,53054622,53054423,398
"11377","chr12",40105160,40106215,40105687,1055
"11378","chr1",39490752,39492465,39491608,1713
"11379","chr1",109509332,109509883,109509607,551
"11380","chr19",10315705,10316047,10315876,342
"11381","chr12",13981692,13982003,13981847,311
"11382","chr6",84227398,84228010,84227704,612
"11383","chr14",104473891,104474129,104474010,238
"11384","chr9",88076203,88077168,88076685,965
"11385","chr10",122643142,122643448,122643295,306
"11386","chr1",154405194,154405969,154405581,775
"11387","chr21",42686058,42686436,42686247,378
"11388","chr4",25096038,25096293,25096165,255
"11389","chr12",132603300,132603750,132603525,450
"11390","chr1",150629234,150629725,150629479,491
"11391","chr10",128286774,128287161,128286967,387
"11392","chr11",44957064,44957479,44957271,415
"11393","chr1",26432001,26432365,26432183,364
"11394","chr6",21594382,21596206,21595294,1824
"11395","chr12",70609844,70610277,70610060,433
"11396","chr7",159773,160039,159906,266
"11397","chr2",10120152,10120804,10120478,652
"11398","chr10",47564945,47566050,47565497,1105
"11399","chr12",22543846,22544794,22544320,948
"11400","chr1",235160949,235161402,235161175,453
"11401","chr19",3649055,3650032,3649543,977
"11402","chr14",69547826,69548276,69548051,450
"11403","chr19",11528799,11529082,11528940,283
"11404","chr14",94080655,94081319,94080987,664
"11405","chr14",95156743,95157883,95157313,1140
"11406","chr10",102642064,102645211,102643637,3147
"11407","chr15",90233467,90234404,90233935,937
"11408","chr2",233939003,233939213,233939108,210
"11409","chr22",50424327,50424538,50424432,211
"11410","chr12",132118822,132119101,132118961,279
"11411","chr1",248691729,248692169,248691949,440
"11412","chr20",50190061,50192485,50191273,2424
"11413","chr16",2496263,2497038,2496650,775
"11414","chr12",130715279,130715612,130715445,333
"11415","chr3",183179132,183179593,183179362,461
"11416","chr1",28369530,28370220,28369875,690
"11417","chr19",48291096,48291470,48291283,374
"11418","chr17",43906780,43907644,43907212,864
"11419","chr1",17419704,17420051,17419877,347
"11420","chr3",52410550,52411088,52410819,538
"11421","chr1",115337546,115338711,115338128,1165
"11422","chr9",69671888,69673165,69672526,1277
"11423","chr6",165854021,165854299,165854160,278
"11424","chr19",17075233,17076423,17075828,1190
"11425","chr22",44496513,44498411,44497462,1898
"11426","chr14",74955497,74955952,74955724,455
"11427","chr1",213982657,213983508,213983082,851
"11428","chr7",5371041,5371358,5371199,317
"11429","chr1",197917958,197918661,197918309,703
"11430","chr17",7439510,7440709,7440109,1199
"11431","chr14",99971044,99972526,99971785,1482
"11432","chr7",135662308,135662750,135662529,442
"11433","chr2",241857336,241857544,241857440,208
"11434","chr14",95875872,95877233,95876552,1361
"11435","chr12",71439412,71440609,71440010,1197
"11436","chr16",2339705,2342163,2340934,2458
"11437","chr7",604544,604824,604684,280
"11438","chr19",57118971,57119265,57119118,294
"11439","chr14",20971419,20971749,20971584,330
"11440","chr1",58546249,58546905,58546577,656
"11441","chr4",105473394,105474165,105473779,771
"11442","chr19",56403987,56404487,56404237,500
"11443","chr16",89686470,89687276,89686873,806
"11444","chr12",53973031,53975319,53974175,2288
"11445","chr1",206506903,206508111,206507507,1208
"11446","chr11",94543728,94545747,94544737,2019
"11447","chr7",128910356,128910849,128910602,493
"11448","chr17",8247808,8248202,8248005,394
"11449","chr8",89984144,89984729,89984436,585
"11450","chr10",5498822,5499552,5499187,730
"11451","chr3",32401660,32401963,32401811,303
"11452","chr14",69151619,69153741,69152680,2122
"11453","chr15",37100400,37100672,37100536,272
"11454","chr14",39431472,39433002,39432237,1530
"11455","chr1",207321198,207322019,207321608,821
"11456","chr17",76103657,76103974,76103815,317
"11457","chr3",38165007,38166137,38165572,1130
"11458","chr19",3747834,3748089,3747961,255
"11459","chr22",30822239,30822906,30822572,667
"11460","chrX",18983885,18985126,18984505,1241
"11461","chr3",32780781,32781839,32781310,1058
"11462","chr12",102957360,102958917,102958138,1557
"11463","chr19",33134561,33134899,33134730,338
"11464","chrX",153056076,153056527,153056301,451
"11465","chr19",8697463,8698444,8697953,981
"11466","chr14",21510803,21511557,21511180,754
"11467","chr12",52879447,52879714,52879580,267
"11468","chr18",48975254,48976606,48975930,1352
"11469","chr19",57583371,57584396,57583883,1025
"11470","chr2",238320233,238320795,238320514,562
"11471","chr3",53160700,53162117,53161408,1417
"11472","chr17",43713742,43714108,43713925,366
"11473","chr9",96654622,96655544,96655083,922
"11474","chr1",42456045,42456904,42456474,859
"11475","chr10",133465212,133465612,133465412,400
"11476","chr22",43174055,43174316,43174185,261
"11477","chr13",110306544,110308243,110307393,1699
"11478","chr17",21126743,21127501,21127122,758
"11479","chr9",128688693,128690403,128689548,1710
"11480","chr17",30705991,30706333,30706162,342
"11481","chr15",66356446,66356840,66356643,394
"11482","chr14",105489838,105491860,105490849,2022
"11483","chr22",46678761,46678982,46678871,221
"11484","chr17",79197985,79198187,79198086,202
"11485","chr4",39771190,39771689,39771439,499
"11486","chr7",43583091,43583793,43583442,702
"11487","chr7",155796569,155797172,155796870,603
"11488","chr19",50836037,50836254,50836145,217
"11489","chr3",194629607,194631118,194630362,1511
"11490","chr19",48954669,48955236,48954952,567
"11491","chr17",20895644,20896799,20896221,1155
"11492","chr18",3012549,3013268,3012908,719
"11493","chr10",42898028,42898969,42898498,941
"11494","chr21",32612057,32613140,32612598,1083
"11495","chr3",198157260,198157481,198157370,221
"11496","chr19",4007163,4008169,4007666,1006
"11497","chr14",59187912,59189612,59188762,1700
"11498","chr3",13073127,13073745,13073436,618
"11499","chr9",96496512,96497239,96496875,727
"11500","chr14",105600063,105600865,105600464,802
"11501","chr13",113584624,113585603,113585113,979
"11502","chr1",248811896,248812318,248812107,422
"11503","chr6",166342324,166343022,166342673,698
"11504","chr7",5529431,5530963,5530197,1532
"11505","chrX",155070787,155071520,155071153,733
"11506","chr3",190322028,190322676,190322352,648
"11507","chr6",13364767,13365717,13365242,950
"11508","chr11",72590258,72590702,72590480,444
"11509","chr7",123532678,123533177,123532927,499
"11510","chr13",111973114,111973328,111973221,214
"11511","chr1",10474861,10475115,10474988,254
"11512","chr1",2642591,2643425,2643008,834
"11513","chr1",216600997,216601392,216601194,395
"11514","chrX",3345312,3347306,3346309,1994
"11515","chr20",63978773,63979810,63979291,1037
"11516","chr1",118979762,118980015,118979888,253
"11517","chr6",24720370,24721692,24721031,1322
"11518","chr22",23566135,23566836,23566485,701
"11519","chr10",58512740,58513696,58513218,956
"11520","chr20",31484109,31484512,31484310,403
"11521","chr12",122835203,122836496,122835849,1293
"11522","chr10",132603904,132604121,132604012,217
"11523","chr17",82782658,82783053,82782855,395
"11524","chr19",22517594,22518459,22518026,865
"11525","chr1",47416224,47417393,47416808,1169
"11526","chr17",74972072,74973069,74972570,997
"11527","chr18",78914507,78914797,78914652,290
"11528","chr16",68235107,68238240,68236673,3133
"11529","chr3",63863370,63864681,63864025,1311
"11530","chr21",41854516,41854804,41854660,288
"11531","chr9",93306859,93307098,93306978,239
"11532","chr10",43689591,43690684,43690137,1093
"11533","chr1",3080708,3080909,3080808,201
"11534","chr5",11384569,11385409,11384989,840
"11535","chr6",41593483,41593735,41593609,252
"11536","chr14",91059889,91061208,91060548,1319
"11537","chr13",112547392,112547613,112547502,221
"11538","chr12",109154510,109154828,109154669,318
"11539","chr17",7688176,7688521,7688348,345
"11540","chr12",128366004,128366210,128366107,206
"11541","chr7",893189,893671,893430,482
"11542","chr18",79745235,79746486,79745860,1251
"11543","chr3",10141621,10142257,10141939,636
"11544","chr17",79097290,79097723,79097506,433
"11545","chr13",114073183,114073617,114073400,434
"11546","chr6",37648946,37649403,37649174,457
"11547","chr14",69611600,69612360,69611980,760
"11548","chr4",70902076,70902946,70902511,870
"11549","chr4",6909208,6910583,6909895,1375
"11550","chr12",6056775,6057091,6056933,316
"11551","chr5",141427772,141428221,141427996,449
"11552","chr12",6828405,6829475,6828940,1070
"11553","chr19",48137461,48137757,48137609,296
"11554","chr17",39165229,39165846,39165537,617
"11555","chr5",5495048,5495264,5495156,216
"11556","chr1",40303514,40304199,40303856,685
"11557","chr1",212035495,212036022,212035758,527
"11558","chr19",23470889,23471442,23471165,553
"11559","chr14",92793962,92794579,92794270,617
"11560","chr16",88436406,88437932,88437169,1526
"11561","chr11",78188518,78188944,78188731,426
"11562","chr3",50611508,50612398,50611953,890
"11563","chr6",170446562,170446804,170446683,242
"11564","chr16",56617069,56617372,56617220,303
"11565","chr2",66575758,66577699,66576728,1941
"11566","chr1",10835838,10836060,10835949,222
"11567","chr11",76206227,76211040,76208633,4813
"11568","chr10",116271067,116274718,116272892,3651
"11569","chr17",82750316,82750652,82750484,336
"11570","chr4",75939936,75941273,75940604,1337
"11571","chr7",27142994,27145943,27144468,2949
"11572","chr9",23820693,23822137,23821415,1444
"11573","chr19",13880187,13880403,13880295,216
"11574","chr19",49085101,49085823,49085462,722
"11575","chr2",98935722,98937368,98936545,1646
"11576","chr4",3373006,3373271,3373138,265
"11577","chrX",48911486,48911937,48911711,451
"11578","chr1",116944627,116945023,116944825,396
"11579","chr4",112379396,112379613,112379504,217
"11580","chrX",83508563,83509454,83509008,891
"11581","chr3",13570423,13570935,13570679,512
"11582","chr19",42375485,42376136,42375810,651
"11583","chr1",24187050,24187987,24187518,937
"11584","chr3",27730147,27730451,27730299,304
"11585","chr2",64859670,64860046,64859858,376
"11586","chr14",57390226,57391633,57390929,1407
"11587","chr7",1246475,1248022,1247248,1547
"11588","chr12",47705534,47706122,47705828,588
"11589","chr5",1289160,1295855,1292507,6695
"11590","chr7",98194097,98194504,98194300,407
"11591","chr5",64690362,64691147,64690754,785
"11592","chr14",96391274,96391788,96391531,514
"11593","chr16",2164221,2165918,2165069,1697
"11594","chr1",11273202,11273490,11273346,288
"11595","chr12",127455396,127456362,127455879,966
"11596","chr4",38014532,38014820,38014676,288
"11597","chr19",49580500,49580729,49580614,229
"11598","chrX",147981151,147981397,147981274,246
"11599","chr13",20721472,20722299,20721885,827
"11600","chr1",147599456,147600151,147599803,695
"11601","chr19",45601964,45602209,45602086,245
"11602","chrX",23667702,23667929,23667815,227
"11603","chrX",154546678,154547921,154547299,1243
"11604","chr3",112333046,112333559,112333302,513
"11605","chr5",137753444,137755189,137754316,1745
"11606","chr1",1539582,1541289,1540435,1707
"11607","chr1",44213331,44213793,44213562,462
"11608","chr12",124456768,124457038,124456903,270
"11609","chr19",50325757,50325971,50325864,214
"11610","chr19",19063453,19064186,19063819,733
"11611","chr5",154610397,154611038,154610717,641
"11612","chr14",92922900,92923554,92923227,654
"11613","chrX",135521949,135522202,135522075,253
"11614","chr1",26306345,26306798,26306571,453
"11615","chr16",2213911,2215427,2214669,1516
"11616","chr17",76585099,76586314,76585706,1215
"11617","chr14",37172027,37172674,37172350,647
"11618","chr19",3463014,3464360,3463687,1346
"11619","chr19",22807207,22807849,22807528,642
"11620","chr9",88387826,88389415,88388620,1589
"11621","chr16",70065371,70066324,70065847,953
"11622","chr6",144063757,144064751,144064254,994
"11623","chr5",176647137,176647622,176647379,485
"11624","chr14",94864646,94864858,94864752,212
"11625","chr7",100478831,100479162,100478996,331
"11626","chr6",519079,521338,520208,2259
"11627","chr4",1230663,1230940,1230801,277
"11628","chr17",50397155,50397734,50397444,579
"11629","chrX",108732629,108732992,108732810,363
"11630","chr17",28743520,28744552,28744036,1032
"11631","chr2",25215856,25216224,25216040,368
"11632","chr7",158957532,158957807,158957669,275
"11633","chr7",1841545,1841755,1841650,210
"11634","chr1",228157676,228158999,228158337,1323
"11635","chr8",28493939,28495043,28494491,1104
"11636","chr7",28179411,28180619,28180015,1208
"11637","chr19",518847,519905,519376,1058
"11638","chr1",228471236,228471451,228471343,215
"11639","chr16",88749450,88749687,88749568,237
"11640","chr17",7561349,7562506,7561927,1157
"11641","chr7",154914036,154914779,154914407,743
"11642","chr2",231613648,231615214,231614431,1566
"11643","chr1",161117932,161118322,161118127,390
"11644","chr1",240091659,240093763,240092711,2104
"11645","chrX",77895340,77895750,77895545,410
"11646","chr10",37680208,37681422,37680815,1214
"11647","chr4",143699669,143701065,143700367,1396
"11648","chr19",54180759,54181159,54180959,400
"11649","chr1",68163316,68163519,68163417,203
"11650","chr14",104714680,104715113,104714896,433
"11651","chr1",229407196,229408023,229407609,827
"11652","chr4",4248039,4248543,4248291,504
"11653","chr12",52006683,52007912,52007297,1229
"11654","chr13",20773304,20774118,20773711,814
"11655","chr10",109923017,109923725,109923371,708
"11656","chr4",136812297,136812588,136812442,291
"11657","chr3",46717574,46718060,46717817,486
"11658","chrX",37847042,37847719,37847380,677
"11659","chr4",38867543,38868159,38867851,616
"11660","chr12",57216193,57217385,57216789,1192
"11661","chr16",88151250,88151495,88151372,245
"11662","chrX",41922853,41924005,41923429,1152
"11663","chr3",180602035,180602605,180602320,570
"11664","chr19",6002680,6002927,6002803,247
"11665","chr14",22821869,22822128,22821998,259
"11666","chrX",139203665,139205460,139204562,1795
"11667","chr2",128091089,128091636,128091362,547
"11668","chr17",76736385,76738140,76737262,1755
"11669","chr19",5339629,5341050,5340339,1421
"11670","chr3",133927250,133927806,133927528,556
"11671","chr19",36032614,36032985,36032799,371
"11672","chr7",93574773,93575069,93574921,296
"11673","chr12",56449062,56449471,56449266,409
"11674","chr17",40362713,40364012,40363362,1299
"11675","chr19",38361671,38362845,38362258,1174
"11676","chr1",61742155,61743146,61742650,991
"11677","chr20",34704011,34704764,34704387,753
"11678","chr14",64540156,64542479,64541317,2323
"11679","chr2",96550051,96550488,96550269,437
"11680","chr10",129898815,129899148,129898981,333
"11681","chr22",39456200,39457987,39457093,1787
"11682","chr2",43637183,43637817,43637500,634
"11683","chr21",45553992,45554539,45554265,547
"11684","chr9",135734698,135734943,135734820,245
"11685","chr19",53909456,53909833,53909644,377
"11686","chr10",129794129,129794352,129794240,223
"11687","chr1",247111283,247112455,247111869,1172
"11688","chr10",99659111,99659832,99659471,721
"11689","chr14",55440479,55440715,55440597,236
"11690","chr14",102015874,102016076,102015975,202
"11691","chr19",49487983,49488261,49488122,278
"11692","chr1",33159658,33159926,33159792,268
"11693","chr10",133189213,133189479,133189346,266
"11694","chr1",43367875,43368466,43368170,591
"11695","chr8",26448337,26450222,26449279,1885
"11696","chr19",48696707,48696927,48696817,220
"11697","chr13",113548281,113548547,113548414,266
"11698","chr12",124988868,124989278,124989073,410
"11699","chr17",56833135,56835109,56834122,1974
"11700","chr1",143651544,143652033,143651788,489
"11701","chr14",24398820,24399384,24399102,564
"11702","chr14",56807889,56810122,56809005,2233
"11703","chr4",176319784,176320681,176320232,897
"11704","chr16",67872906,67873408,67873157,502
"11705","chr16",30571415,30572512,30571963,1097
"11706","chr2",241200358,241200570,241200464,212
"11707","chr2",172086561,172087431,172086996,870
"11708","chrX",54495012,54496316,54495664,1304
"11709","chr12",48105680,48106449,48106064,769
"11710","chr16",4957818,4958501,4958159,683
"11711","chr13",112882501,112883202,112882851,701
"11712","chr19",45884069,45886320,45885194,2251
"11713","chr10",103276871,103278327,103277599,1456
"11714","chr2",127060418,127060655,127060536,237
"11715","chr7",17940151,17940919,17940535,768
"11716","chr16",31700518,31701022,31700770,504
"11717","chrX",49331496,49332110,49331803,614
"11718","chr21",44931413,44932996,44932204,1583
"11719","chr8",17246555,17247354,17246954,799
"11720","chr13",20566812,20567580,20567196,768
"11721","chr1",214280753,214281704,214281228,951
"11722","chr19",58480370,58480767,58480568,397
"11723","chr12",132792609,132793704,132793156,1095
"11724","chrX",129654026,129655218,129654622,1192
"11725","chr17",8295122,8295852,8295487,730
"11726","chr4",128809491,128809871,128809681,380
"11727","chr10",87355106,87355425,87355265,319
"11728","chr17",28251246,28251656,28251451,410
"11729","chr1",1286017,1294783,1290400,8766
"11730","chr1",41241285,41242655,41241970,1370
"11731","chr7",121872992,121873728,121873360,736
"11732","chr14",103220221,103221039,103220630,818
"11733","chr9",37800568,37801566,37801067,998
"11734","chr2",120576732,120577225,120576978,493
"11735","chr14",18583746,18584428,18584087,682
"11736","chr2",197705187,197706224,197705705,1037
"11737","chr10",99731923,99732597,99732260,674
"11738","chr1",3645293,3645559,3645426,266
"11739","chr3",143970891,143973437,143972164,2546
"11740","chr19",46000850,46001072,46000961,222
"11741","chr12",124372010,124372255,124372132,245
"11742","chr8",22024734,22025372,22025053,638
"11743","chr8",1482586,1483158,1482872,572
"11744","chr20",62804476,62805776,62805126,1300
"11745","chr19",10323348,10323572,10323460,224
"11746","chr2",68466915,68467965,68467440,1050
"11747","chr9",136907965,136908372,136908168,407
"11748","chr13",32586147,32587698,32586922,1551
"11749","chr6",36839105,36841032,36840068,1927
"11750","chr1",204516345,204516703,204516524,358
"11751","chr5",213076,213361,213218,285
"11752","chr2",177212457,177213487,177212972,1030
"11753","chr19",39435584,39436223,39435903,639
"11754","chr3",196632330,196632813,196632571,483
"11755","chr10",80078603,80079322,80078962,719
"11756","chr3",196968448,196970194,196969321,1746
"11757","chr10",49326229,49326659,49326444,430
"11758","chr14",36646983,36648423,36647703,1440
"11759","chr16",823398,823614,823506,216
"11760","chr10",3172106,3173068,3172587,962
"11761","chr7",23206302,23206542,23206422,240
"11762","chr20",45436790,45437074,45436932,284
"11763","chr9",135989945,135990181,135990063,236
"11764","chr12",69470214,69470693,69470453,479
"11765","chr9",133347575,133348905,133348240,1330
"11766","chr4",48779314,48780322,48779818,1008
"11767","chrX",38803653,38805511,38804582,1858
"11768","chr16",84648154,84649126,84648640,972
"11769","chr1",48898882,48899241,48899061,359
"11770","chr2",175167657,175168547,175168102,890
"11771","chr11",64285135,64286180,64285657,1045
"11772","chr1",3012591,3012812,3012701,221
"11773","chr8",1027625,1028351,1027988,726
"11774","chr12",15881997,15882902,15882449,905
"11775","chr1",145720881,145721118,145720999,237
"11776","chr7",149422307,149423216,149422761,909
"11777","chr6",25652230,25652481,25652355,251
"11778","chr12",5494421,5494824,5494622,403
"11779","chr19",32691703,32692656,32692179,953
"11780","chr22",41832503,41833980,41833241,1477
"11781","chr17",82861143,82861384,82861263,241
"11782","chr1",26345954,26346159,26346056,205
"11783","chrX",80573271,80573560,80573415,289
"11784","chr7",56483795,56484020,56483907,225
"11785","chr2",222318294,222320220,222319257,1926
"11786","chr2",74554288,74555558,74554923,1270
"11787","chr19",40777975,40778371,40778173,396
"11788","chr12",34022295,34022520,34022407,225
"11789","chr3",142962295,142964426,142963360,2131
"11790","chr8",123207171,123207569,123207370,398
"11791","chr8",30811934,30812441,30812187,507
"11792","chr1",13583111,13583347,13583229,236
"11793","chr10",113126698,113126981,113126839,283
"11794","chr20",38446584,38447211,38446897,627
"11795","chr8",11466270,11467188,11466729,918
"11796","chr18",13217074,13219045,13218059,1971
"11797","chr14",105398143,105399128,105398635,985
"11798","chr12",32106315,32107217,32106766,902
"11799","chr1",31239231,31239965,31239598,734
"11800","chr18",12777497,12778114,12777805,617
"11801","chr14",102229118,102229467,102229292,349
"11802","chr19",1285397,1286575,1285986,1178
"11803","chr19",22634472,22634744,22634608,272
"11804","chr1",162367086,162367531,162367308,445
"11805","chr7",128854457,128854676,128854566,219
"11806","chr3",183491879,183492155,183492017,276
"11807","chr7",117872888,117873811,117873349,923
"11808","chr3",150611670,150611941,150611805,271
"11809","chr9",35731813,35732760,35732286,947
"11810","chr1",178724833,178726013,178725423,1180
"11811","chr7",98869400,98870435,98869917,1035
"11812","chr2",216371302,216372408,216371855,1106
"11813","chr7",63068088,63068593,63068340,505
"11814","chr1",156338382,156338651,156338516,269
"11815","chr10",45726968,45727839,45727403,871
"11816","chr1",46489121,46491449,46490285,2328
"11817","chr4",92305197,92305856,92305526,659
"11818","chr3",81761164,81761802,81761483,638
"11819","chr14",103561971,103563334,103562652,1363
"11820","chr20",63043723,63044465,63044094,742
"11821","chr19",11925084,11925618,11925351,534
"11822","chr5",147509187,147510165,147509676,978
"11823","chr15",40281427,40283917,40282672,2490
"11824","chr15",85380373,85381449,85380911,1076
"11825","chr7",70595848,70596470,70596159,622
"11826","chr16",74718799,74719012,74718905,213
"11827","chr16",35425226,35425689,35425457,463
"11828","chr16",4987528,4988330,4987929,802
"11829","chr10",81874293,81875973,81875133,1680
"11830","chr7",150371667,150372962,150372314,1295
"11831","chr19",44071963,44072411,44072187,448
"11832","chr8",51898610,51899752,51899181,1142
"11833","chr19",1506027,1506269,1506148,242
"11834","chr1",36088724,36089354,36089039,630
"11835","chr3",119810073,119810312,119810192,239
"11836","chr14",73612479,73613100,73612789,621
"11837","chr15",75347254,75348402,75347828,1148
"11838","chr6",149545895,149546438,149546166,543
"11839","chr10",22320419,22322208,22321313,1789
"11840","chr9",121759967,121760267,121760117,300
"11841","chr5",139756004,139756391,139756197,387
"11842","chr14",22766565,22767369,22766967,804
"11843","chr14",21383339,21384391,21383865,1052
"11844","chr15",30991201,30992211,30991706,1010
"11845","chr14",20609716,20609935,20609825,219
"11846","chr10",47368497,47368756,47368626,259
"11847","chr16",84368351,84368891,84368621,540
"11848","chr19",46745984,46746691,46746337,707
"11849","chr12",4909419,4911874,4910646,2455
"11850","chr9",6680856,6681758,6681307,902
"11851","chr19",35628997,35629372,35629184,375
"11852","chr6",119348424,119350259,119349341,1835
"11853","chr16",8868332,8869080,8868706,748
"11854","chr9",71446597,71447181,71446889,584
"11855","chr3",50322408,50322611,50322509,203
"11856","chr19",58408181,58409162,58408671,981
"11857","chr3",48187587,48188795,48188191,1208
"11858","chr17",2749160,2750078,2749619,918
"11859","chr2",37196435,37196698,37196566,263
"11860","chr19",57681900,57682270,57682085,370
"11861","chr3",9749439,9750327,9749883,888
"11862","chr19",10424463,10424831,10424647,368
"11863","chr3",136751591,136753081,136752336,1490
"11864","chr7",157009476,157011720,157010598,2244
"11865","chr14",99737703,99737925,99737814,222
"11866","chr14",89416195,89417934,89417064,1739
"11867","chr9",69173799,69174626,69174212,827
"11868","chr19",42220038,42220513,42220275,475
"11869","chr17",79512613,79512896,79512754,283
"11870","chr17",413292,413621,413456,329
"11871","chr9",34377403,34377612,34377507,209
"11872","chr12",52948901,52949378,52949139,477
"11873","chr16",28062496,28063975,28063235,1479
"11874","chr22",22114711,22115533,22115122,822
"11875","chr6",24402861,24403458,24403159,597
"11876","chr17",42760798,42761535,42761166,737
"11877","chr3",114056300,114056735,114056517,435
"11878","chr8",10726306,10726746,10726526,440
"11879","chr15",23878084,23878285,23878184,201
"11880","chr7",105521535,105522442,105521988,907
"11881","chr16",29973343,29974138,29973740,795
"11882","chr19",44500077,44500794,44500435,717
"11883","chr7",151341564,151342050,151341807,486
"11884","chr2",25877644,25878784,25878214,1140
"11885","chr6",168440758,168442420,168441589,1662
"11886","chr19",55146264,55147030,55146647,766
"11887","chr10",133112311,133113374,133112842,1063
"11888","chr12",132414191,132414401,132414296,210
"11889","chr9",97038574,97039442,97039008,868
"11890","chr9",135981389,135982159,135981774,770
"11891","chr10",97713327,97714907,97714117,1580
"11892","chr10",8035866,8036415,8036140,549
"11893","chr19",55531087,55531318,55531202,231
"11894","chr19",12513459,12513663,12513561,204
"11895","chr19",1788990,1789881,1789435,891
"11896","chr20",57389193,57391990,57390591,2797
"11897","chr17",72540343,72540547,72540445,204
"11898","chr9",94726536,94726890,94726713,354
"11899","chr8",144474855,144475439,144475147,584
"11900","chr14",103698714,103698941,103698827,227
"11901","chr11",70078232,70079091,70078661,859
"11902","chr7",55365454,55366578,55366016,1124
"11903","chr7",130205306,130205584,130205445,278
"11904","chr10",48586,49361,48973,775
"11905","chr19",32720875,32721174,32721024,299
"11906","chr14",36508313,36508791,36508552,478
"11907","chr19",48612988,48613384,48613186,396
"11908","chr7",1851194,1851452,1851323,258
"11909","chr19",9913159,9914848,9914003,1689
"11910","chr19",57320231,57320882,57320556,651
"11911","chr4",2468492,2470001,2469246,1509
"11912","chr16",921429,921825,921627,396
"11913","chr14",60165022,60165536,60165279,514
"11914","chr4",169612247,169612797,169612522,550
"11915","chr10",133419414,133419620,133419517,206
"11916","chr14",64914357,64914664,64914510,307
"11917","chr4",2416583,2419167,2417875,2584
"11918","chr17",66964515,66966205,66965360,1690
"11919","chr4",145732842,145733463,145733152,621
"11920","chr7",157647332,157650029,157648680,2697
"11921","chr8",12362002,12362407,12362204,405
"11922","chr21",29298423,29299465,29298944,1042
"11923","chr6",137867115,137868004,137867559,889
"11924","chr1",215082708,215083293,215083000,585
"11925","chr17",36591623,36592472,36592047,849
"11926","chr7",552983,553421,553202,438
"11927","chr16",3282472,3283847,3283159,1375
"11928","chr10",45000827,45001338,45001082,511
"11929","chr19",45671114,45671317,45671215,203
"11930","chr12",2690973,2691896,2691434,923
"11931","chr8",23714409,23714695,23714552,286
"11932","chr16",5033243,5034031,5033637,788
"11933","chr12",130818548,130819291,130818919,743
"11934","chr19",14495897,14496573,14496235,676
"11935","chr17",61451618,61452905,61452261,1287
"11936","chr6",98847865,98848578,98848221,713
"11937","chr21",46388756,46389206,46388981,450
"11938","chr4",83334807,83335246,83335026,439
"11939","chr9",137180706,137180923,137180814,217
"11940","chr19",12365235,12365558,12365396,323
"11941","chr4",15001435,15005137,15003286,3702
"11942","chr19",8364081,8364608,8364344,527
"11943","chr5",139637478,139638083,139637780,605
"11944","chr21",39612682,39613067,39612874,385
"11945","chr5",138463926,138466564,138465245,2638
"11946","chr10",101066172,101067794,101066983,1622
"11947","chr7",1101593,1101909,1101751,316
"11948","chr19",44025241,44025626,44025433,385
"11949","chr17",75109134,75110572,75109853,1438
"11950","chr6",41941007,41941973,41941490,966
"11951","chr22",21735531,21736620,21736075,1089
"11952","chr12",120446244,120446900,120446572,656
"11953","chr6",7051263,7052699,7051981,1436
"11954","chr5",134071116,134071458,134071287,342
"11955","chr2",11634184,11634395,11634289,211
"11956","chr1",26360025,26360790,26360407,765
"11957","chr17",75502018,75502309,75502163,291
"11958","chr19",1526463,1526682,1526572,219
"11959","chr6",170469186,170469448,170469317,262
"11960","chr10",133270235,133270458,133270346,223
"11961","chr19",40224478,40224805,40224641,327
"11962","chr10",99329546,99330898,99330222,1352
"11963","chr6",99393785,99394270,99394027,485
"11964","chr10",132138194,132138508,132138351,314
"11965","chr10",67884411,67885420,67884915,1009
"11966","chr17",45051421,45052210,45051815,789
"11967","chr1",214608319,214609213,214608766,894
"11968","chr7",155070970,155071535,155071252,565
"11969","chr6",43243376,43243607,43243491,231
"11970","chr19",4326881,4327383,4327132,502
"11971","chr6",72621214,72623381,72622297,2167
"11972","chr18",78964859,78965314,78965086,455
"11973","chr20",63487845,63489267,63488556,1422
"11974","chr6",30075141,30075723,30075432,582
"11975","chr17",45221358,45222370,45221864,1012
"11976","chr1",1702813,1703251,1703032,438
"11977","chr19",40601087,40601674,40601380,587
"11978","chr12",128844742,128846946,128845844,2204
"11979","chr1",161983826,161984249,161984037,423
"11980","chr12",121799916,121805484,121802700,5568
"11981","chr2",240520215,240520630,240520422,415
"11982","chr9",136363390,136364623,136364006,1233
"11983","chr1",33349182,33350169,33349675,987
"11984","chr1",32221920,32222439,32222179,519
"11985","chr14",19668545,19668800,19668672,255
"11986","chr7",100720483,100721061,100720772,578
"11987","chr13",30421548,30422245,30421896,697
"11988","chr2",502994,503502,503248,508
"11989","chr17",38428173,38429210,38428691,1037
"11990","chr12",112575217,112575725,112575471,508
"11991","chrX",153420663,153421741,153421202,1078
"11992","chrX",71169685,71169950,71169817,265
"11993","chr5",134176280,134177429,134176854,1149
"11994","chr10",3457130,3457690,3457410,560
"11995","chr1",236604061,236604698,236604379,637
"11996","chr15",28117111,28117346,28117228,235
"11997","chr4",39182203,39182605,39182404,402
"11998","chr1",205591961,205592345,205592153,384
"11999","chrX",21839473,21840086,21839779,613
"12000","chr4",114598266,114599776,114599021,1510
"12001","chr7",2518737,2520333,2519535,1596
"12002","chr2",161308164,161308737,161308450,573
"12003","chr14",106812858,106813074,106812966,216
"12004","chr4",2364694,2365365,2365029,671
"12005","chr19",3006275,3006723,3006499,448
"12006","chr16",15154013,15155298,15154655,1285
"12007","chr10",102065137,102066021,102065579,884
"12008","chr1",11529781,11529987,11529884,206
"12009","chr14",100238025,100240730,100239377,2705
"12010","chr20",3237932,3240284,3239108,2352
"12011","chr1",69919360,69919587,69919473,227
"12012","chr14",20632679,20632884,20632781,205
"12013","chr2",170713367,170717394,170715380,4027
"12014","chr11",69636368,69643828,69640098,7460
"12015","chr14",99269703,99274662,99272182,4959
"12016","chr1",108876844,108877416,108877130,572
"12017","chr14",100654671,100655028,100654849,357
"12018","chr19",45645238,45645683,45645460,445
"12019","chr4",75630182,75630895,75630538,713
"12020","chr3",171460040,171461175,171460607,1135
"12021","chr12",113358412,113359042,113358727,630
"12022","chr7",95772379,95773120,95772749,741
"12023","chr13",20160738,20162018,20161378,1280
"12024","chr6",39229041,39229741,39229391,700
"12025","chr7",76302387,76303195,76302791,808
"12026","chr20",37902741,37903731,37903236,990
"12027","chr11",7673480,7674454,7673967,974
"12028","chr20",62121505,62123286,62122395,1781
"12029","chr1",226641881,226642102,226641991,221
"12030","chr17",28985951,28986265,28986108,314
"12031","chr5",55232986,55234335,55233660,1349
"12032","chr22",50176849,50179471,50178160,2622
"12033","chr19",13804804,13805026,13804915,222
"12034","chr15",52805429,52806279,52805854,850
"12035","chr1",54405180,54407327,54406253,2147
"12036","chr19",3838024,3838225,3838124,201
"12037","chr19",3753746,3754259,3754002,513
"12038","chr7",151237563,151237783,151237673,220
"12039","chr1",145918451,145919050,145918750,599
"12040","chr7",158351888,158352141,158352014,253
"12041","chr2",176108699,176108990,176108844,291
"12042","chr1",41496179,41496645,41496412,466
"12043","chr1",207669460,207669914,207669687,454
"12044","chr2",46480469,46480760,46480614,291
"12045","chr11",64368343,64368909,64368626,566
"12046","chr10",133039579,133039800,133039689,221
"12047","chr14",22918883,22919648,22919265,765
"12048","chrX",15493188,15493562,15493375,374
"12049","chr19",48501256,48501623,48501439,367
"12050","chr3",13818937,13819385,13819161,448
"12051","chrX",102712039,102713042,102712540,1003
"12052","chr7",87600743,87600944,87600843,201
"12053","chr12",66694,67234,66964,540
"12054","chr3",179261160,179261576,179261368,416
"12055","chr18",48008210,48008647,48008428,437
"12056","chr12",53949838,53950064,53949951,226
"12057","chr1",119622679,119624003,119623341,1324
"12058","chr11",67409474,67409698,67409586,224
"12059","chr1",203795440,203796165,203795802,725
"12060","chr14",61280086,61281423,61280754,1337
"12061","chr20",1002009,1002609,1002309,600
"12062","chr2",87341716,87342494,87342105,778
"12063","chr4",183444044,183445282,183444663,1238
"12064","chr4",1144210,1146033,1145121,1823
"12065","chr20",9068311,9069371,9068841,1060
"12066","chr16",67183813,67185316,67184564,1503
"12067","chr12",66130684,66131012,66130848,328
"12068","chr9",81687224,81690086,81688655,2862
"12069","chr1",144461026,144462012,144461519,986
"12070","chr17",49968424,49969843,49969133,1419
"12071","chr14",51989410,51989875,51989642,465
"12072","chr20",34558331,34559240,34558785,909
"12073","chr17",56960784,56961169,56960976,385
"12074","chr17",9239663,9240522,9240092,859
"12075","chr16",31442622,31443240,31442931,618
"12076","chr10",124056751,124057006,124056878,255
"12077","chr9",127724060,127724374,127724217,314
"12078","chr1",247126361,247126923,247126642,562
"12079","chr1",51616902,51617376,51617139,474
"12080","chr4",90127260,90128531,90127895,1271
"12081","chr6",33410152,33410868,33410510,716
"12082","chr1",96721546,96722263,96721904,717
"12083","chr19",17235356,17236070,17235713,714
"12084","chr5",55223226,55223800,55223513,574
"12085","chr17",75521932,75522302,75522117,370
"12086","chr7",99918979,99919673,99919326,694
"12087","chr4",54091812,54092375,54092093,563
"12088","chr14",96592606,96593185,96592895,579
"12089","chr8",56211013,56212438,56211725,1425
"12090","chr16",77434412,77435177,77434794,765
"12091","chr4",25312595,25312936,25312765,341
"12092","chr2",72915926,72921131,72918528,5205
"12093","chr10",107164022,107165047,107164534,1025
"12094","chr16",2527801,2528366,2528083,565
"12095","chr7",73433603,73435702,73434652,2099
"12096","chr3",51995741,51996042,51995891,301
"12097","chr19",39539486,39540345,39539915,859
"12098","chr19",48513480,48513950,48513715,470
"12099","chr14",94026293,94026951,94026622,658
"12100","chr7",107891035,107891538,107891286,503
"12101","chr1",15065685,15066023,15065854,338
"12102","chr17",18038884,18040181,18039532,1297
"12103","chr3",128555093,128555953,128555523,860
"12104","chr16",4802116,4803175,4802645,1059
"12105","chr16",89933943,89934279,89934111,336
"12106","chr9",85940786,85941723,85941254,937
"12107","chr7",100148630,100149020,100148825,390
"12108","chr12",121466539,121468153,121467346,1614
"12109","chr14",91417328,91419023,91418175,1695
"12110","chr7",149790195,149790681,149790438,486
"12111","chr14",99320493,99320714,99320603,221
"12112","chr16",87407781,87408065,87407923,284
"12113","chr1",54488220,54488583,54488401,363
"12114","chr22",44729101,44729975,44729538,874
"12115","chr19",53882061,53882350,53882205,289
"12116","chr7",23585992,23586542,23586267,550
"12117","chr19",58380467,58381274,58380870,807
"12118","chr19",56671519,56672007,56671763,488
"12119","chr5",78509930,78510490,78510210,560
"12120","chr3",107430973,107432063,107431518,1090
"12121","chr3",188154290,188154566,188154428,276
"12122","chr19",2774198,2774552,2774375,354
"12123","chr7",27179690,27180131,27179910,441
"12124","chr19",911689,913715,912702,2026
"12125","chr2",240157987,240158517,240158252,530
"12126","chr7",97971995,97972501,97972248,506
"12127","chr7",6526435,6527019,6526727,584
"12128","chr17",15704238,15704969,15704603,731
"12129","chr14",88562834,88563594,88563214,760
"12130","chr9",136653753,136653974,136653863,221
"12131","chr9",13278313,13279806,13279059,1493
"12132","chr17",77372606,77374424,77373515,1818
"12133","chr19",3880720,3881280,3881000,560
"12134","chr7",151018221,151019317,151018769,1096
"12135","chr2",241210259,241210491,241210375,232
"12136","chr10",133740607,133761247,133750927,20640
"12137","chr17",81962653,81962880,81962766,227
"12138","chr20",61390520,61390734,61390627,214
"12139","chr7",157775471,157775712,157775591,241
"12140","chr18",9474806,9475980,9475393,1174
"12141","chr2",188291689,188292992,188292340,1303
"12142","chr22",50058012,50058964,50058488,952
"12143","chr14",97033268,97033839,97033553,571
"12144","chr3",113019397,113019806,113019601,409
"12145","chr2",24359751,24360742,24360246,991
"12146","chr2",96321289,96321913,96321601,624
"12147","chr2",241901609,241902631,241902120,1022
"12148","chr8",135457520,135458099,135457809,579
"12149","chr9",92293480,92294017,92293748,537
"12150","chr14",104826344,104827058,104826701,714
"12151","chr20",45293309,45294002,45293655,693
"12152","chr6",26689575,26689864,26689719,289
"12153","chr12",94649775,94650536,94650155,761
"12154","chr3",5026351,5026749,5026550,398
"12155","chr21",34202022,34202248,34202135,226
"12156","chr1",236142009,236143374,236142691,1365
"12157","chr11",66691312,66691652,66691482,340
"12158","chr12",62602379,62603892,62603135,1513
"12159","chr17",30477318,30477675,30477496,357
"12160","chr22",26433752,26434162,26433957,410
"12161","chr7",155381433,155382553,155381993,1120
"12162","chr2",3377573,3378141,3377857,568
"12163","chr19",1050977,1051235,1051106,258
"12164","chr7",156616329,156617171,156616750,842
"12165","chr19",40444118,40444870,40444494,752
"12166","chr14",105020274,105021578,105020926,1304
"12167","chr1",47230832,47232525,47231678,1693
"12168","chr3",77039347,77040047,77039697,700
"12169","chr10",132714238,132714587,132714412,349
"12170","chr4",103719402,103719640,103719521,238
"12171","chr22",46533420,46538964,46536192,5544
"12172","chr13",49791924,49793167,49792545,1243
"12173","chr4",139734808,139735981,139735394,1173
"12174","chr10",116788125,116788343,116788234,218
"12175","chr14",73537418,73537979,73537698,561
"12176","chr19",12156183,12156871,12156527,688
"12177","chr18",47246621,47249206,47247913,2585
"12178","chr4",47836587,47837929,47837258,1342
"12179","chr6",168842662,168843076,168842869,414
"12180","chr19",5914996,5915290,5915143,294
"12181","chr14",102776904,102778368,102777636,1464
"12182","chr10",92692443,92692671,92692557,228
"12183","chr20",54207791,54208509,54208150,718
"12184","chr19",10403314,10404927,10404120,1613
"12185","chr17",75289099,75289773,75289436,674
"12186","chr3",137770752,137772162,137771457,1410
"12187","chr20",34708710,34710438,34709574,1728
"12188","chr16",33680717,33681195,33680956,478
"12189","chrX",40094181,40109994,40102087,15813
"12190","chr10",99234063,99234431,99234247,368
"12191","chr8",30082626,30083411,30083018,785
"12192","chr12",13562915,13564100,13563507,1185
"12193","chr9",128551949,128553217,128552583,1268
"12194","chr4",8691127,8691392,8691259,265
"12195","chrX",21373717,21375290,21374503,1573
"12196","chr19",35351527,35352284,35351905,757
"12197","chr19",17606051,17606722,17606386,671
"12198","chr2",231786188,231786721,231786454,533
"12199","chr19",45323543,45323906,45323724,363
"12200","chr3",137768587,137769179,137768883,592
"12201","chr2",8678741,8679456,8679098,715
"12202","chr21",46411619,46412017,46411818,398
"12203","chr7",66921098,66921822,66921460,724
"12204","chr16",30650662,30651932,30651297,1270
"12205","chr19",37548659,37549493,37549076,834
"12206","chr8",144202897,144203374,144203135,477
"12207","chr19",5903471,5905205,5904338,1734
"12208","chr13",19564715,19565183,19564949,468
"12209","chr19",7963631,7963936,7963783,305
"12210","chr6",44727457,44727666,44727561,209
"12211","chr5",132866209,132867061,132866635,852
"12212","chr8",123160560,123161301,123160930,741
"12213","chr19",39203836,39204354,39204095,518
"12214","chr3",154120998,154122591,154121794,1593
"12215","chr3",150050667,150050882,150050774,215
"12216","chr9",122126670,122127103,122126886,433
"12217","chr6",82247908,82248125,82248016,217
"12218","chr2",37344533,37345254,37344893,721
"12219","chr16",56989278,56989856,56989567,578
"12220","chrX",150762223,150762435,150762329,212
"12221","chr7",2688048,2688758,2688403,710
"12222","chr7",2555090,2555904,2555497,814
"12223","chrX",3317110,3317690,3317400,580
"12224","chrX",71182012,71182363,71182187,351
"12225","chr2",165953460,165954316,165953888,856
"12226","chr15",95326726,95327093,95326909,367
"12227","chr14",21269247,21269935,21269591,688
"12228","chr2",231661955,231663066,231662510,1111
"12229","chr6",656409,657155,656782,746
"12230","chr12",132476094,132476317,132476205,223
"12231","chr3",56801622,56802182,56801902,560
"12232","chr4",153465682,153467031,153466356,1349
"12233","chr16",68446961,68448919,68447940,1958
"12234","chr13",52128637,52129251,52128944,614
"12235","chr10",132036172,132037322,132036747,1150
"12236","chr2",207766834,207770210,207768522,3376
"12237","chr14",49585932,49586315,49586123,383
"12238","chr4",57195585,57195949,57195767,364
"12239","chr4",57109694,57110750,57110222,1056
"12240","chr2",98086891,98087426,98087158,535
"12241","chr7",16644614,16646739,16645676,2125
"12242","chr18",34222394,34223828,34223111,1434
"12243","chr17",26981979,26982273,26982126,294
"12244","chr8",70668815,70669415,70669115,600
"12245","chr2",214809271,214810328,214809799,1057
"12246","chr2",231706427,231711123,231708775,4696
"12247","chr18",59265481,59265762,59265621,281
"12248","chr16",22813295,22815138,22814216,1843
"12249","chr5",139787591,139788445,139788018,854
"12250","chr16",58392279,58392961,58392620,682
"12251","chr4",20251653,20255245,20253449,3592
"12252","chr2",130288427,130288908,130288667,481
"12253","chr13",44141737,44142106,44141921,369
"12254","chr2",121530044,121530756,121530400,712
"12255","chr6",35182194,35182614,35182404,420
"12256","chr22",19973001,19973804,19973402,803
"12257","chr11",62653072,62653452,62653262,380
"12258","chr13",30674051,30674481,30674266,430
"12259","chr1",111738430,111740655,111739542,2225
"12260","chr12",123633550,123633932,123633741,382
"12261","chr2",68643219,68643923,68643571,704
"12262","chr4",140497853,140498350,140498101,497
"12263","chr8",55449296,55449608,55449452,312
"12264","chr20",19211815,19213258,19212536,1443
"12265","chr6",143450473,143450947,143450710,474
"12266","chr5",80960133,80961187,80960660,1054
"12267","chr1",152216384,152216597,152216490,213
"12268","chr13",102394330,102394876,102394603,546
"12269","chr4",73258688,73259413,73259050,725
"12270","chr14",23969699,23970237,23969968,538
"12271","chr13",27927722,27927953,27927837,231
"12272","chr10",21516268,21517701,21516984,1433
"12273","chr5",115179019,115180523,115179771,1504
"12274","chr3",38346631,38347278,38346954,647
"12275","chr22",24805986,24806586,24806286,600
"12276","chrX",120115529,120115899,120115714,370
"12277","chr9",37025495,37025798,37025646,303
"12278","chr14",100158982,100160124,100159553,1142
"12279","chr4",13536022,13536349,13536185,327
"12280","chr14",70187641,70187926,70187783,285
"12281","chr10",6215211,6215413,6215312,202
"12282","chr6",43021440,43021772,43021606,332
"12283","chr1",84892676,84893504,84893090,828
"12284","chr20",31573078,31573374,31573226,296
"12285","chr1",10209957,10211248,10210602,1291
"12286","chr3",126394704,126395124,126394914,420
"12287","chr1",23343752,23344870,23344311,1118
"12288","chr11",119205931,119206844,119206387,913
"12289","chr1",107480610,107480820,107480715,210
"12290","chr15",80989537,80990076,80989806,539
"12291","chr17",45894044,45897674,45895859,3630
"12292","chr15",45023003,45023345,45023174,342
"12293","chr1",143667749,143667975,143667862,226
"12294","chr1",220786674,220787261,220786967,587
"12295","chr14",50830009,50831759,50830884,1750
"12296","chr7",2526238,2526480,2526359,242
"12297","chr16",1871896,1872425,1872160,529
"12298","chr20",57718507,57718800,57718653,293
"12299","chr3",183635446,183637028,183636237,1582
"12300","chr4",185425640,185426417,185426028,777
"12301","chr3",139677496,139678028,139677762,532
"12302","chr13",23374995,23375626,23375310,631
"12303","chr6",170236745,170238016,170237380,1271
"12304","chr1",85047826,85048872,85048349,1046
"12305","chr3",36992737,36993865,36993301,1128
"12306","chr10",89837217,89838035,89837626,818
"12307","chr6",42890431,42891222,42890826,791
"12308","chr5",65721776,65722685,65722230,909
"12309","chr9",128233931,128234164,128234047,233
"12310","chr11",33868811,33869949,33869380,1138
"12311","chr13",110438290,110438513,110438401,223
"12312","chr10",102917558,102919555,102918556,1997
"12313","chr15",91099678,91100472,91100075,794
"12314","chr1",8217135,8217762,8217448,627
"12315","chr1",15584593,15585113,15584853,520
"12316","chr18",24426346,24427043,24426694,697
"12317","chr10",44206436,44206701,44206568,265
"12318","chr1",20507923,20508390,20508156,467
"12319","chr3",170418454,170420098,170419276,1644
"12320","chr18",74147320,74148481,74147900,1161
"12321","chr3",13281938,13283429,13282683,1491
"12322","chr16",14632659,14633509,14633084,850
"12323","chr4",8345749,8346162,8345955,413
"12324","chrX",54357439,54359044,54358241,1605
"12325","chr13",25068974,25069420,25069197,446
"12326","chr19",1226491,1230257,1228374,3766
"12327","chr13",114161213,114161578,114161395,365
"12328","chr7",45111388,45111955,45111671,567
"12329","chr6",164337012,164337347,164337179,335
"12330","chr12",39144581,39145698,39145139,1117
"12331","chr3",147397977,147398634,147398305,657
"12332","chr8",81280143,81281450,81280796,1307
"12333","chr20",38730862,38731210,38731036,348
"12334","chr12",459536,461196,460366,1660
"12335","chr3",9136007,9136505,9136256,498
"12336","chr16",75148345,75149054,75148699,709
"12337","chr10",97686939,97687643,97687291,704
"12338","chr2",134718128,134719423,134718775,1295
"12339","chr8",43246346,43247399,43246872,1053
"12340","chr14",99348119,99348759,99348439,640
"12341","chr9",113089631,113089980,113089805,349
"12342","chr17",18260371,18261358,18260864,987
"12343","chr13",112036871,112037219,112037045,348
"12344","chr14",22956773,22957248,22957010,475
"12345","chr3",125959210,125959565,125959387,355
"12346","chr12",118774305,118774588,118774446,283
"12347","chr2",231412031,231412564,231412297,533
"12348","chr2",197434520,197435248,197434884,728
"12349","chr16",87477753,87478022,87477887,269
"12350","chr2",69741617,69742460,69742038,843
"12351","chr16",50841152,50841411,50841281,259
"12352","chr22",49959948,49963567,49961757,3619
"12353","chr9",136361071,136361560,136361315,489
"12354","chr1",31742885,31743103,31742994,218
"12355","chrX",119468195,119469355,119468775,1160
"12356","chr3",14602211,14603323,14602767,1112
"12357","chr12",128853325,128854326,128853825,1001
"12358","chrX",120311011,120311417,120311214,406
"12359","chr17",7294112,7295098,7294605,986
"12360","chr4",1049599,1049857,1049728,258
"12361","chr3",172447582,172448948,172448265,1366
"12362","chr13",30114858,30115198,30115028,340
"12363","chr17",50508024,50508806,50508415,782
"12364","chr4",168318398,168318673,168318535,275
"12365","chr19",6279472,6280347,6279909,875
"12366","chr16",23595929,23596329,23596129,400
"12367","chr1",228360376,228360629,228360502,253
"12368","chr13",76885187,76886964,76886075,1777
"12369","chr10",123142391,123143101,123142746,710
"12370","chr17",78997291,78997537,78997414,246
"12371","chrX",40580487,40581453,40580970,966
"12372","chr17",43021804,43022409,43022106,605
"12373","chr22",40636125,40637268,40636696,1143
"12374","chr2",222671403,222671941,222671672,538
"12375","chr10",132837337,132837997,132837667,660
"12376","chr3",112185535,112185998,112185766,463
"12377","chr17",77213377,77213590,77213483,213
"12378","chr17",73164783,73166211,73165497,1428
"12379","chr16",80932055,80932581,80932318,526
"12380","chr3",128051898,128052781,128052339,883
"12381","chr13",112770584,112770791,112770687,207
"12382","chr1",210683717,210683920,210683818,203
"12383","chr3",196708,198323,197515,1615
"12384","chrY",9485458,9485721,9485589,263
"12385","chr7",27139443,27139892,27139667,449
"12386","chr2",237475033,237475739,237475386,706
"12387","chr2",207930801,207931136,207930968,335
"12388","chr1",202144023,202145015,202144519,992
"12389","chr6",26171805,26172170,26171987,365
"12390","chr1",167721741,167722615,167722178,874
"12391","chr14",92686933,92688414,92687673,1481
"12392","chr1",155745506,155746117,155745811,611
"12393","chr6",43644977,43645629,43645303,652
"12394","chrX",64204318,64206310,64205314,1992
"12395","chr7",926351,926630,926490,279
"12396","chr3",49685710,49687185,49686447,1475
"12397","chr1",44799862,44801111,44800486,1249
"12398","chr17",64975397,64976175,64975786,778
"12399","chr6",79947027,79947876,79947451,849
"12400","chr16",1072764,1073009,1072886,245
"12401","chr4",173168792,173170272,173169532,1480
"12402","chr16",1942667,1943645,1943156,978
"12403","chr4",88697613,88697903,88697758,290
"12404","chr17",1078268,1078508,1078388,240
"12405","chr7",27164296,27166843,27165569,2547
"12406","chr14",104588536,104588776,104588656,240
"12407","chr1",3856623,3857901,3857262,1278
"12408","chr16",23641066,23641597,23641331,531
"12409","chr5",77491915,77492617,77492266,702
"12410","chr4",174522255,174522686,174522470,431
"12411","chr7",711151,711600,711375,449
"12412","chr5",139668320,139668650,139668485,330
"12413","chr7",107660760,107661971,107661365,1211
"12414","chr3",149086117,149086770,149086443,653
"12415","chr3",46976389,46976822,46976605,433
"12416","chr3",52287803,52288038,52287920,235
"12417","chr1",33633296,33633519,33633407,223
"12418","chr7",1474718,1474942,1474830,224
"12419","chr1",231528253,231528862,231528557,609
"12420","chr3",308977,309210,309093,233
"12421","chr2",238128716,238128942,238128829,226
"12422","chr7",92832887,92837073,92834980,4186
"12423","chr2",61694582,61694802,61694692,220
"12424","chr12",56079008,56080609,56079808,1601
"12425","chr1",42334594,42335699,42335146,1105
"12426","chr17",79741771,79742262,79742016,491
"12427","chr22",31944070,31945206,31944638,1136
"12428","chr13",21458723,21459591,21459157,868
"12429","chr17",28318264,28318588,28318426,324
"12430","chr5",39073779,39075134,39074456,1355
"12431","chr3",197297556,197298635,197298095,1079
"12432","chr22",42662120,42662745,42662432,625
"12433","chr10",5525159,5525865,5525512,706
"12434","chr2",130755790,130756610,130756200,820
"12435","chr14",104429567,104431272,104430419,1705
"12436","chr5",11903438,11904591,11904014,1153
"12437","chrX",71096499,71096821,71096660,322
"12438","chr1",50968090,50969833,50968961,1743
"12439","chr14",89701438,89702008,89701723,570
"12440","chr19",50548525,50548865,50548695,340
"12441","chr1",109281691,109281904,109281797,213
"12442","chr10",131900492,131901844,131901168,1352
"12443","chr16",83916396,83917572,83916984,1176
"12444","chr10",101284233,101284723,101284478,490
"12445","chr12",111597808,111599754,111598781,1946
"12446","chr3",150181308,150181518,150181413,210
"12447","chr6",47477372,47478355,47477863,983
"12448","chr2",43100798,43101199,43100998,401
"12449","chr1",200890948,200891448,200891198,500
"12450","chr17",49677508,49678410,49677959,902
"12451","chr2",241771222,241771632,241771427,410
"12452","chr19",7916085,7918098,7917091,2013
"12453","chr19",33226606,33227377,33226991,771
"12454","chr1",149746992,149747368,149747180,376
"12455","chr17",83074706,83075083,83074894,377
"12456","chr12",53500666,53501529,53501097,863
"12457","chr2",60553775,60555149,60554462,1374
"12458","chr17",82435594,82435876,82435735,282
"12459","chr8",53594547,53594798,53594672,251
"12460","chr2",54330493,54330902,54330697,409
"12461","chr2",131460690,131461152,131460921,462
"12462","chr19",4123524,4124349,4123936,825
"12463","chr8",143718787,143719165,143718976,378
"12464","chr14",28765683,28768626,28767154,2943
"12465","chr11",57657465,57657790,57657627,325
"12466","chr5",141387629,141388128,141387878,499
"12467","chr16",84236815,84237251,84237033,436
"12468","chr12",8082093,8082424,8082258,331
"12469","chr14",102591589,102593707,102592648,2118
"12470","chr7",18086291,18086770,18086530,479
"12471","chr8",11749807,11750260,11750033,453
"12472","chrX",119605607,119606552,119606079,945
"12473","chr3",142578377,142579007,142578692,630
"12474","chr19",4851950,4852236,4852093,286
"12475","chr19",42387159,42387563,42387361,404
"12476","chr17",76452306,76453342,76452824,1036
"12477","chr12",132443210,132443420,132443315,210
"12478","chr5",172283176,172284149,172283662,973
"12479","chr1",42846587,42846842,42846714,255
"12480","chr16",3149651,3149936,3149793,285
"12481","chr1",161399073,161400142,161399607,1069
"12482","chr3",2098345,2100100,2099222,1755
"12483","chr12",21437535,21437851,21437693,316
"12484","chr14",100305483,100307336,100306409,1853
"12485","chr8",1155083,1155435,1155259,352
"12486","chr12",95217058,95218221,95217639,1163
"12487","chr10",132960709,132960981,132960845,272
"12488","chr7",102396023,102396570,102396296,547
"12489","chr1",156053171,156054188,156053679,1017
"12490","chr10",98029857,98031391,98030624,1534
"12491","chr7",4792117,4792850,4792483,733
"12492","chr7",151894826,151895159,151894992,333
"12493","chr1",35079326,35079702,35079514,376
"12494","chr1",6128813,6129060,6128936,247
"12495","chr10",79904633,79905320,79904976,687
"12496","chr8",90985002,90985678,90985340,676
"12497","chr17",1072352,1072662,1072507,310
"12498","chrX",70433857,70434811,70434334,954
"12499","chr1",29259385,29260086,29259735,701
"12500","chr2",231052576,231053151,231052863,575
"12501","chr1",60073643,60073868,60073755,225
"12502","chr14",93184400,93185307,93184853,907
"12503","chr1",47437121,47439846,47438483,2725
"12504","chr16",60997,62169,61583,1172
"12505","chr17",79992006,79992497,79992251,491
"12506","chr1",15048567,15048917,15048742,350
"12507","chr3",186193555,186194439,186193997,884
"12508","chr13",41060036,41061984,41061010,1948
"12509","chr12",34335675,34336102,34335888,427
"12510","chr16",31142235,31143153,31142694,918
"12511","chr6",57172156,57172933,57172544,777
"12512","chr5",140639449,140639917,140639683,468
"12513","chr12",34347615,34347879,34347747,264
"12514","chr1",212414249,212414942,212414595,693
"12515","chr16",56632033,56632729,56632381,696
"12516","chr9",120713707,120714977,120714342,1270
"12517","chr4",163473522,163473910,163473716,388
"12518","chr1",6456064,6456265,6456164,201
"12519","chr18",79797780,79798948,79798364,1168
"12520","chr16",57802043,57803077,57802560,1034
"12521","chr16",30096070,30096554,30096312,484
"12522","chrX",154886116,154887248,154886682,1132
"12523","chr7",116499485,116500298,116499891,813
"12524","chr14",94768275,94770232,94769253,1957
"12525","chr3",58433449,58434091,58433770,642
"12526","chr19",615691,623505,619598,7814
"12527","chr18",11947828,11948156,11947992,328
"12528","chr1",11058973,11060577,11059775,1604
"12529","chr1",6485083,6485858,6485470,775
"12530","chr20",609578,610578,610078,1000
"12531","chr17",63741324,63742037,63741680,713
"12532","chr9",35972146,35972449,35972297,303
"12533","chr19",11090243,11091010,11090626,767
"12534","chr5",150166464,150167425,150166944,961
"12535","chr19",45902467,45903287,45902877,820
"12536","chr7",87475407,87475989,87475698,582
"12537","chr12",41188353,41189173,41188763,820
"12538","chr6",28616157,28616512,28616334,355
"12539","chr19",50203225,50203939,50203582,714
"12540","chr4",3517837,3518421,3518129,584
"12541","chr15",51751225,51752250,51751737,1025
"12542","chr8",22598578,22598995,22598786,417
"12543","chrX",84934059,84934585,84934322,526
"12544","chr17",82832492,82832705,82832598,213
"12545","chr8",100309340,100310486,100309913,1146
"12546","chrX",134373104,134373636,134373370,532
"12547","chr12",53954911,53955594,53955252,683
"12548","chr8",37898936,37899821,37899378,885
"12549","chr8",22176925,22177259,22177092,334
"12550","chr19",1848059,1848777,1848418,718
"12551","chrX",123859828,123860485,123860156,657
"12552","chr6",2999843,3000286,3000064,443
"12553","chr22",49102438,49102653,49102545,215
"12554","chr8",47180069,47180382,47180225,313
"12555","chr16",50673380,50674130,50673755,750
"12556","chr1",54390728,54390935,54390831,207
"12557","chr19",41564997,41565253,41565125,256
"12558","chr8",30156184,30156844,30156514,660
"12559","chr9",127937480,127937987,127937733,507
"12560","chr4",56976468,56977727,56977097,1259
"12561","chr19",3207922,3208159,3208040,237
"12562","chr7",83749569,83749837,83749703,268
"12563","chr1",13699986,13700705,13700345,719
"12564","chr14",105045718,105045970,105045844,252
"12565","chr11",62880765,62881689,62881227,924
"12566","chr12",112409151,112409396,112409273,245
"12567","chr10",126387586,126388913,126388249,1327
"12568","chr10",97185305,97186482,97185893,1177
"12569","chr9",34126268,34126961,34126614,693
"12570","chr1",147908011,147908355,147908183,344
"12571","chr10",125822760,125823628,125823194,868
"12572","chr7",5823199,5823435,5823317,236
"12573","chr20",3672543,3674126,3673334,1583
"12574","chr8",55101096,55103124,55102110,2028
"12575","chr1",109643339,109643542,109643440,203
"12576","chr12",114443844,114444132,114443988,288
"12577","chr12",126191015,126191649,126191332,634
"12578","chr8",28401850,28402200,28402025,350
"12579","chr8",141308639,141309056,141308847,417
"12580","chr1",110209634,110212172,110210903,2538
"12581","chr5",77180220,77180867,77180543,647
"12582","chr1",16498643,16499882,16499262,1239
"12583","chr18",11851210,11852123,11851666,913
"12584","chr12",30695330,30696082,30695706,752
"12585","chr22",41064010,41064268,41064139,258
"12586","chr19",2543640,2543880,2543760,240
"12587","chr1",84754335,84754655,84754495,320
"12588","chr7",16420955,16421640,16421297,685
"12589","chr6",85449707,85450677,85450192,970
"12590","chr16",29158577,29159093,29158835,516
"12591","chr1",31944587,31945029,31944808,442
"12592","chr17",7435775,7437577,7436676,1802
"12593","chr16",23301918,23302625,23302271,707
"12594","chr14",69191410,69192056,69191733,646
"12595","chr10",103350508,103351251,103350879,743
"12596","chr1",10665130,10665560,10665345,430
"12597","chr9",110578933,110579749,110579341,816
"12598","chr10",30349032,30349350,30349191,318
"12599","chr2",222296812,222297200,222297006,388
"12600","chr20",25196138,25196392,25196265,254
"12601","chr14",99174023,99176430,99175226,2407
"12602","chr17",81922573,81922996,81922784,423
"12603","chrX",47078232,47078570,47078401,338
"12604","chr1",3583338,3583906,3583622,568
"12605","chr16",58024808,58025024,58024916,216
"12606","chr16",4307551,4307954,4307752,403
"12607","chr9",69324585,69325387,69324986,802
"12608","chr8",143790631,143790870,143790750,239
"12609","chr15",100973040,100974118,100973579,1078
"12610","chr14",88326560,88326980,88326770,420
"12611","chr21",45073014,45073255,45073134,241
"12612","chr7",48924371,48924752,48924561,381
"12613","chr14",36524283,36525283,36524783,1000
"12614","chr11",67428329,67428719,67428524,390
"12615","chr15",28113022,28113352,28113187,330
"12616","chr10",97319054,97321291,97320172,2237
"12617","chrX",36957432,36958276,36957854,844
"12618","chr14",49892622,49894079,49893350,1457
"12619","chr17",58531664,58532222,58531943,558
"12620","chr16",81403599,81403937,81403768,338
"12621","chr8",142541914,142542621,142542267,707
"12622","chr14",77181765,77181985,77181875,220
"12623","chr1",6253701,6254079,6253890,378
"12624","chr20",45405818,45407314,45406566,1496
"12625","chr15",91916036,91916448,91916242,412
"12626","chr21",46125696,46126298,46125997,602
"12627","chr10",529958,530191,530074,233
"12628","chr9",92325667,92326324,92325995,657
"12629","chr5",178006280,178007492,178006886,1212
"12630","chr7",39833215,39833552,39833383,337
"12631","chr4",51842601,51844958,51843779,2357
"12632","chr8",85107070,85107629,85107349,559
"12633","chr6",109691162,109691566,109691364,404
"12634","chr22",31345059,31347721,31346390,2662
"12635","chr18",76379281,76379944,76379612,663
"12636","chr2",112138215,112140264,112139239,2049
"12637","chr16",88686112,88686870,88686491,758
"12638","chr1",201982457,201983451,201982954,994
"12639","chr2",39124214,39124592,39124403,378
"12640","chr2",72887090,72887791,72887440,701
"12641","chr1",4653929,4656495,4655212,2566
"12642","chr15",58065111,58066578,58065844,1467
"12643","chr16",28600625,28601067,28600846,442
"12644","chr5",132963267,132964048,132963657,781
"12645","chr6",155218841,155219059,155218950,218
"12646","chr13",112606410,112606611,112606510,201
"12647","chr8",1363221,1363460,1363340,239
"12648","chr6",122471613,122471946,122471779,333
"12649","chr10",124589729,124589934,124589831,205
"12650","chr14",88323204,88324149,88323676,945
"12651","chr22",30387316,30387631,30387473,315
"12652","chr19",7611737,7613138,7612437,1401
"12653","chr16",46830541,46831649,46831095,1108
"12654","chr19",2061111,2062055,2061583,944
"12655","chr7",56368594,56368866,56368730,272
"12656","chr8",13276333,13276791,13276562,458
"12657","chr3",138174568,138174966,138174767,398
"12658","chr16",11233151,11233377,11233264,226
"12659","chr1",24413367,24413772,24413569,405
"12660","chr2",3651535,3651875,3651705,340
"12661","chr1",100352153,100353343,100352748,1190
"12662","chr14",68628298,68628690,68628494,392
"12663","chr2",27393338,27393573,27393455,235
"12664","chr6",3118338,3119058,3118698,720
"12665","chr8",143380460,143380784,143380622,324
"12666","chr8",103140498,103141162,103140830,664
"12667","chr2",232697113,232697837,232697475,724
"12668","chr2",174486636,174487426,174487031,790
"12669","chr14",73851709,73852082,73851895,373
"12670","chr14",73490861,73492185,73491523,1324
"12671","chr4",2954979,2955598,2955288,619
"12672","chr16",77449,78632,78040,1183
"12673","chr6",36678467,36680688,36679577,2221
"12674","chr4",1578946,1580603,1579774,1657
"12675","chr21",46302708,46302986,46302847,278
"12676","chr14",21068923,21069196,21069059,273
"12677","chr1",227563708,227563934,227563821,226
"12678","chr7",25858617,25859151,25858884,534
"12679","chr12",56104084,56105263,56104673,1179
"12680","chr8",109691180,109691902,109691541,722
"12681","chr2",151261369,151261965,151261667,596
"12682","chr2",20822804,20823174,20822989,370
"12683","chr2",17753288,17754673,17753980,1385
"12684","chr6",148877223,148878712,148877967,1489
"12685","chrX",101051625,101052003,101051814,378
"12686","chrX",55160888,55161574,55161231,686
"12687","chr22",32801394,32802281,32801837,887
"12688","chr22",20116125,20116400,20116262,275
"12689","chr7",103274,104053,103663,779
"12690","chr1",159780626,159781563,159781094,937
"12691","chr16",734367,735034,734700,667
"12692","chr14",34555975,34556189,34556082,214
"12693","chr17",56592589,56594986,56593787,2397
"12694","chr1",210234056,210234292,210234174,236
"12695","chr10",50417964,50418422,50418193,458
"12696","chr7",128343629,128344042,128343835,413
"12697","chr21",45430659,45430927,45430793,268
"12698","chrX",74924017,74925309,74924663,1292
"12699","chr4",13527767,13527979,13527873,212
"12700","chr8",135456696,135457308,135457002,612
"12701","chr16",10907789,10908015,10907902,226
"12702","chr6",85641833,85644196,85643014,2363
"12703","chr9",91900283,91900536,91900409,253
"12704","chr4",76801939,76802271,76802105,332
"12705","chrX",5892966,5893263,5893114,297
"12706","chr16",20073172,20073983,20073577,811
"12707","chr22",46662973,46663217,46663095,244
"12708","chr12",43550916,43552482,43551699,1566
"12709","chr17",56913471,56914410,56913940,939
"12710","chr8",119873574,119874370,119873972,796
"12711","chr17",8156238,8156919,8156578,681
"12712","chr9",124045231,124045453,124045342,222
"12713","chr5",1594123,1594912,1594517,789
"12714","chr6",27374658,27375000,27374829,342
"12715","chr10",17616666,17617640,17617153,974
"12716","chr1",161159348,161159899,161159623,551
"12717","chr1",37554005,37554222,37554113,217
"12718","chr10",606319,606588,606453,269
"12719","chr3",58177742,58177953,58177847,211
"12720","chr14",54565108,54568112,54566610,3004
"12721","chr15",39782444,39782987,39782715,543
"12722","chr1",154328499,154329052,154328775,553
"12723","chr16",4936166,4937532,4936849,1366
"12724","chr16",66566121,66566665,66566393,544
"12725","chr7",1530584,1531500,1531042,916
"12726","chrX",37349815,37350032,37349923,217
"12727","chrX",136879943,136880792,136880367,849
"12728","chrX",140091228,140091545,140091386,317
"12729","chr17",67044613,67044913,67044763,300
"12730","chr18",32018603,32019497,32019050,894
"12731","chr20",62302443,62303952,62303197,1509
"12732","chr7",149284988,149285584,149285286,596
"12733","chr21",42892803,42893750,42893276,947
"12734","chr8",119208149,119208982,119208565,833
"12735","chr10",30784906,30785504,30785205,598
"12736","chr1",150010204,150010911,150010557,707
"12737","chr11",68843782,68844339,68844060,557
"12738","chr16",46427458,46428974,46428216,1516
"12739","chr8",108248297,108248898,108248597,601
"12740","chr16",85169194,85170335,85169764,1141
"12741","chr16",67192083,67192576,67192329,493
"12742","chr15",75903762,75904609,75904185,847
"12743","chr19",3585359,3585949,3585654,590
"12744","chr3",194058302,194058529,194058415,227
"12745","chr1",1273135,1274437,1273786,1302
"12746","chr6",26020443,26020897,26020670,454
"12747","chr3",55470173,55470425,55470299,252
"12748","chr7",65750745,65751508,65751126,763
"12749","chr5",78984494,78985477,78984985,983
"12750","chr5",141484960,141485181,141485070,221
"12751","chr8",12665112,12665717,12665414,605
"12752","chr1",245335581,245335916,245335748,335
"12753","chr15",32312446,32315710,32314078,3264
"12754","chr6",170266745,170267712,170267228,967
"12755","chr6",4281770,4282076,4281923,306
"12756","chr20",58852636,58852940,58852788,304
"12757","chr16",70800786,70801395,70801090,609
"12758","chr5",102498650,102499036,102498843,386
"12759","chr15",40440730,40442498,40441614,1768
"12760","chr5",60843532,60844538,60844035,1006
"12761","chr1",107056583,107057788,107057185,1205
"12762","chr22",42648930,42649673,42649301,743
"12763","chr7",98878381,98879331,98878856,950
"12764","chr22",18609462,18611606,18610534,2144
"12765","chr6",24359801,24360183,24359992,382
"12766","chr4",3509207,3509871,3509539,664
"12767","chr17",63842299,63843296,63842797,997
"12768","chr13",113431108,113431367,113431237,259
"12769","chr4",133148007,133149287,133148647,1280
"12770","chr7",75485554,75486438,75485996,884
"12771","chr16",1057607,1057865,1057736,258
"12772","chr1",3067361,3071398,3069379,4037
"12773","chr6",151090867,151091203,151091035,336
"12774","chr17",74371840,74372041,74371940,201
"12775","chr5",2007201,2007765,2007483,564
"12776","chr1",201829085,201829570,201829327,485
"12777","chr14",77475650,77475973,77475811,323
"12778","chr7",157757855,157758333,157758094,478
"12779","chr19",17172668,17173003,17172835,335
"12780","chr16",2155206,2155882,2155544,676
"12781","chr14",105559196,105559453,105559324,257
"12782","chr5",134366938,134367214,134367076,276
"12783","chr7",44847668,44848471,44848069,803
"12784","chr17",12020634,12021554,12021094,920
"12785","chrX",65534436,65534925,65534680,489
"12786","chr17",48944700,48944982,48944841,282
"12787","chr14",96424093,96424296,96424194,203
"12788","chr1",26110828,26112426,26111627,1598
"12789","chr7",2762806,2763064,2762935,258
"12790","chr22",50507430,50507692,50507561,262
"12791","chr16",1261335,1261757,1261546,422
"12792","chr1",40531488,40531767,40531627,279
"12793","chr1",147050656,147050993,147050824,337
"12794","chr16",10252179,10252408,10252293,229
"12795","chr16",87998550,88001362,87999956,2812
"12796","chr7",25852336,25852995,25852665,659
"12797","chr17",75012467,75013075,75012771,608
"12798","chr1",160070056,160070878,160070467,822
"12799","chr17",30970922,30971588,30971255,666
"12800","chr3",48898608,48899024,48898816,416
"12801","chr6",27096849,27097225,27097037,376
"12802","chr6",132512659,132513210,132512934,551
"12803","chr9",135105524,135105742,135105633,218
"12804","chr22",45931032,45931374,45931203,342
"12805","chr5",3962172,3962398,3962285,226
"12806","chr3",194333441,194334084,194333762,643
"12807","chr18",75455447,75455965,75455706,518
"12808","chr19",12550990,12551488,12551239,498
"12809","chr4",102760679,102761191,102760935,512
"12810","chr12",120528985,120529235,120529110,250
"12811","chr7",1019892,1020241,1020066,349
"12812","chr20",396272,396521,396396,249
"12813","chr6",96897390,96898097,96897743,707
"12814","chr14",60507054,60507405,60507229,351
"12815","chr5",112160710,112161343,112161026,633
"12816","chr17",76265046,76266201,76265623,1155
"12817","chr6",168884657,168884860,168884758,203
"12818","chr7",105387813,105389327,105388570,1514
"12819","chr20",58466393,58466610,58466501,217
"12820","chr15",81323912,81324622,81324267,710
"12821","chr16",85234734,85234962,85234848,228
"12822","chr1",46616344,46616905,46616624,561
"12823","chr10",70255021,70255940,70255480,919
"12824","chr10",132722453,132722733,132722593,280
"12825","chr8",1641872,1644116,1642994,2244
"12826","chr1",232805308,232805961,232805634,653
"12827","chr14",24271358,24271736,24271547,378
"12828","chr6",108114905,108115318,108115111,413
"12829","chr14",24334600,24335147,24334873,547
"12830","chr3",186772813,186773024,186772918,211
"12831","chr20",34997354,34997647,34997500,293
"12832","chr1",9367448,9367675,9367561,227
"12833","chr7",65251861,65252434,65252147,573
"12834","chr18",79410427,79411445,79410936,1018
"12835","chr7",23655540,23655755,23655647,215
"12836","chr22",41381386,41382277,41381831,891
"12837","chr8",22703436,22703884,22703660,448
"12838","chr6",113858558,113860511,113859534,1953
"12839","chr16",2467606,2468609,2468107,1003
"12840","chr16",2911640,2912531,2912085,891
"12841","chr16",583867,584143,584005,276
"12842","chr1",156020598,156020989,156020793,391
"12843","chr13",29594764,29596109,29595436,1345
"12844","chr1",146019304,146019601,146019452,297
"12845","chr9",136711848,136712981,136712414,1133
"12846","chr1",207963321,207963838,207963579,517
"12847","chr17",72116683,72118130,72117406,1447
"12848","chr1",11654160,11655249,11654704,1089
"12849","chr17",62679811,62680927,62680369,1116
"12850","chr17",65559784,65561813,65560798,2029
"12851","chr12",10111476,10111839,10111657,363
"12852","chr4",155208016,155209057,155208536,1041
"12853","chr10",584369,585010,584689,641
"12854","chr4",56907701,56909436,56908568,1735
"12855","chr1",154936486,154937455,154936970,969
"12856","chr8",29071554,29072201,29071877,647
"12857","chr11",1294237,1295371,1294804,1134
"12858","chr20",61928198,61928444,61928321,246
"12859","chr2",19353396,19353671,19353533,275
"12860","chr1",28259320,28260622,28259971,1302
"12861","chr6",12009100,12009427,12009263,327
"12862","chr6",125153658,125154598,125154128,940
"12863","chr10",124044485,124044863,124044674,378
"12864","chr7",74254063,74254812,74254437,749
"12865","chr5",115601916,115602452,115602184,536
"12866","chr15",28885495,28887062,28886278,1567
"12867","chr18",712232,713086,712659,854
"12868","chr21",18244781,18245557,18245169,776
"12869","chr12",7872768,7873312,7873040,544
"12870","chr5",43191872,43193053,43192462,1181
"12871","chr1",181022583,181023013,181022798,430
"12872","chr14",37591636,37592914,37592275,1278
"12873","chr1",53326015,53328156,53327085,2141
"12874","chr7",43905984,43906857,43906420,873
"12875","chr16",88120389,88120952,88120670,563
"12876","chr16",11174035,11174354,11174194,319
"12877","chr1",35192872,35193210,35193041,338
"12878","chr14",77025595,77028755,77027175,3160
"12879","chr18",12420136,12420864,12420500,728
"12880","chr2",32627940,32628203,32628071,263
"12881","chr17",83094248,83095255,83094751,1007
"12882","chr12",56257908,56258743,56258325,835
"12883","chr17",78140432,78141103,78140767,671
"12884","chr4",121070848,121072971,121071909,2123
"12885","chr4",41644275,41644565,41644420,290
"12886","chr1",6625011,6625780,6625395,769
"12887","chr1",115828189,115829006,115828597,817
"12888","chr22",36497929,36498185,36498057,256
"12889","chr13",99955868,99957432,99956650,1564
"12890","chr1",3500442,3500655,3500548,213
"12891","chr1",155050512,155051856,155051184,1344
"12892","chr6",1604371,1605510,1604940,1139
"12893","chrX",148500817,148501763,148501290,946
"12894","chr9",124040982,124041393,124041187,411
"12895","chr9",4740694,4741806,4741250,1112
"12896","chr1",32108460,32108717,32108588,257
"12897","chr22",20393804,20394521,20394162,717
"12898","chr17",73901831,73902281,73902056,450
"12899","chr20",62925675,62926862,62926268,1187
"12900","chr22",21467282,21469836,21468559,2554
"12901","chr9",77022898,77023253,77023075,355
"12902","chr6",134176398,134176618,134176508,220
"12903","chr1",32817074,32818305,32817689,1231
"12904","chr1",53838085,53838589,53838337,504
"12905","chr16",86575782,86576859,86576320,1077
"12906","chr8",6834311,6835613,6834962,1302
"12907","chrX",71716194,71716406,71716300,212
"12908","chr20",22576879,22578602,22577740,1723
"12909","chr1",26900001,26900518,26900259,517
"12910","chr17",48723171,48723384,48723277,213
"12911","chr17",82751176,82752967,82752071,1791
"12912","chr19",47256391,47257759,47257075,1368
"12913","chr12",132549073,132549425,132549249,352
"12914","chr9",33676874,33677237,33677055,363
"12915","chr10",132124191,132124791,132124491,600
"12916","chrX",137031424,137032100,137031762,676
"12917","chr20",3767666,3768760,3768213,1094
"12918","chr12",49842855,49843192,49843023,337
"12919","chr16",84181229,84181430,84181329,201
"12920","chr3",196317565,196318413,196317989,848
"12921","chr14",76352802,76353036,76352919,234
"12922","chr10",101145957,101146936,101146446,979
"12923","chr1",110150366,110151642,110151004,1276
"12924","chr6",37695985,37699326,37697655,3341
"12925","chr16",4425428,4426329,4425878,901
"12926","chr14",69766853,69767951,69767402,1098
"12927","chrX",100731435,100732198,100731816,763
"12928","chrX",52896859,52897395,52897127,536
"12929","chr2",233754949,233755425,233755187,476
"12930","chr13",20141998,20143233,20142615,1235
"12931","chrX",150982633,150984733,150983683,2100
"12932","chr7",127347589,127348179,127347884,590
"12933","chr18",13801000,13801224,13801112,224
"12934","chr10",62813411,62813640,62813525,229
"12935","chr14",50667762,50668586,50668174,824
"12936","chr5",94618208,94619138,94618673,930
"12937","chr16",14989509,14990307,14989908,798
"12938","chr1",228275548,228276787,228276167,1239
"12939","chr9",131475357,131476321,131475839,964
"12940","chr18",28175450,28178211,28176830,2761
"12941","chr1",227786727,227787126,227786926,399
"12942","chrX",48003980,48004198,48004089,218
"12943","chr11",93197594,93198225,93197909,631
"12944","chr22",36065809,36066363,36066086,554
"12945","chr3",122514058,122515097,122514577,1039
"12946","chr16",1351333,1352347,1351840,1014
"12947","chr1",22784411,22785074,22784742,663
"12948","chr16",30585166,30585550,30585358,384
"12949","chr4",183797122,183798601,183797861,1479
"12950","chr20",60087402,60087905,60087653,503
"12951","chr12",46383144,46384073,46383608,929
"12952","chr7",5494753,5495135,5494944,382
"12953","chr17",7716934,7717801,7717367,867
"12954","chr5",149730007,149732187,149731097,2180
"12955","chr1",19800029,19800287,19800158,258
"12956","chr19",4102301,4102979,4102640,678
"12957","chr8",141226289,141226490,141226389,201
"12958","chr21",31659421,31660344,31659882,923
"12959","chr17",37643221,37643499,37643360,278
"12960","chr1",182604240,182604625,182604432,385
"12961","chr17",80454462,80455488,80454975,1026
"12962","chr14",31206805,31208240,31207522,1435
"12963","chr5",129459810,129461724,129460767,1914
"12964","chr6",44387419,44388041,44387730,622
"12965","chr4",48483326,48484456,48483891,1130
"12966","chr12",132835808,132836584,132836196,776
"12967","chr3",100492389,100492731,100492560,342
"12968","chr1",70410939,70411408,70411173,469
"12969","chr1",19485209,19486150,19485679,941
"12970","chr3",156826102,156826616,156826359,514
"12971","chr3",137032499,137032841,137032670,342
"12972","chr5",103258734,103259849,103259291,1115
"12973","chr14",21098101,21098663,21098382,562
"12974","chr22",40021349,40021866,40021607,517
"12975","chr17",21252895,21253642,21253268,747
"12976","chr1",116167536,116167925,116167730,389
"12977","chr7",953765,954938,954351,1173
"12978","chr17",81986737,81987461,81987099,724
"12979","chr22",42142460,42143578,42143019,1118
"12980","chr9",34957720,34958475,34958097,755
"12981","chr1",41917969,41918332,41918150,363
"12982","chr6",31827690,31829607,31828648,1917
"12983","chr17",30708183,30710503,30709343,2320
"12984","chr3",53195974,53196188,53196081,214
"12985","chr17",42421722,42423508,42422615,1786
"12986","chr19",15113564,15114104,15113834,540
"12987","chr11",117876387,117876838,117876612,451
"12988","chr17",4833137,4833805,4833471,668
"12989","chr14",64704158,64705289,64704723,1131
"12990","chr16",34158770,34160020,34159395,1250
"12991","chr3",88149364,88150363,88149863,999
"12992","chr14",81220041,81221541,81220791,1500
"12993","chr10",1474784,1475118,1474951,334
"12994","chr20",50609564,50609768,50609666,204
"12995","chr4",1683678,1684744,1684211,1066
"12996","chr6",149922766,149923074,149922920,308
"12997","chr14",105498651,105498967,105498809,316
"12998","chr11",113875094,113875971,113875532,877
"12999","chr16",57984496,57985567,57985031,1071
"13000","chr1",164321278,164321530,164321404,252
"13001","chr12",49130289,49131709,49130999,1420
"13002","chr1",39691258,39692842,39692050,1584
"13003","chr17",58219127,58219481,58219304,354
"13004","chr15",70762559,70763891,70763225,1332
"13005","chr4",6715988,6716822,6716405,834
"13006","chr7",76393052,76393855,76393453,803
"13007","chr21",41835367,41835613,41835490,246
"13008","chr7",129054459,129055303,129054881,844
"13009","chr16",90052407,90053113,90052760,706
"13010","chr13",113635709,113635947,113635828,238
"13011","chr14",74492977,74494204,74493590,1227
"13012","chr6",106511889,106513110,106512499,1221
"13013","chr14",67473457,67473953,67473705,496
"13014","chr16",30946809,30947174,30946991,365
"13015","chr14",19337328,19337772,19337550,444
"13016","chrY",6305505,6305798,6305651,293
"13017","chr9",126804865,126805524,126805194,659
"13018","chr2",200864169,200864854,200864511,685
"13019","chr17",79103913,79104121,79104017,208
"13020","chr3",159988703,159989224,159988963,521
"13021","chr6",41786142,41787838,41786990,1696
"13022","chr15",45430363,45430741,45430552,378
"13023","chr22",41914053,41915665,41914859,1612
"13024","chr5",421109,421636,421372,527
"13025","chr11",130314053,130314757,130314405,704
"13026","chr16",2583478,2583919,2583698,441
"13027","chr22",30667475,30668397,30667936,922
"13028","chr3",157159386,157160575,157159980,1189
"13029","chr11",64809805,64810877,64810341,1072
"13030","chr1",37859478,37860327,37859902,849
"13031","chr20",51767136,51768833,51767984,1697
"13032","chr2",106487250,106487597,106487423,347
"13033","chrX",24149185,24150668,24149926,1483
"13034","chr1",205228504,205228831,205228667,327
"13035","chr1",25771413,25771616,25771514,203
"13036","chr17",41835769,41836375,41836072,606
"13037","chr1",151399381,151400106,151399743,725
"13038","chr5",141357254,141357491,141357372,237
"13039","chr5",55172955,55173496,55173225,541
"13040","chr6",32664381,32665250,32664815,869
"13041","chr2",94735635,94735891,94735763,256
"13042","chr5",132819596,132819805,132819700,209
"13043","chr11",67519763,67520097,67519930,334
"13044","chr2",235764659,235765350,235765004,691
"13045","chr14",60637260,60637945,60637602,685
"13046","chr5",141096015,141097023,141096519,1008
"13047","chr3",47846335,47846660,47846497,325
"13048","chr16",89061196,89061407,89061301,211
"13049","chr10",931349,932980,932164,1631
"13050","chr19",1354421,1355351,1354886,930
"13051","chr1",15684083,15685007,15684545,924
"13052","chr7",138664217,138665120,138664668,903
"13053","chr11",72821567,72822729,72822148,1162
"13054","chr15",83107109,83108170,83107639,1061
"13055","chr6",108074228,108075139,108074683,911
"13056","chr1",2628453,2629253,2628853,800
"13057","chr2",55519539,55519863,55519701,324
"13058","chr18",59219859,59220433,59220146,574
"13059","chr14",20723387,20723701,20723544,314
"13060","chr2",120442927,120443212,120443069,285
"13061","chr2",111883760,111884329,111884044,569
"13062","chr17",49219607,49219952,49219779,345
"13063","chr1",2114990,2115426,2115208,436
"13064","chr4",7042560,7044005,7043282,1445
"13065","chr19",39996852,39997387,39997119,535
"13066","chr16",18801065,18802077,18801571,1012
"13067","chrX",154097110,154098015,154097562,905
"13068","chr14",104637156,104637432,104637294,276
"13069","chr10",49394943,49398737,49396840,3794
"13070","chr5",33936063,33938204,33937133,2141
"13071","chrX",39820886,39822164,39821525,1278
"13072","chr2",218871410,218871870,218871640,460
"13073","chr1",202642540,202643911,202643225,1371
"13074","chr20",23349999,23351409,23350704,1410
"13075","chr5",150000401,150001239,150000820,838
"13076","chr6",41407007,41407449,41407228,442
"13077","chr6",160347382,160349276,160348329,1894
"13078","chr12",82358225,82358967,82358596,742
"13079","chr9",124010967,124013287,124012127,2320
"13080","chr16",74606570,74607299,74606934,729
"13081","chr6",117265319,117265993,117265656,674
"13082","chr10",80204925,80205802,80205363,877
"13083","chr22",50508037,50508581,50508309,544
"13084","chr5",141968966,141969539,141969252,573
"13085","chrX",153444746,153445356,153445051,610
"13086","chr10",94362783,94363147,94362965,364
"13087","chr3",124268879,124269099,124268989,220
"13088","chr17",20908435,20908845,20908640,410
"13089","chr5",95283755,95285417,95284586,1662
"13090","chr3",10010857,10011339,10011098,482
"13091","chr4",70704430,70705909,70705169,1479
"13092","chr22",30326583,30327229,30326906,646
"13093","chr20",38747978,38748787,38748382,809
"13094","chr14",101925262,101925516,101925389,254
"13095","chr20",63519692,63521494,63520593,1802
"13096","chr1",80330972,80331201,80331086,229
"13097","chr5",157265802,157266739,157266270,937
"13098","chr16",88473452,88474124,88473788,672
"13099","chr3",129626824,129627678,129627251,854
"13100","chr16",86515463,86516906,86516184,1443
"13101","chr1",35641368,35641660,35641514,292
"13102","chr12",75207301,75207972,75207636,671
"13103","chr17",50536517,50537105,50536811,588
"13104","chr13",111020014,111020318,111020166,304
"13105","chr11",62923502,62924016,62923759,514
"13106","chr1",32464899,32465460,32465179,561
"13107","chr9",124415087,124415539,124415313,452
"13108","chr10",102393972,102395800,102394886,1828
"13109","chr13",79405869,79406588,79406228,719
"13110","chr6",89819418,89819979,89819698,561
"13111","chr12",104063988,104065309,104064648,1321
"13112","chr16",2019717,2020864,2020290,1147
"13113","chr7",2353993,2355539,2354766,1546
"13114","chr7",5190026,5190710,5190368,684
"13115","chr3",49539814,49540098,49539956,284
"13116","chr1",179586229,179586915,179586572,686
"13117","chr6",55578934,55579294,55579114,360
"13118","chr5",40679400,40681979,40680689,2579
"13119","chr19",11293836,11294100,11293968,264
"13120","chr2",582818,583385,583101,567
"13121","chr1",23800300,23801059,23800679,759
"13122","chr1",31789124,31789407,31789265,283
"13123","chr7",141551213,141551672,141551442,459
"13124","chr10",132741609,132741834,132741721,225
"13125","chr20",32743151,32743626,32743388,475
"13126","chr21",32278597,32279202,32278899,605
"13127","chr5",178113206,178114233,178113719,1027
"13128","chr12",122997343,122997570,122997456,227
"13129","chr7",21945453,21946224,21945838,771
"13130","chr18",77120083,77120326,77120204,243
"13131","chr1",209805971,209806321,209806146,350
"13132","chr8",48834836,48835062,48834949,226
"13133","chr1",39671550,39672415,39671982,865
"13134","chr22",31749649,31750214,31749931,565
"13135","chr13",25468555,25469348,25468951,793
"13136","chr21",38660319,38661741,38661030,1422
"13137","chr7",1109743,1110670,1110206,927
"13138","chr20",17680876,17682811,17681843,1935
"13139","chr16",22573229,22573444,22573336,215
"13140","chr3",133661614,133662145,133661879,531
"13141","chr7",101180090,101180420,101180255,330
"13142","chr20",62683823,62684145,62683984,322
"13143","chr18",48539162,48541455,48540308,2293
"13144","chr6",124961978,124963243,124962610,1265
"13145","chr6",160679060,160679424,160679242,364
"13146","chr19",45398194,45398430,45398312,236
"13147","chr9",124809847,124810362,124810104,515
"13148","chr7",572903,574102,573502,1199
"13149","chr3",127672168,127673591,127672879,1423
"13150","chr20",38260489,38261040,38260764,551
"13151","chr14",100149203,100149571,100149387,368
"13152","chr3",155079609,155080199,155079904,590
"13153","chr7",72924829,72925710,72925269,881
"13154","chr1",17437576,17439981,17438778,2405
"13155","chr5",51387451,51387781,51387616,330
"13156","chr1",10032474,10033346,10032910,872
"13157","chr14",72925988,72926908,72926448,920
"13158","chr5",3324530,3324859,3324694,329
"13159","chr19",47004049,47004435,47004242,386
"13160","chr7",151028086,151028931,151028508,845
"13161","chr7",129825564,129826304,129825934,740
"13162","chr14",103384880,103386371,103385625,1491
"13163","chr1",3519424,3519686,3519555,262
"13164","chr16",1258003,1258307,1258155,304
"13165","chr13",110385732,110386054,110385893,322
"13166","chr1",86395883,86396400,86396141,517
"13167","chr12",6748807,6749091,6748949,284
"13168","chr8",85220192,85220774,85220483,582
"13169","chr8",60280753,60281636,60281194,883
"13170","chr21",34886655,34887175,34886915,520
"13171","chr20",25407596,25408006,25407801,410
"13172","chr1",247103877,247104582,247104229,705
"13173","chr5",1633455,1634109,1633782,654
"13174","chr3",184603995,184604612,184604303,617
"13175","chr9",121736234,121736683,121736458,449
"13176","chr14",56817249,56817840,56817544,591
"13177","chr2",230848060,230848267,230848163,207
"13178","chr14",99603138,99605476,99604307,2338
"13179","chr1",110673622,110675675,110674648,2053
"13180","chr10",73997726,73998469,73998097,743
"13181","chr2",66434974,66435206,66435090,232
"13182","chr9",127734983,127735567,127735275,584
"13183","chr2",64453975,64455075,64454525,1100
"13184","chrX",38327169,38327757,38327463,588
"13185","chr3",32502596,32502863,32502729,267
"13186","chr17",3532659,3532870,3532764,211
"13187","chr8",142544264,142544801,142544532,537
"13188","chr12",50057292,50058160,50057726,868
"13189","chr19",50908387,50908748,50908567,361
"13190","chr1",9762518,9762759,9762638,241
"13191","chr22",42500180,42501035,42500607,855
"13192","chr3",32821682,32821923,32821802,241
"13193","chr20",33811456,33811744,33811600,288
"13194","chrX",56563512,56564081,56563796,569
"13195","chr16",19410494,19411176,19410835,682
"13196","chr1",11262201,11262979,11262590,778
"13197","chr5",1444144,1444352,1444248,208
"13198","chr1",205321104,205321907,205321505,803
"13199","chr10",97640506,97641225,97640865,719
"13200","chr5",126594909,126595357,126595133,448
"13201","chr19",39125637,39126179,39125908,542
"13202","chr1",240406020,240406379,240406199,359
"13203","chrX",65667617,65667970,65667793,353
"13204","chr1",207050744,207051105,207050924,361
"13205","chr12",114700457,114700670,114700563,213
"13206","chr8",144619240,144619570,144619405,330
"13207","chr19",33811263,33811663,33811463,400
"13208","chr19",18173711,18174213,18173962,502
"13209","chr1",1658612,1659481,1659046,869
"13210","chr2",104867295,104867968,104867631,673
"13211","chr1",52602208,52602936,52602572,728
"13212","chr8",64369346,64370404,64369875,1058
"13213","chr11",61567640,61567868,61567754,228
"13214","chr9",136447266,136447469,136447367,203
"13215","chr3",49856377,49856783,49856580,406
"13216","chr2",72143167,72143553,72143360,386
"13217","chr1",47333739,47334754,47334246,1015
"13218","chr19",808004,808834,808419,830
"13219","chr12",55646204,55646553,55646378,349
"13220","chr20",41692835,41693320,41693077,485
"13221","chr12",65741712,65742620,65742166,908
"13222","chr14",76956499,76956751,76956625,252
"13223","chr4",98143451,98143654,98143552,203
"13224","chr11",18209072,18209359,18209215,287
"13225","chr9",130885033,130885492,130885262,459
"13226","chr2",39120110,39121220,39120665,1110
"13227","chr1",145858692,145859938,145859315,1246
"13228","chr14",100144069,100144354,100144211,285
"13229","chr2",74482037,74482983,74482510,946
"13230","chr20",2820993,2821489,2821241,496
"13231","chr5",141441661,141442121,141441891,460
"13232","chr4",3669430,3669805,3669617,375
"13233","chr13",97346708,97347123,97346915,415
"13234","chr19",50330812,50331070,50330941,258
"13235","chrX",56232518,56232726,56232622,208
"13236","chr1",64744599,64745555,64745077,956
"13237","chr7",156154149,156155960,156155054,1811
"13238","chr1",15526613,15527168,15526890,555
"13239","chr5",178302222,178302465,178302343,243
"13240","chr4",163343669,163344620,163344144,951
"13241","chr2",45643557,45643912,45643734,355
"13242","chr21",14216118,14216587,14216352,469
"13243","chr4",39527108,39528103,39527605,995
"13244","chr7",5570094,5570474,5570284,380
"13245","chr10",80535745,80536436,80536090,691
"13246","chr12",8032368,8033020,8032694,652
"13247","chr5",178055698,178055960,178055829,262
"13248","chrX",68433104,68434065,68433584,961
"13249","chr7",1444004,1444423,1444213,419
"13250","chr1",151458750,151459556,151459153,806
"13251","chr16",693924,695943,694933,2019
"13252","chr2",86194945,86195735,86195340,790
"13253","chr7",140230265,140231289,140230777,1024
"13254","chr1",202888555,202889266,202888910,711
"13255","chr1",86914479,86915531,86915005,1052
"13256","chr8",17001535,17001943,17001739,408
"13257","chrX",2828512,2830194,2829353,1682
"13258","chr9",5185333,5185780,5185556,447
"13259","chr19",5622237,5623701,5622969,1464
"13260","chr7",20783688,20785511,20784599,1823
"13261","chr14",91509326,91510982,91510154,1656
"13262","chr5",132813162,132815226,132814194,2064
"13263","chr10",86968282,86968963,86968622,681
"13264","chrX",44844239,44844648,44844443,409
"13265","chr19",15728186,15728467,15728326,281
"13266","chrX",72238710,72239352,72239031,642
"13267","chr1",2800176,2800668,2800422,492
"13268","chr22",19169464,19169900,19169682,436
"13269","chr3",48847070,48847973,48847521,903
"13270","chr7",151724582,151725071,151724826,489
"13271","chr1",11925586,11926078,11925832,492
"13272","chr20",50153408,50154172,50153790,764
"13273","chr13",94701935,94702930,94702432,995
"13274","chr16",67170305,67170734,67170519,429
"13275","chr7",158973435,158974709,158974072,1274
"13276","chr10",62804675,62806058,62805366,1383
"13277","chr14",19344830,19345388,19345109,558
"13278","chr16",84661563,84662062,84661812,499
"13279","chr19",45494615,45494998,45494806,383
"13280","chr1",1387264,1387544,1387404,280
"13281","chr3",195867965,195868623,195868294,658
"13282","chr16",1092315,1094087,1093201,1772
"13283","chr8",12014609,12015270,12014939,661
"13284","chr18",47034654,47035451,47035052,797
"13285","chr10",86363167,86367607,86365387,4440
"13286","chr19",49388012,49388347,49388179,335
"13287","chr17",68247442,68248262,68247852,820
"13288","chr16",2751912,2753408,2752660,1496
"13289","chr9",133071199,133071663,133071431,464
"13290","chr12",131032722,131033079,131032900,357
"13291","chr1",46132454,46133457,46132955,1003
"13292","chr22",47117306,47117689,47117497,383
"13293","chr19",45091139,45091749,45091444,610
"13294","chr8",63038563,63039545,63039054,982
"13295","chr5",139661159,139661443,139661301,284
"13296","chr7",103074659,103075568,103075113,909
"13297","chr18",45775353,45775733,45775543,380
"13298","chr7",31193063,31193286,31193174,223
"13299","chr19",13138183,13138424,13138303,241
"13300","chr22",39292123,39292344,39292233,221
"13301","chr5",36875825,36877558,36876691,1733
"13302","chr4",3363467,3363688,3363577,221
"13303","chr9",84668263,84670789,84669526,2526
"13304","chr1",165768595,165769112,165768853,517
"13305","chr8",8318177,8318663,8318420,486
"13306","chr1",156572307,156572710,156572508,403
"13307","chr5",32312232,32313363,32312797,1131
"13308","chrX",131082356,131082928,131082642,572
"13309","chr7",44581694,44582778,44582236,1084
"13310","chr10",5446521,5446723,5446622,202
"13311","chr19",14117677,14118452,14118064,775
"13312","chr5",643312,643554,643433,242
"13313","chr7",63900748,63901115,63900931,367
"13314","chr20",62406852,62407724,62407288,872
"13315","chr10",101042876,101043122,101042999,246
"13316","chr1",110963259,110964385,110963822,1126
"13317","chr2",153872431,153872815,153872623,384
"13318","chr2",232550295,232551101,232550698,806
"13319","chr19",13794996,13795527,13795261,531
"13320","chr2",238288282,238289186,238288734,904
"13321","chr7",231272,231539,231405,267
"13322","chr14",60514805,60515918,60515361,1113
"13323","chr5",130995078,130995399,130995238,321
"13324","chr7",140292521,140292774,140292647,253
"13325","chr19",52601293,52601896,52601594,603
"13326","chr8",2089883,2090163,2090023,280
"13327","chr1",28088587,28088801,28088694,214
"13328","chr4",150582859,150583933,150583396,1074
"13329","chr5",16700962,16701666,16701314,704
"13330","chr2",230987131,230987440,230987285,309
"13331","chr12",125331009,125331271,125331140,262
"13332","chr17",76014896,76015174,76015035,278
"13333","chr14",75259045,75259326,75259185,281
"13334","chr19",2819632,2820297,2819964,665
"13335","chr17",7704857,7705638,7705247,781
"13336","chr2",45310932,45311179,45311055,247
"13337","chrX",136098258,136098624,136098441,366
"13338","chr12",6891066,6891559,6891312,493
"13339","chr2",119524085,119524625,119524355,540
"13340","chr19",48636899,48637874,48637386,975
"13341","chr12",54217811,54218254,54218032,443
"13342","chr20",46364038,46364464,46364251,426
"13343","chr12",123383720,123384834,123384277,1114
"13344","chr8",124727444,124729025,124728234,1581
"13345","chr7",5607473,5607709,5607591,236
"13346","chr2",229921196,229922949,229922072,1753
"13347","chr10",133126830,133127371,133127100,541
"13348","chr1",77979079,77979597,77979338,518
"13349","chr7",2558916,2559569,2559242,653
"13350","chr1",778604,779167,778885,563
"13351","chr2",176162889,176163286,176163087,397
"13352","chr21",25607123,25607940,25607531,817
"13353","chr19",496822,498135,497478,1313
"13354","chr11",112226299,112226824,112226561,525
"13355","chr9",100598673,100599030,100598851,357
"13356","chr17",22217269,22217521,22217395,252
"13357","chr1",40132836,40133537,40133186,701
"13358","chr12",120213908,120214140,120214024,232
"13359","chr1",10654344,10654651,10654497,307
"13360","chr12",130160782,130164443,130162612,3661
"13361","chr21",46160578,46162151,46161364,1573
"13362","chr16",31108236,31109423,31108829,1187
"13363","chr16",30604456,30604965,30604710,509
"13364","chr1",110130188,110130717,110130452,529
"13365","chr1",233327251,233328765,233328008,1514
"13366","chr16",4768770,4769032,4768901,262
"13367","chr14",22836684,22837804,22837244,1120
"13368","chr16",88229520,88229724,88229622,204
"13369","chr19",406131,406611,406371,480
"13370","chr20",58851674,58851992,58851833,318
"13371","chr1",171841327,171842185,171841756,858
"13372","chr10",100286385,100286875,100286630,490
"13373","chr14",106213836,106214058,106213947,222
"13374","chr2",74130447,74130887,74130667,440
"13375","chr1",225427019,225428810,225427914,1791
"13376","chr2",3605225,3605535,3605380,310
"13377","chr7",920087,920322,920204,235
"13378","chr14",68789959,68790319,68790139,360
"13379","chr13",113541394,113542404,113541899,1010
"13380","chr1",181482175,181482913,181482544,738
"13381","chr20",408074,408698,408386,624
"13382","chr1",28518141,28518781,28518461,640
"13383","chr14",77320347,77321451,77320899,1104
"13384","chr7",7640209,7641048,7640628,839
"13385","chr18",76441283,76443117,76442200,1834
"13386","chr5",173232046,173233274,173232660,1228
"13387","chr3",157437478,157437976,157437727,498
"13388","chr14",95713919,95714511,95714215,592
"13389","chr6",132400954,132401762,132401358,808
"13390","chr7",29988902,29990206,29989554,1304
"13391","chr6",118650499,118651540,118651019,1041
"13392","chr1",52698016,52698508,52698262,492
"13393","chrX",119990533,119991708,119991120,1175
"13394","chr17",2023914,2026114,2025014,2200
"13395","chr17",7042070,7044202,7043136,2132
"13396","chr14",20684324,20684581,20684452,257
"13397","chr1",213985383,213985737,213985560,354
"13398","chr12",50842850,50843141,50842995,291
"13399","chr2",26785892,26786597,26786244,705
"13400","chr2",204545216,204546187,204545701,971
"13401","chr2",66581436,66582272,66581854,836
"13402","chr13",113647996,113648204,113648100,208
"13403","chr14",73718779,73719291,73719035,512
"13404","chr14",88551316,88551628,88551472,312
"13405","chr4",52076812,52077082,52076947,270
"13406","chr1",3899792,3901520,3900656,1728
"13407","chr19",45767441,45771706,45769573,4265
"13408","chr17",45021761,45022128,45021944,367
"13409","chr3",47475507,47475942,47475724,435
"13410","chr3",48503865,48504087,48503976,222
"13411","chr22",35424102,35424309,35424205,207
"13412","chr6",118934468,118935166,118934817,698
"13413","chr7",4129849,4130121,4129985,272
"13414","chr17",55238257,55238837,55238547,580
"13415","chr14",24232440,24232786,24232613,346
"13416","chr2",231900536,231900781,231900658,245
"13417","chr1",201283324,201284520,201283922,1196
"13418","chr1",223845383,223846561,223845972,1178
"13419","chr17",4782401,4783020,4782710,619
"13420","chr14",92639914,92640120,92640017,206
"13421","chrX",152941510,152941951,152941730,441
"13422","chr10",678696,679423,679059,727
"13423","chr5",169583589,169584171,169583880,582
"13424","chr1",30721429,30721740,30721584,311
"13425","chr3",139043847,139045271,139044559,1424
"13426","chr1",87331699,87332201,87331950,502
"13427","chr7",66075556,66076117,66075836,561
"13428","chr1",220884121,220884870,220884495,749
"13429","chr19",58451373,58452069,58451721,696
"13430","chr16",1343572,1343877,1343724,305
"13431","chr4",10077711,10077931,10077821,220
"13432","chr19",35936271,35936820,35936545,549
"13433","chr16",89919505,89919948,89919726,443
"13434","chr3",93979919,93980589,93980254,670
"13435","chr5",1243534,1243835,1243684,301
"13436","chr8",143307412,143308456,143307934,1044
"13437","chr14",85533188,85534134,85533661,946
"13438","chr22",16609565,16610334,16609949,769
"13439","chr7",27169252,27169964,27169608,712
"13440","chrX",84187388,84188516,84187952,1128
"13441","chr19",51719170,51719955,51719562,785
"13442","chr1",32200630,32200859,32200744,229
"13443","chr10",68988679,68989578,68989128,899
"13444","chr14",30874149,30875268,30874708,1119
"13445","chr6",30646944,30647866,30647405,922
"13446","chr5",73435994,73436234,73436114,240
"13447","chr5",150649383,150649895,150649639,512
"13448","chr16",4253443,4254224,4253833,781
"13449","chr6",37648617,37648845,37648731,228
"13450","chr13",112689539,112690874,112690206,1335
"13451","chr11",117315628,117316263,117315945,635
"13452","chr5",42944164,42944480,42944322,316
"13453","chr19",807131,807445,807288,314
"13454","chr12",132168478,132168691,132168584,213
"13455","chr16",67161697,67161924,67161810,227
"13456","chr7",100126859,100128185,100127522,1326
"13457","chr7",2718370,2718623,2718496,253
"13458","chr9",130923665,130923875,130923770,210
"13459","chr2",205925908,205926110,205926009,202
"13460","chr5",141692057,141692400,141692228,343
"13461","chr20",63394909,63395127,63395018,218
"13462","chr2",27032732,27033253,27032992,521
"13463","chr16",31568749,31568996,31568872,247
"13464","chr9",126610458,126615827,126613142,5369
"13465","chr7",87059381,87059702,87059541,321
"13466","chr2",190319597,190320041,190319819,444
"13467","chr5",35617753,35618237,35617995,484
"13468","chr19",49873099,49873307,49873203,208
"13469","chr9",129080652,129081469,129081060,817
"13470","chr19",42133125,42133532,42133328,407
"13471","chr22",42338451,42338711,42338581,260
"13472","chr2",1540500,1540717,1540608,217
"13473","chr7",876116,877353,876734,1237
"13474","chr7",44239449,44239728,44239588,279
"13475","chr7",4758898,4759650,4759274,752
"13476","chr9",92764177,92765543,92764860,1366
"13477","chr5",123400932,123401293,123401112,361
"13478","chr14",77139542,77141961,77140751,2419
"13479","chr22",35257368,35257981,35257674,613
"13480","chr5",84383766,84384785,84384275,1019
"13481","chr19",54137355,54138609,54137982,1254
"13482","chr17",7588996,7589627,7589311,631
"13483","chr20",4221501,4222118,4221809,617
"13484","chr19",46495771,46496033,46495902,262
"13485","chr5",140848544,140848991,140848767,447
"13486","chr12",121686933,121687310,121687121,377
"13487","chr12",112108343,112108902,112108622,559
"13488","chr8",66113615,66113883,66113749,268
"13489","chr19",38726890,38727217,38727053,327
"13490","chr4",112411785,112412167,112411976,382
"13491","chr1",236523771,236524308,236524039,537
"13492","chr7",143885032,143885517,143885274,485
"13493","chr15",73632692,73633584,73633138,892
"13494","chr12",65278606,65279470,65279038,864
"13495","chr19",16532462,16532788,16532625,326
"13496","chr3",196081407,196082348,196081877,941
"13497","chr14",74923009,74923430,74923219,421
"13498","chr12",64390230,64390884,64390557,654
"13499","chr16",29995257,29996553,29995905,1296
"13500","chr22",42614434,42615057,42614745,623
"13501","chr10",132134821,132135173,132134997,352
"13502","chr19",46078787,46079186,46078986,399
"13503","chr12",111033257,111035742,111034499,2485
"13504","chr6",168909722,168910217,168909969,495
"13505","chr20",13638638,13639123,13638880,485
"13506","chr7",100171261,100171936,100171598,675
"13507","chr19",3120996,3122718,3121857,1722
"13508","chr16",30979207,30979409,30979308,202
"13509","chr19",33373270,33374272,33373771,1002
"13510","chr10",1362464,1364024,1363244,1560
"13511","chr19",3381527,3382277,3381902,750
"13512","chr19",7899554,7899819,7899686,265
"13513","chr12",64404154,64405164,64404659,1010
"13514","chr4",88591877,88593330,88592603,1453
"13515","chr9",91724009,91724971,91724490,962
"13516","chr9",137045331,137046689,137046010,1358
"13517","chr5",61625707,61626645,61626176,938
"13518","chr10",30433449,30434778,30434113,1329
"13519","chr2",95165412,95166088,95165750,676
"13520","chr8",118952150,118952398,118952274,248
"13521","chr9",87148421,87148852,87148636,431
"13522","chr16",89560236,89561461,89560848,1225
"13523","chr19",47778328,47779094,47778711,766
"13524","chr19",49057837,49058363,49058100,526
"13525","chr16",57883977,57884447,57884212,470
"13526","chr8",8386049,8386769,8386409,720
"13527","chr17",43720493,43721013,43720753,520
"13528","chr17",4939563,4940341,4939952,778
"13529","chr6",33633325,33633956,33633640,631
"13530","chr17",37406724,37406967,37406845,243
"13531","chr14",32076070,32077935,32077002,1865
"13532","chr19",46860100,46861545,46860822,1445
"13533","chr6",157236037,157236963,157236500,926
"13534","chr12",52714128,52714687,52714407,559
"13535","chr10",133640447,133641024,133640735,577
"13536","chr15",40252151,40253311,40252731,1160
"13537","chr9",5437566,5437996,5437781,430
"13538","chr2",206642050,206642698,206642374,648
"13539","chr4",77862591,77862861,77862726,270
"13540","chr19",6767934,6768149,6768041,215
"13541","chr19",3185742,3186494,3186118,752
"13542","chr2",71226458,71227188,71226823,730
"13543","chr22",27614235,27614638,27614436,403
"13544","chr18",61893476,61894716,61894096,1240
"13545","chr19",11374610,11375093,11374851,483
"13546","chr19",56100930,56101374,56101152,444
"13547","chr16",2817191,2818001,2817596,810
"13548","chr1",21509055,21509851,21509453,796
"13549","chr22",21013908,21014482,21014195,574
"13550","chr3",50291968,50292685,50292326,717
"13551","chr8",144684291,144687461,144685876,3170
"13552","chr6",80106402,80106969,80106685,567
"13553","chr8",106271245,106271648,106271446,403
"13554","chr15",42920218,42921403,42920810,1185
"13555","chr17",40054514,40054722,40054618,208
"13556","chr7",106111657,106112702,106112179,1045
"13557","chr19",2858895,2859241,2859068,346
"13558","chr12",2958794,2960278,2959536,1484
"13559","chr3",138329351,138329936,138329643,585
"13560","chr14",102907500,102907803,102907651,303
"13561","chr9",136994482,136995891,136995186,1409
"13562","chr5",111512122,111512747,111512434,625
"13563","chr19",50818011,50818525,50818268,514
"13564","chr15",43329632,43330755,43330193,1123
"13565","chr8",143072233,143073978,143073105,1745
"13566","chr17",4142498,4143197,4142847,699
"13567","chr8",123395852,123396798,123396325,946
"13568","chr8",145052415,145053010,145052712,595
"13569","chr8",142499408,142499614,142499511,206
"13570","chr12",116819426,116819697,116819561,271
"13571","chr10",69577829,69578919,69578374,1090
"13572","chr5",173236613,173237581,173237097,968
"13573","chr17",18411705,18412185,18411945,480
"13574","chr4",186723165,186727099,186725132,3934
"13575","chr3",196739714,196740482,196740098,768
"13576","chr1",43933396,43933863,43933629,467
"13577","chr8",73976003,73976690,73976346,687
"13578","chr16",68371004,68372370,68371687,1366
"13579","chr3",161161711,161161934,161161822,223
"13580","chr5",141101962,141102876,141102419,914
"13581","chr10",47349986,47350342,47350164,356
"13582","chr4",49523884,49524104,49523994,220
"13583","chr7",54697733,54697944,54697838,211
"13584","chr3",131026544,131026996,131026770,452
"13585","chr10",100912610,100913402,100913006,792
"13586","chr20",63064229,63064573,63064401,344
"13587","chr8",143278496,143279334,143278915,838
"13588","chr12",51025857,51026564,51026210,707
"13589","chr17",4703689,4704427,4704058,738
"13590","chr6",26031652,26032036,26031844,384
"13591","chr12",50081086,50081662,50081374,576
"13592","chr2",176147643,176147947,176147795,304
"13593","chr5",176609457,176610736,176610096,1279
"13594","chr5",97183715,97183941,97183828,226
"13595","chrX",51396101,51396403,51396252,302
"13596","chr7",44324833,44325718,44325275,885
"13597","chr2",172427371,172428455,172427913,1084
"13598","chr3",51384555,51385600,51385077,1045
"13599","chr19",42410348,42410737,42410542,389
"13600","chr9",133417560,133418363,133417961,803
"13601","chr2",207624704,207626306,207625505,1602
"13602","chr15",80403734,80405051,80404392,1317
"13603","chr13",23979537,23979868,23979702,331
"13604","chr10",130567421,130567717,130567569,296
"13605","chr19",11536035,11536295,11536165,260
"13606","chr1",92298616,92299369,92298992,753
"13607","chr19",8321198,8322088,8321643,890
"13608","chr10",77925961,77927292,77926626,1331
"13609","chr5",83722075,83722539,83722307,464
"13610","chr15",60478869,60479359,60479114,490
"13611","chr18",32091794,32093351,32092572,1557
"13612","chr7",144355022,144355557,144355289,535
"13613","chr2",238158936,238159387,238159161,451
"13614","chr17",7841644,7845102,7843373,3458
"13615","chr21",43657790,43659940,43658865,2150
"13616","chr22",29603407,29604164,29603785,757
"13617","chr11",55872592,55873609,55873100,1017
"13618","chr3",13419470,13420646,13420058,1176
"13619","chr1",3111615,3111993,3111804,378
"13620","chr9",841374,843364,842369,1990
"13621","chr11",134383566,134384257,134383911,691
"13622","chr1",3142486,3142704,3142595,218
"13623","chr12",43758703,43759119,43758911,416
"13624","chr11",67250136,67250351,67250243,215
"13625","chr6",127514783,127515110,127514946,327
"13626","chr2",176068403,176068721,176068562,318
"13627","chr8",71843548,71844432,71843990,884
"13628","chr12",120098836,120099147,120098991,311
"13629","chr16",66934126,66935021,66934573,895
"13630","chr17",82212446,82213426,82212936,980
"13631","chr12",31659111,31659457,31659284,346
"13632","chr14",21071552,21071886,21071719,334
"13633","chr8",143571604,143571806,143571705,202
"13634","chr2",240832238,240832777,240832507,539
"13635","chr19",55587020,55587566,55587293,546
"13636","chr3",50674637,50675576,50675106,939
"13637","chr19",5711692,5711969,5711830,277
"13638","chr19",17337926,17338234,17338080,308
"13639","chr9",137160916,137163385,137162150,2469
"13640","chr6",72182334,72183174,72182754,840
"13641","chr12",132572120,132572435,132572277,315
"13642","chr4",81030787,81031654,81031220,867
"13643","chr19",40567738,40568245,40567991,507
"13644","chr12",56315674,56316326,56316000,652
"13645","chr2",69012951,69013872,69013411,921
"13646","chr7",30681756,30682829,30682292,1073
"13647","chr19",17026495,17027272,17026883,777
"13648","chr1",10704392,10704868,10704630,476
"13649","chr17",32822402,32822868,32822635,466
"13650","chr14",96363129,96363997,96363563,868
"13651","chr15",41558747,41558982,41558864,235
"13652","chr19",58572834,58573692,58573263,858
"13653","chr14",55128979,55129974,55129476,995
"13654","chr1",228006395,228008811,228007603,2416
"13655","chr2",27217260,27217849,27217554,589
"13656","chr1",26620353,26621585,26620969,1232
"13657","chr20",21125707,21126326,21126016,619
"13658","chr1",9997209,9998050,9997629,841
"13659","chr14",102213950,102214182,102214066,232
"13660","chr2",96536576,96538050,96537313,1474
"13661","chr19",52585073,52585407,52585240,334
"13662","chr14",105330083,105330412,105330247,329
"13663","chr16",2047464,2048364,2047914,900
"13664","chr4",651447,651790,651618,343
"13665","chr22",21938156,21938358,21938257,202
"13666","chr8",127734004,127734234,127734119,230
"13667","chr17",19236994,19238335,19237664,1341
"13668","chr20",3092578,3093420,3092999,842
"13669","chr20",63174902,63179515,63177208,4613
"13670","chr8",17496812,17497741,17497276,929
"13671","chr20",675236,675960,675598,724
"13672","chr12",12723696,12726068,12724882,2372
"13673","chr1",161202019,161202466,161202242,447
"13674","chr11",9758217,9758923,9758570,706
"13675","chr12",124517460,124517887,124517673,427
"13676","chr22",50546543,50549712,50548127,3169
"13677","chr1",31181575,31181986,31181780,411
"13678","chr9",2843965,2844308,2844136,343
"13679","chr15",99732696,99733686,99733191,990
"13680","chr11",72584588,72584831,72584709,243
"13681","chr8",33484745,33485623,33485184,878
"13682","chr5",139392021,139395222,139393621,3201
"13683","chr19",56839915,56840916,56840415,1001
"13684","chr1",6179177,6180754,6179965,1577
"13685","chr11",13277249,13279046,13278147,1797
"13686","chr1",16646990,16648550,16647770,1560
"13687","chr7",149838154,149838948,149838551,794
"13688","chr12",128415268,128415520,128415394,252
"13689","chr22",17146341,17147833,17147087,1492
"13690","chr9",135548899,135549213,135549056,314
"13691","chr10",132869196,132869413,132869304,217
"13692","chr19",47713229,47713580,47713404,351
"13693","chrX",154357329,154357576,154357452,247
"13694","chr5",73498215,73498816,73498515,601
"13695","chr12",131138652,131138998,131138825,346
"13696","chrX",152830605,152831207,152830906,602
"13697","chr1",16888926,16889599,16889262,673
"13698","chr1",226939368,226940729,226940048,1361
"13699","chr10",7407414,7413250,7410332,5836
"13700","chr3",27369121,27369575,27369348,454
"13701","chr20",52084726,52085193,52084959,467
"13702","chr5",169637266,169637698,169637482,432
"13703","chr2",114662151,114662684,114662417,533
"13704","chr1",170074469,170074856,170074662,387
"13705","chr19",2888931,2889214,2889072,283
"13706","chr11",131690462,131690665,131690563,203
"13707","chr1",228217016,228217312,228217164,296
"13708","chr19",44777876,44778098,44777987,222
"13709","chr22",19906860,19907905,19907382,1045
"13710","chr11",2944555,2944872,2944713,317
"13711","chr12",49903797,49904205,49904001,408
"13712","chr15",51095335,51095558,51095446,223
"13713","chr19",43820284,43820857,43820570,573
"13714","chr12",132397881,132398089,132397985,208
"13715","chrX",115311786,115312078,115311932,292
"13716","chr4",40856867,40857290,40857078,423
"13717","chr1",201739659,201740301,201739980,642
"13718","chr16",25257465,25258407,25257936,942
"13719","chr3",17742570,17742963,17742766,393
"13720","chr1",212284625,212286352,212285488,1727
"13721","chr4",188631231,188631637,188631434,406
"13722","chr1",16520785,16521397,16521091,612
"13723","chr3",172449736,172450076,172449906,340
"13724","chr18",46757547,46758137,46757842,590
"13725","chr5",34915188,34916135,34915661,947
"13726","chr2",241579747,241580220,241579983,473
"13727","chr17",40099123,40099643,40099383,520
"13728","chr19",3626500,3627276,3626888,776
"13729","chr20",46246614,46246815,46246714,201
"13730","chr17",28041560,28042107,28041833,547
"13731","chr20",62351708,62352444,62352076,736
"13732","chr13",111067357,111067667,111067512,310
"13733","chr5",41869561,41870774,41870167,1213
"13734","chr1",54121691,54122019,54121855,328
"13735","chr12",130871565,130872683,130872124,1118
"13736","chr10",102151939,102152789,102152364,850
"13737","chr10",27741253,27746282,27743767,5029
"13738","chr17",50345628,50346750,50346189,1122
"13739","chr20",33401338,33401612,33401475,274
"13740","chr19",12162979,12163476,12163227,497
"13741","chrY",9640566,9640836,9640701,270
"13742","chr12",110450056,110450440,110450248,384
"13743","chr5",65035405,65035968,65035686,563
"13744","chr6",73461626,73462146,73461886,520
"13745","chr19",47483972,47484365,47484168,393
"13746","chr4",6378506,6378818,6378662,312
"13747","chr9",91948835,91950793,91949814,1958
"13748","chr1",151839777,151840049,151839913,272
"13749","chrX",101348634,101348962,101348798,328
"13750","chr19",1604919,1605682,1605300,763
"13751","chr9",34318284,34318950,34318617,666
"13752","chr17",35795020,35795797,35795408,777
"13753","chr4",99651902,99652421,99652161,519
"13754","chr5",40835139,40835771,40835455,632
"13755","chr1",904314,905239,904776,925
"13756","chr7",95596191,95596882,95596536,691
"13757","chr16",88470528,88470967,88470747,439
"13758","chr19",15457216,15458416,15457816,1200
"13759","chr11",72080339,72080914,72080626,575
"13760","chr1",162790460,162790932,162790696,472
"13761","chr1",151790128,151791531,151790829,1403
"13762","chr13",77326399,77327005,77326702,606
"13763","chr22",50459913,50460201,50460057,288
"13764","chr1",20185867,20186304,20186085,437
"13765","chr11",694564,696375,695469,1811
"13766","chrX",101931935,101932285,101932110,350
"13767","chr16",55328825,55329375,55329100,550
"13768","chr1",212606809,212609744,212608276,2935
"13769","chr2",26184553,26185384,26184968,831
"13770","chr1",204494165,204494842,204494503,677
"13771","chr4",46993111,46993855,46993483,744
"13772","chr13",25287204,25287656,25287430,452
"13773","chr6",13574206,13574878,13574542,672
"13774","chr19",7933904,7934525,7934214,621
"13775","chr14",92323046,92324368,92323707,1322
"13776","chr5",122774844,122775474,122775159,630
"13777","chr22",36856433,36856667,36856550,234
"13778","chr6",170554310,170554735,170554522,425
"13779","chr19",1360039,1360348,1360193,309
"13780","chr12",8242455,8244117,8243286,1662
"13781","chr10",96384542,96384756,96384649,214
"13782","chr1",9428878,9429190,9429034,312
"13783","chr18",5628325,5630786,5629555,2461
"13784","chr17",43398852,43399347,43399099,495
"13785","chr1",222618057,222618741,222618399,684
"13786","chr11",71518941,71519258,71519099,317
"13787","chr19",10517304,10517741,10517522,437
"13788","chr5",174735363,174735840,174735601,477
"13789","chr7",20330380,20331881,20331130,1501
"13790","chr1",100895993,100896252,100896122,259
"13791","chr1",224617706,224618151,224617928,445
"13792","chr17",28854961,28855301,28855131,340
"13793","chr10",47553199,47553892,47553545,693
"13794","chr17",81110536,81110761,81110648,225
"13795","chr14",101760414,101762517,101761465,2103
"13796","chr7",35259024,35259245,35259134,221
"13797","chr17",50117270,50117721,50117495,451
"13798","chr16",31080068,31080475,31080271,407
"13799","chr5",43000241,43000689,43000465,448
"13800","chr14",101584477,101584688,101584582,211
"13801","chr6",118651755,118651974,118651864,219
"13802","chr13",91347287,91349187,91348237,1900
"13803","chr1",827036,828065,827550,1029
"13804","chr11",65857024,65861125,65859074,4101
"13805","chr1",43453589,43454143,43453866,554
"13806","chr12",121537123,121538235,121537679,1112
"13807","chr19",57578433,57579156,57578794,723
"13808","chr10",133029961,133030272,133030116,311
"13809","chr3",18425948,18426172,18426060,224
"13810","chr11",67629373,67630823,67630098,1450
"13811","chr19",43526975,43527298,43527136,323
"13812","chr6",138291852,138292081,138291966,229
"13813","chr8",78666028,78666432,78666230,404
"13814","chrX",47513077,47513643,47513360,566
"13815","chr20",3229167,3229434,3229300,267
"13816","chr3",139538870,139539107,139538988,237
"13817","chr22",25178909,25179575,25179242,666
"13818","chr10",96512450,96514182,96513316,1732
"13819","chr17",60141265,60141565,60141415,300
"13820","chr1",32239923,32241540,32240731,1617
"13821","chr16",30957104,30958494,30957799,1390
"13822","chr19",44748510,44749073,44748791,563
"13823","chr12",118981300,118982005,118981652,705
"13824","chr6",110645808,110646620,110646214,812
"13825","chrX",34943313,34943588,34943450,275
"13826","chr19",3671904,3672123,3672013,219
"13827","chr14",100213932,100214699,100214315,767
"13828","chr2",242045490,242045723,242045606,233
"13829","chr10",69180140,69180548,69180344,408
"13830","chr17",18258302,18259002,18258652,700
"13831","chr1",2546432,2546924,2546678,492
"13832","chr11",65599393,65599783,65599588,390
"13833","chr21",44967136,44967387,44967261,251
"13834","chr9",136245355,136246050,136245702,695
"13835","chr11",8267985,8268775,8268380,790
"13836","chr20",43514570,43514951,43514760,381
"13837","chr11",43522285,43522536,43522410,251
"13838","chr5",76953610,76954703,76954156,1093
"13839","chr2",232418687,232421249,232419968,2562
"13840","chr11",77813596,77813798,77813697,202
"13841","chr1",214870434,214870660,214870547,226
"13842","chr2",241734238,241735691,241734964,1453
"13843","chr7",140640197,140641336,140640766,1139
"13844","chr2",219556007,219556272,219556139,265
"13845","chr2",219243122,219243626,219243374,504
"13846","chr10",44975073,44975285,44975179,212
"13847","chr19",50604168,50604485,50604326,317
"13848","chr20",63941983,63942434,63942208,451
"13849","chr12",67068890,67069944,67069417,1054
"13850","chrY",14829942,14830308,14830125,366
"13851","chr10",124801592,124802365,124801978,773
"13852","chr8",109540089,109540414,109540251,325
"13853","chr1",2184993,2185362,2185177,369
"13854","chr1",40861277,40862613,40861945,1336
"13855","chr1",92960955,92962197,92961576,1242
"13856","chr14",32932888,32935044,32933966,2156
"13857","chr11",712310,712515,712412,205
"13858","chr21",42617166,42617368,42617267,202
"13859","chr7",75156668,75157964,75157316,1296
"13860","chr11",74493090,74493811,74493450,721
"13861","chr5",1851228,1851450,1851339,222
"13862","chr22",20584815,20585066,20584940,251
"13863","chr18",36745661,36745879,36745770,218
"13864","chr2",96527240,96527788,96527514,548
"13865","chr1",1217142,1217754,1217448,612
"13866","chr19",1884769,1885609,1885189,840
"13867","chr14",24188357,24189015,24188686,658
"13868","chr1",2606232,2606447,2606339,215
"13869","chr15",60004355,60006321,60005338,1966
"13870","chr5",1702170,1702463,1702316,293
"13871","chr10",76112325,76112547,76112436,222
"13872","chr6",137044162,137044989,137044575,827
"13873","chr17",16589032,16589523,16589277,491
"13874","chr3",158094264,158094975,158094619,711
"13875","chr8",98045309,98045538,98045423,229
"13876","chr19",7912586,7912832,7912709,246
"13877","chr11",129815842,129816316,129816079,474
"13878","chr19",55216977,55217261,55217119,284
"13879","chr5",126776537,126778537,126777537,2000
"13880","chr5",103119849,103120286,103120067,437
"13881","chr1",225677366,225677626,225677496,260
"13882","chr5",139293473,139294619,139294046,1146
"13883","chr10",133202875,133203972,133203423,1097
"13884","chr11",8031698,8031943,8031820,245
"13885","chr7",55741019,55741308,55741163,289
"13886","chr3",13655127,13655627,13655377,500
"13887","chr13",113129572,113130388,113129980,816
"13888","chr19",18388287,18388887,18388587,600
"13889","chr11",46917807,46918748,46918277,941
"13890","chr2",233868236,233868452,233868344,216
"13891","chr19",46660629,46661526,46661077,897
"13892","chrX",30247055,30247438,30247246,383
"13893","chr19",45439607,45440138,45439872,531
"13894","chrX",102769106,102769327,102769216,221
"13895","chr11",11620574,11622272,11621423,1698
"13896","chrX",150693379,150693998,150693688,619
"13897","chr21",45427590,45427858,45427724,268
"13898","chr7",99558248,99559346,99558797,1098
"13899","chr1",110780601,110780811,110780706,210
"13900","chr2",218962937,218963483,218963210,546
"13901","chr19",2190990,2191263,2191126,273
"13902","chr11",130546905,130547203,130547054,298
"13903","chr19",3201457,3201683,3201570,226
"13904","chr14",70641291,70642615,70641953,1324
"13905","chr9",136407088,136407395,136407241,307
"13906","chr19",44113337,44113741,44113539,404
"13907","chr7",156347905,156348155,156348030,250
"13908","chr19",2739853,2740395,2740124,542
"13909","chr19",35758078,35758406,35758242,328
"13910","chrX",118727251,118728214,118727732,963
"13911","chr19",43535080,43535604,43535342,524
"13912","chr5",88685061,88685455,88685258,394
"13913","chr19",19532315,19532518,19532416,203
"13914","chr11",9090914,9091815,9091364,901
"13915","chr2",112645424,112646502,112645963,1078
"13916","chr15",39976380,39976860,39976620,480
"13917","chr4",8158001,8159154,8158577,1153
"13918","chr11",64448939,64449237,64449088,298
"13919","chr8",144442196,144442397,144442296,201
"13920","chr11",89491248,89491550,89491399,302
"13921","chr20",63190939,63191156,63191047,217
"13922","chr10",100535791,100536153,100535972,362
"13923","chr21",32569337,32569954,32569645,617
"13924","chr11",68840687,68841951,68841319,1264
"13925","chr20",51004361,51004780,51004570,419
"13926","chr13",19862636,19864949,19863792,2313
"13927","chr6",168308912,168309524,168309218,612
"13928","chr1",18376801,18377002,18376901,201
"13929","chr2",200525962,200526494,200526228,532
"13930","chr6",391188,393802,392495,2614
"13931","chr11",66408563,66409258,66408910,695
"13932","chr7",94664297,94664552,94664424,255
"13933","chr10",43667402,43668083,43667742,681
"13934","chr13",112981340,112981585,112981462,245
"13935","chr22",50525179,50526802,50525990,1623
"13936","chr1",20366089,20367041,20366565,952
"13937","chr2",134119836,134121597,134120716,1761
"13938","chr17",79950281,79950624,79950452,343
"13939","chr11",8080811,8081680,8081245,869
"13940","chrX",40205490,40205740,40205615,250
"13941","chr5",179732466,179733533,179732999,1067
"13942","chr7",1934319,1935042,1934680,723
"13943","chr20",35741568,35742641,35742104,1073
"13944","chr14",20454581,20455864,20455222,1283
"13945","chr11",117097822,117098796,117098309,974
"13946","chr1",110034781,110035320,110035050,539
"13947","chr9",137145639,137146116,137145877,477
"13948","chr5",123088642,123088844,123088743,202
"13949","chr16",48244421,48244744,48244582,323
"13950","chr16",4371641,4372239,4371940,598
"13951","chr22",17108550,17109397,17108973,847
"13952","chr19",31357040,31357303,31357171,263
"13953","chr4",168631565,168631796,168631680,231
"13954","chr16",29141920,29142157,29142038,237
"13955","chr3",47824855,47825392,47825123,537
"13956","chr19",51598548,51598771,51598659,223
"13957","chr20",43666759,43667680,43667219,921
"13958","chr19",50381921,50382233,50382077,312
"13959","chr3",150603215,150604004,150603609,789
"13960","chrY",7560138,7560383,7560260,245
"13961","chrX",67543963,67544235,67544099,272
"13962","chr11",6655265,6656121,6655693,856
"13963","chr8",67342894,67343815,67343354,921
"13964","chr13",27270521,27271388,27270954,867
"13965","chr20",61919710,61920391,61920050,681
"13966","chrX",135004051,135004288,135004169,237
"13967","chr15",89912330,89913031,89912680,701
"13968","chr20",3777559,3778537,3778048,978
"13969","chr16",67109379,67110432,67109905,1053
"13970","chr11",68271832,68272412,68272122,580
"13971","chr3",52524549,52524753,52524651,204
"13972","chr15",75450740,75456108,75453424,5368
"13973","chr11",78574360,78574950,78574655,590
"13974","chr12",47819326,47820405,47819865,1079
"13975","chr5",171308165,171312859,171310512,4694
"13976","chr7",73308330,73308955,73308642,625
"13977","chr6",142301446,142302316,142301881,870
"13978","chr8",143553138,143553856,143553497,718
"13979","chr10",27319745,27319963,27319854,218
"13980","chr14",47674230,47676386,47675308,2156
"13981","chr10",95290428,95291367,95290897,939
"13982","chr2",170820042,170820470,170820256,428
"13983","chr1",246619895,246620615,246620255,720
"13984","chr6",138773312,138773802,138773557,490
"13985","chr5",10649255,10650240,10649747,985
"13986","chr15",57376139,57376830,57376484,691
"13987","chr9",69515971,69516184,69516077,213
"13988","chr7",156122816,156123019,156122917,203
"13989","chr13",113107252,113111220,113109236,3968
"13990","chr19",17847693,17847999,17847846,306
"13991","chr22",38927198,38927523,38927360,325
"13992","chr19",3761495,3761828,3761661,333
"13993","chr5",140801259,140801497,140801378,238
"13994","chr6",39724967,39725284,39725125,317
"13995","chr7",6530822,6531464,6531143,642
"13996","chr11",47408182,47408827,47408504,645
"13997","chr5",140042491,140043565,140043028,1074
"13998","chr18",31684709,31685687,31685198,978
"13999","chr4",82373692,82374633,82374162,941
"14000","chr14",74712926,74713172,74713049,246
"14001","chr11",94088935,94089171,94089053,236
"14002","chr5",34007691,34008228,34007959,537
"14003","chr4",183722761,183723261,183723011,500
"14004","chr22",42692912,42693662,42693287,750
"14005","chr5",42991931,42992853,42992392,922
"14006","chr5",33440529,33441259,33440894,730
"14007","chr7",149070868,149072098,149071483,1230
"14008","chr6",42178109,42178315,42178212,206
"14009","chr3",15331807,15332702,15332254,895
"14010","chr14",105148038,105148580,105148309,542
"14011","chr16",30634371,30634804,30634587,433
"14012","chr2",32356678,32358197,32357437,1519
"14013","chr6",83859624,83859900,83859762,276
"14014","chr12",121811937,121812258,121812097,321
"14015","chr20",35664634,35665005,35664819,371
"14016","chr11",124868816,124869115,124868965,299
"14017","chr8",38786955,38788242,38787598,1287
"14018","chr19",30450946,30451274,30451110,328
"14019","chr16",88387141,88387561,88387351,420
"14020","chr2",171160028,171161350,171160689,1322
"14021","chr11",69674986,69675561,69675273,575
"14022","chr11",75814666,75814871,75814768,205
"14023","chr3",101512766,101513329,101513047,563
"14024","chr13",20902620,20903245,20902932,625
"14025","chr14",67572081,67572296,67572188,215
"14026","chr16",2223218,2224080,2223649,862
"14027","chr1",23436661,23437478,23437069,817
"14028","chr5",138178971,138179252,138179111,281
"14029","chr5",55821745,55822138,55821941,393
"14030","chr19",48965115,48966119,48965617,1004
"14031","chr20",48372965,48373228,48373096,263
"14032","chr18",79882744,79883330,79883037,586
"14033","chr16",3175353,3175593,3175473,240
"14034","chr11",71577090,71577317,71577203,227
"14035","chr10",26860237,26861300,26860768,1063
"14036","chr11",1336485,1337851,1337168,1366
"14037","chr1",227887676,227888049,227887862,373
"14038","chr14",41606655,41607126,41606890,471
"14039","chr5",373727,374311,374019,584
"14040","chr11",65786278,65788102,65787190,1824
"14041","chr12",62631808,62632433,62632120,625
"14042","chr12",6873155,6873772,6873463,617
"14043","chr1",908919,910503,909711,1584
"14044","chr19",57746720,57747251,57746985,531
"14045","chr11",3413803,3414009,3413906,206
"14046","chr11",65833293,65834080,65833686,787
"14047","chr8",11700343,11700743,11700543,400
"14048","chr7",57424427,57425366,57424896,939
"14049","chr18",79678980,79680398,79679689,1418
"14050","chr19",4968546,4969616,4969081,1070
"14051","chr12",68807842,68808883,68808362,1041
"14052","chr14",77124816,77125504,77125160,688
"14053","chrX",49100826,49101657,49101241,831
"14054","chr7",2702639,2702912,2702775,273
"14055","chr14",105855645,105855897,105855771,252
"14056","chr19",45777296,45777784,45777540,488
"14057","chr14",69879391,69879810,69879600,419
"14058","chr8",144522125,144523298,144522711,1173
"14059","chr10",8034039,8035298,8034668,1259
"14060","chr5",138345372,138345585,138345478,213
"14061","chr14",73644857,73645063,73644960,206
"14062","chr10",100009556,100010241,100009898,685
"14063","chr9",133478858,133479642,133479250,784
"14064","chr6",26124265,26124554,26124409,289
"14065","chrX",135032037,135032955,135032496,918
"14066","chr10",87504613,87505614,87505113,1001
"14067","chr5",176869540,176869932,176869736,392
"14068","chr9",137272747,137273000,137272873,253
"14069","chr12",63843623,63844621,63844122,998
"14070","chr20",23047766,23051581,23049673,3815
"14071","chr2",237859430,237860188,237859809,758
"14072","chr14",102964197,102964450,102964323,253
"14073","chr22",39242197,39244894,39243545,2697
"14074","chr19",15021330,15021914,15021622,584
"14075","chr7",44044507,44044846,44044676,339
"14076","chr16",3124117,3124886,3124501,769
"14077","chr5",169300425,169301271,169300848,846
"14078","chr17",83025162,83025687,83025424,525
"14079","chr20",48827197,48828644,48827920,1447
"14080","chr14",34539320,34539774,34539547,454
"14081","chr2",202171328,202171573,202171450,245
"14082","chr5",1037849,1038311,1038080,462
"14083","chr4",65669475,65669902,65669688,427
"14084","chr2",44087149,44087425,44087287,276
"14085","chr14",62116961,62117561,62117261,600
"14086","chr20",62163256,62163672,62163464,416
"14087","chr19",1407110,1408844,1407977,1734
"14088","chr17",19868296,19868501,19868398,205
"14089","chr9",132877960,132878997,132878478,1037
"14090","chr12",130715964,130716181,130716072,217
"14091","chr1",9292330,9293834,9293082,1504
"14092","chr19",36151425,36152683,36152054,1258
"14093","chr11",78416919,78418354,78417636,1435
"14094","chr6",27630908,27631367,27631137,459
"14095","chr4",176065770,176066209,176065989,439
"14096","chr11",63838642,63840002,63839322,1360
"14097","chr11",74731215,74731829,74731522,614
"14098","chr5",481524,482110,481817,586
"14099","chr21",39182838,39184191,39183514,1353
"14100","chr2",28810722,28811145,28810933,423
"14101","chr5",111223871,111224748,111224309,877
"14102","chr5",137498327,137499457,137498892,1130
"14103","chr11",108664857,108665469,108665163,612
"14104","chr2",130428572,130428923,130428747,351
"14105","chr12",453055,454068,453561,1013
"14106","chr14",103102028,103105162,103103595,3134
"14107","chr11",4094459,4095259,4094859,800
"14108","chr1",3155335,3155675,3155505,340
"14109","chr9",98796047,98796932,98796489,885
"14110","chr11",3056912,3057754,3057333,842
"14111","chr3",53493900,53496079,53494989,2179
"14112","chr13",101415765,101416907,101416336,1142
"14113","chr7",1825907,1826132,1826019,225
"14114","chr1",143642888,143643745,143643316,857
"14115","chr7",117322787,117324635,117323711,1848
"14116","chr13",20177117,20177807,20177462,690
"14117","chr1",244050095,244050317,244050206,222
"14118","chr1",15603328,15603794,15603561,466
"14119","chr17",5122503,5123769,5123136,1266
"14120","chr5",159209144,159209941,159209542,797
"14121","chr13",32031183,32031766,32031474,583
"14122","chr14",103123016,103123909,103123462,893
"14123","chr4",24583812,24584552,24584182,740
"14124","chr18",47263371,47264307,47263839,936
"14125","chr2",126777156,126777610,126777383,454
"14126","chr7",77696093,77697184,77696638,1091
"14127","chr18",45967227,45967736,45967481,509
"14128","chr2",219358180,219359132,219358656,952
"14129","chr11",1753358,1753810,1753584,452
"14130","chr15",65376972,65378279,65377625,1307
"14131","chr17",34637356,34638414,34637885,1058
"14132","chr17",79009522,79010024,79009773,502
"14133","chr17",7035818,7036771,7036294,953
"14134","chr17",75764613,75765221,75764917,608
"14135","chr3",140941492,140942760,140942126,1268
"14136","chr17",13017639,13018249,13017944,610
"14137","chr20",59024147,59024353,59024250,206
"14138","chr11",32583637,32584183,32583910,546
"14139","chr7",151631776,151633102,151632439,1326
"14140","chr16",77190271,77191246,77190758,975
"14141","chr14",68816329,68816888,68816608,559
"14142","chr20",45911806,45912318,45912062,512
"14143","chr4",140568808,140569224,140569016,416
"14144","chr2",120222756,120223875,120223315,1119
"14145","chr3",55474308,55474680,55474494,372
"14146","chr2",70907455,70907662,70907558,207
"14147","chr17",29929808,29930390,29930099,582
"14148","chr10",63521110,63522270,63521690,1160
"14149","chr17",58661486,58661736,58661611,250
"14150","chr15",59997126,59997334,59997230,208
"14151","chr10",133372838,133373677,133373257,839
"14152","chr4",3374104,3374418,3374261,314
"14153","chr11",70411173,70411450,70411311,277
"14154","chr14",58244633,58245179,58244906,546
"14155","chr14",38207949,38208582,38208265,633
"14156","chr6",27388713,27389241,27388977,528
"14157","chr10",101817637,101818499,101818068,862
"14158","chr11",31987256,31987642,31987449,386
"14159","chr12",113135172,113135953,113135562,781
"14160","chr16",29925717,29926440,29926078,723
"14161","chr16",1656694,1656940,1656817,246
"14162","chr16",75529215,75530214,75529714,999
"14163","chr5",36240901,36242562,36241731,1661
"14164","chr2",172100034,172103129,172101581,3095
"14165","chr20",33443334,33444158,33443746,824
"14166","chr7",1421036,1421353,1421194,317
"14167","chr9",137551175,137552439,137551807,1264
"14168","chr2",104659130,104659482,104659306,352
"14169","chr4",119627048,119629095,119628071,2047
"14170","chr10",28302474,28303188,28302831,714
"14171","chrX",154762565,154763556,154763060,991
"14172","chr21",29073254,29073934,29073594,680
"14173","chr13",38687099,38688162,38687630,1063
"14174","chr2",71130057,71130822,71130439,765
"14175","chr7",158856293,158857068,158856680,775
"14176","chr7",1620844,1621145,1620994,301
"14177","chr3",52444508,52444768,52444638,260
"14178","chr18",14178944,14179711,14179327,767
"14179","chr6",159692525,159693831,159693178,1306
"14180","chr10",44959347,44960026,44959686,679
"14181","chr9",114153995,114156250,114155122,2255
"14182","chr4",127622876,127623748,127623312,872
"14183","chr2",202237892,202238605,202238248,713
"14184","chr11",69967143,69967346,69967244,203
"14185","chr2",239231780,239232096,239231938,316
"14186","chr6",84762984,84764414,84763699,1430
"14187","chr16",67718946,67719543,67719244,597
"14188","chr6",1555027,1555346,1555186,319
"14189","chrX",76428315,76429140,76428727,825
"14190","chr7",99408161,99409236,99408698,1075
"14191","chr16",955902,956281,956091,379
"14192","chr14",73237346,73238398,73237872,1052
"14193","chr1",2529321,2530571,2529946,1250
"14194","chr2",106885897,106887760,106886828,1863
"14195","chr11",10450453,10451187,10450820,734
"14196","chr22",24494444,24495485,24494964,1041
"14197","chr16",2135138,2136405,2135771,1267
"14198","chr5",134113629,134115569,134114599,1940
"14199","chr8",15236728,15237659,15237193,931
"14200","chr11",73982657,73983757,73983207,1100
"14201","chr10",133318502,133318954,133318728,452
"14202","chr14",71931947,71932837,71932392,890
"14203","chr5",138331813,138332348,138332080,535
"14204","chr4",148442060,148445904,148443982,3844
"14205","chr14",99683390,99684736,99684063,1346
"14206","chr12",49335945,49337379,49336662,1434
"14207","chr17",1724451,1726603,1725527,2152
"14208","chr21",41304186,41304486,41304336,300
"14209","chr14",104800107,104801501,104800804,1394
"14210","chr16",88831177,88831813,88831495,636
"14211","chr2",9555393,9556477,9555935,1084
"14212","chr14",103529203,103529435,103529319,232
"14213","chr16",88076317,88076929,88076623,612
"14214","chr1",86552985,86553493,86553239,508
"14215","chr7",70693774,70695701,70694737,1927
"14216","chr20",63829913,63832738,63831325,2825
"14217","chrX",101418203,101418685,101418444,482
"14218","chr13",27980290,27980928,27980609,638
"14219","chr20",727957,728646,728301,689
"14220","chr9",41189249,41189538,41189393,289
"14221","chr1",24321712,24322684,24322198,972
"14222","chrX",70454949,70455455,70455202,506
"14223","chr2",10432265,10432626,10432445,361
"14224","chr10",132752937,132753412,132753174,475
"14225","chr10",11894252,11895061,11894656,809
"14226","chr5",160311774,160312906,160312340,1132
"14227","chr2",118186247,118186623,118186435,376
"14228","chr17",5115755,5116584,5116169,829
"14229","chr9",89381036,89381315,89381175,279
"14230","chr10",133124462,133124977,133124719,515
"14231","chr22",24592626,24593312,24592969,686
"14232","chr14",104843353,104844030,104843691,677
"14233","chr9",130938244,130940394,130939319,2150
"14234","chrX",130170972,130172453,130171712,1481
"14235","chr3",190513541,190514237,190513889,696
"14236","chr16",68529856,68530378,68530117,522
"14237","chr6",83430693,83431279,83430986,586
"14238","chr19",23070994,23071580,23071287,586
"14239","chr2",241065407,241065686,241065546,279
"14240","chr16",67393381,67395047,67394214,1666
"14241","chr7",5302668,5302968,5302818,300
"14242","chr4",41880433,41880947,41880690,514
"14243","chr10",14953681,14954432,14954056,751
"14244","chr4",2843304,2844531,2843917,1227
"14245","chr9",104763891,104764498,104764194,607
"14246","chr11",1450109,1450365,1450237,256
"14247","chr17",82601149,82601574,82601361,425
"14248","chr21",46661329,46662292,46661810,963
"14249","chr2",156332545,156334925,156333735,2380
"14250","chr14",99675050,99675714,99675382,664
"14251","chr17",42016981,42017676,42017328,695
"14252","chr16",89093610,89094298,89093954,688
"14253","chrX",40005272,40009853,40007562,4581
"14254","chr4",4541710,4542377,4542043,667
"14255","chr22",32175871,32176538,32176204,667
"14256","chr5",14871282,14871502,14871392,220
"14257","chr4",26583942,26584177,26584059,235
"14258","chr16",87708950,87709503,87709226,553
"14259","chr1",204377604,204378302,204377953,698
"14260","chr9",129549877,129550613,129550245,736
"14261","chr10",69123907,69124597,69124252,690
"14262","chr6",109454991,109456442,109455716,1451
"14263","chr20",63494577,63495108,63494842,531
"14264","chr5",645940,646176,646058,236
"14265","chr16",844644,845057,844850,413
"14266","chr5",154189985,154190978,154190481,993
"14267","chr10",5684492,5685734,5685113,1242
"14268","chr14",89026791,89028038,89027414,1247
"14269","chr9",136991860,136992728,136992294,868
"14270","chr10",119178516,119178906,119178711,390
"14271","chr4",182806396,182807200,182806798,804
"14272","chr16",2963650,2970325,2966987,6675
"14273","chr10",97578232,97578484,97578358,252
"14274","chr22",38214328,38214821,38214574,493
"14275","chr3",126416207,126416588,126416397,381
"14276","chr19",42306861,42307067,42306964,206
"14277","chr16",274797,276177,275487,1380
"14278","chr3",127337993,127338453,127338223,460
"14279","chr10",113679248,113680437,113679842,1189
"14280","chr16",31458661,31459981,31459321,1320
"14281","chr2",241844981,241845262,241845121,281
"14282","chr11",126303644,126304147,126303895,503
"14283","chr8",1823195,1824594,1823894,1399
"14284","chr5",293510,294015,293762,505
"14285","chr7",2020272,2020496,2020384,224
"14286","chr2",19356028,19358642,19357335,2614
"14287","chr21",36966084,36966998,36966541,914
"14288","chr11",118530520,118531354,118530937,834
"14289","chr8",140047187,140047424,140047305,237
"14290","chr16",34014586,34015526,34015056,940
"14291","chr4",42656261,42657533,42656897,1272
"14292","chr8",67064205,67065213,67064709,1008
"14293","chr11",116821233,116821644,116821438,411
"14294","chr2",240623052,240623493,240623272,441
"14295","chr2",42568749,42569090,42568919,341
"14296","chr20",32482386,32484873,32483629,2487
"14297","chr8",19602394,19602626,19602510,232
"14298","chr11",22829219,22829838,22829528,619
"14299","chr16",67278993,67279828,67279410,835
"14300","chr19",50724404,50725626,50725015,1222
"14301","chr9",32384422,32384913,32384667,491
"14302","chr22",20425096,20426273,20425684,1177
"14303","chr10",101216212,101218339,101217275,2127
"14304","chr4",112705583,112706351,112705967,768
"14305","chr3",46845958,46846429,46846193,471
"14306","chr22",21360344,21361522,21360933,1178
"14307","chr5",159987039,159987573,159987306,534
"14308","chr22",50673507,50675314,50674410,1807
"14309","chr7",510813,511044,510928,231
"14310","chr8",10729794,10733599,10731696,3805
"14311","chr22",25359974,25360197,25360085,223
"14312","chr9",131125397,131125919,131125658,522
"14313","chr17",41811155,41812352,41811753,1197
"14314","chr5",62305790,62307103,62306446,1313
"14315","chr5",179907344,179908115,179907729,771
"14316","chr9",113687865,113688174,113688019,309
"14317","chr16",29961702,29962249,29961975,547
"14318","chr17",48633593,48634057,48633825,464
"14319","chr3",98593065,98593852,98593458,787
"14320","chr17",2029844,2030558,2030201,714
"14321","chr6",45421683,45423909,45422796,2226
"14322","chr3",111859390,111859892,111859641,502
"14323","chr5",100535221,100536016,100535618,795
"14324","chr6",168035155,168035517,168035336,362
"14325","chr11",449961,451178,450569,1217
"14326","chr1",155269487,155269703,155269595,216
"14327","chr16",89948630,89949712,89949171,1082
"14328","chr6",10425967,10426405,10426186,438
"14329","chr17",83051075,83052123,83051599,1048
"14330","chr1",11805405,11806509,11805957,1104
"14331","chrX",27863837,27864055,27863946,218
"14332","chr17",57885212,57885868,57885540,656
"14333","chr10",5412468,5413056,5412762,588
"14334","chr4",77818553,77820401,77819477,1848
"14335","chr17",45601488,45601841,45601664,353
"14336","chrX",73447321,73447754,73447537,433
"14337","chr4",41981905,41982166,41982035,261
"14338","chr5",177971161,177971433,177971297,272
"14339","chr7",65572711,65572951,65572831,240
"14340","chr5",69332595,69332912,69332753,317
"14341","chr3",51499326,51500244,51499785,918
"14342","chr9",121299527,121300035,121299781,508
"14343","chr17",82519222,82520677,82519949,1455
"14344","chr11",64035470,64036893,64036181,1423
"14345","chr7",56812798,56813020,56812909,222
"14346","chr17",82647425,82648448,82647936,1023
"14347","chr7",1159329,1160583,1159956,1254
"14348","chr3",141095071,141095292,141095181,221
"14349","chr2",130963246,130964294,130963770,1048
"14350","chr5",14142908,14145241,14144074,2333
"14351","chr7",98106723,98107409,98107066,686
"14352","chrX",138710933,138711848,138711390,915
"14353","chr3",141065967,141066639,141066303,672
"14354","chr17",82941109,82941437,82941273,328
"14355","chr2",17538888,17539150,17539019,262
"14356","chr19",49812954,49813212,49813083,258
"14357","chr3",44584833,44585302,44585067,469
"14358","chr3",193869563,193870100,193869831,537
"14359","chr1",93878951,93879266,93879108,315
"14360","chr16",1493097,1494425,1493761,1328
"14361","chr3",10248213,10248712,10248462,499
"14362","chr5",177337114,177337541,177337327,427
"14363","chr20",37179006,37179640,37179323,634
"14364","chr2",73268792,73269782,73269287,990
"14365","chr11",133360989,133361750,133361369,761
"14366","chr10",84540643,84541197,84540920,554
"14367","chr10",101775638,101776748,101776193,1110
"14368","chrY",11321576,11322772,11322174,1196
"14369","chr5",73233272,73234149,73233710,877
"14370","chr4",1763282,1763781,1763531,499
"14371","chr4",145761358,145761665,145761511,307
"14372","chr20",37384192,37385036,37384614,844
"14373","chr6",122996019,122996608,122996313,589
"14374","chr11",62705981,62706684,62706332,703
"14375","chr14",59630490,59630835,59630662,345
"14376","chr16",30075915,30076521,30076218,606
"14377","chr3",9946211,9947935,9947073,1724
"14378","chr17",18382915,18383483,18383199,568
"14379","chr5",179060145,179060920,179060532,775
"14380","chr18",72866730,72869636,72868183,2906
"14381","chr16",68644783,68646246,68645514,1463
"14382","chr4",6221839,6222497,6222168,658
"14383","chr16",2036419,2036891,2036655,472
"14384","chr8",143614158,143614638,143614398,480
"14385","chr5",146334078,146334350,146334214,272
"14386","chr8",102862994,102864856,102863925,1862
"14387","chr2",227717769,227718105,227717937,336
"14388","chr17",81636601,81637202,81636901,601
"14389","chr15",40873649,40874373,40874011,724
"14390","chr15",42581365,42581658,42581511,293
"14391","chr1",43348634,43349606,43349120,972
"14392","chr3",149752122,149752601,149752361,479
"14393","chr1",39575645,39576995,39576320,1350
"14394","chrX",114581622,114581942,114581782,320
"14395","chr4",40749825,40750476,40750150,651
"14396","chr22",48209345,48209695,48209520,350
"14397","chr13",114103419,114104361,114103890,942
"14398","chr19",51016897,51017651,51017274,754
"14399","chr20",9514606,9514950,9514778,344
"14400","chr11",17719242,17722232,17720737,2990
"14401","chr10",119872142,119873592,119872867,1450
"14402","chr16",2513429,2514902,2514165,1473
"14403","chr21",45641859,45644394,45643126,2535
"14404","chr2",61176913,61178226,61177569,1313
"14405","chr10",133261497,133262275,133261886,778
"14406","chr17",39200233,39200692,39200462,459
"14407","chr11",6683065,6683712,6683388,647
"14408","chr14",102139260,102140640,102139950,1380
"14409","chr6",159788909,159790983,159789946,2074
"14410","chr6",53547930,53548279,53548104,349
"14411","chr3",126083604,126084415,126084009,811
"14412","chr7",10940364,10940652,10940508,288
"14413","chr16",87891753,87891979,87891866,226
"14414","chr15",52528136,52529442,52528789,1306
"14415","chrX",10126010,10126366,10126188,356
"14416","chr21",14063798,14064641,14064219,843
"14417","chr2",80322453,80322673,80322563,220
"14418","chr17",44353646,44355187,44354416,1541
"14419","chr6",158818246,158819743,158818994,1497
"14420","chr3",171028283,171028503,171028393,220
"14421","chr22",46061215,46062148,46061681,933
"14422","chr13",50843235,50844013,50843624,778
"14423","chr14",44897184,44897905,44897544,721
"14424","chr14",104893498,104893816,104893657,318
"14425","chr20",41136589,41138192,41137390,1603
"14426","chr21",13937312,13937526,13937419,214
"14427","chr2",6917253,6918302,6917777,1049
"14428","chr6",40586856,40588189,40587522,1333
"14429","chr6",27687564,27687928,27687746,364
"14430","chr17",1575290,1575920,1575605,630
"14431","chr15",68277636,68278720,68278178,1084
"14432","chr11",117327707,117328234,117327970,527
"14433","chr5",174731677,174732726,174732201,1049
"14434","chr3",97821820,97822789,97822304,969
"14435","chr2",120012821,120013575,120013198,754
"14436","chr20",46118183,46118421,46118302,238
"14437","chr4",3740365,3740631,3740498,266
"14438","chr2",136119141,136119481,136119311,340
"14439","chr10",109456846,109457325,109457085,479
"14440","chr2",129587470,129587783,129587626,313
"14441","chr4",108762573,108763206,108762889,633
"14442","chr19",33819839,33820612,33820225,773
"14443","chrX",41473622,41474873,41474247,1251
"14444","chr15",30883092,30883320,30883206,228
"14445","chr11",17388889,17389740,17389314,851
"14446","chr11",64853735,64854774,64854254,1039
"14447","chr22",36703426,36703666,36703546,240
"14448","chr16",2079158,2079668,2079413,510
"14449","chr11",133955442,133957562,133956502,2120
"14450","chr9",15306724,15307388,15307056,664
"14451","chr15",83653570,83655019,83654294,1449
"14452","chr12",88141958,88142371,88142164,413
"14453","chr3",28241335,28241966,28241650,631
"14454","chr21",44324758,44324964,44324861,206
"14455","chr12",29783062,29784500,29783781,1438
"14456","chr7",103445263,103445685,103445474,422
"14457","chr6",73363571,73363838,73363704,267
"14458","chr14",34462413,34462623,34462518,210
"14459","chr14",73786684,73787485,73787084,801
"14460","chr16",767352,768051,767701,699
"14461","chr12",20551591,20553070,20552330,1479
"14462","chr14",105248154,105249988,105249071,1834
"14463","chr17",63827366,63827933,63827649,567
"14464","chr19",1826830,1828547,1827688,1717
"14465","chr11",17387905,17388145,17388025,240
"14466","chr6",78867441,78868039,78867740,598
"14467","chr14",74881782,74882358,74882070,576
"14468","chr8",1669439,1669686,1669562,247
"14469","chr13",44373235,44374307,44373771,1072
"14470","chr12",47773214,47773795,47773504,581
"14471","chr2",112181710,112181986,112181848,276
"14472","chr3",19146995,19147280,19147137,285
"14473","chr6",151341470,151341921,151341695,451
"14474","chr2",113583724,113584721,113584222,997
"14475","chr12",121444388,121444613,121444500,225
"14476","chr17",80101103,80101962,80101532,859
"14477","chr20",35092252,35093226,35092739,974
"14478","chr14",102922679,102923911,102923295,1232
"14479","chr16",29986315,29986528,29986421,213
"14480","chr2",176188229,176189622,176188925,1393
"14481","chr15",42490761,42491086,42490923,325
"14482","chr5",140822988,140824025,140823506,1037
"14483","chr18",78972970,78974765,78973867,1795
"14484","chr17",3386068,3386778,3386423,710
"14485","chr17",50055630,50056720,50056175,1090
"14486","chr15",88881398,88881639,88881518,241
"14487","chr6",4134941,4135570,4135255,629
"14488","chr2",39436756,39437526,39437141,770
"14489","chr8",30657653,30658507,30658080,854
"14490","chr4",131977594,131978035,131977814,441
"14491","chr17",38605690,38606865,38606277,1175
"14492","chr11",3797217,3798077,3797647,860
"14493","chr14",36503964,36504535,36504249,571
"14494","chr17",45584665,45586441,45585553,1776
"14495","chr2",222655797,222656174,222655985,377
"14496","chr17",81112521,81112723,81112622,202
"14497","chr6",26216983,26217293,26217138,310
"14498","chr2",135741575,135742574,135742074,999
"14499","chr17",43938053,43938339,43938196,286
"14500","chr2",241823867,241824403,241824135,536
"14501","chr2",189580733,189581257,189580995,524
"14502","chr11",134961435,134962269,134961852,834
"14503","chr2",11669523,11670307,11669915,784
"14504","chr6",10414785,10415085,10414935,300
"14505","chr10",99430532,99431168,99430850,636
"14506","chr5",73565134,73565785,73565459,651
"14507","chr11",10807814,10809574,10808694,1760
"14508","chr16",986820,987448,987134,628
"14509","chr5",144205180,144205501,144205340,321
"14510","chr3",49165852,49166387,49166119,535
"14511","chr9",126623833,126626952,126625392,3119
"14512","chr10",103555250,103555487,103555368,237
"14513","chr12",123712099,123712960,123712529,861
"14514","chr10",117216538,117217195,117216866,657
"14515","chr20",46022427,46022730,46022578,303
"14516","chr7",822878,823163,823020,285
"14517","chr17",74203793,74204289,74204041,496
"14518","chr10",52314229,52315067,52314648,838
"14519","chr4",2304547,2305177,2304862,630
"14520","chr12",32399091,32400104,32399597,1013
"14521","chr16",89873024,89874404,89873714,1380
"14522","chr16",28259131,28259353,28259242,222
"14523","chr18",35343951,35344621,35344286,670
"14524","chr5",159263005,159263533,159263269,528
"14525","chr6",27177587,27177966,27177776,379
"14526","chr2",98730419,98731714,98731066,1295
"14527","chr11",57458339,57458621,57458480,282
"14528","chr4",151760889,151761139,151761014,250
"14529","chr10",639093,639467,639280,374
"14530","chr4",188159694,188160093,188159893,399
"14531","chr6",133240948,133242448,133241698,1500
"14532","chrX",19886909,19888439,19887674,1530
"14533","chr16",1169429,1169641,1169535,212
"14534","chr17",46769773,46770097,46769935,324
"14535","chr12",48999356,48999578,48999467,222
"14536","chr12",130451167,130451418,130451292,251
"14537","chr3",128650086,128650962,128650524,876
"14538","chr12",129303190,129303615,129303402,425
"14539","chr12",103840495,103841549,103841022,1054
"14540","chr22",37024184,37024859,37024521,675
"14541","chr5",56814478,56814708,56814593,230
"14542","chr22",29049215,29049494,29049354,279
"14543","chr16",66426600,66427002,66426801,402
"14544","chr21",20997105,20998245,20997675,1140
"14545","chr2",129934129,129934529,129934329,400
"14546","chr2",64767854,64768427,64768140,573
"14547","chr11",69005328,69006244,69005786,916
"14548","chr16",424922,426815,425868,1893
"14549","chr11",49891767,49892783,49892275,1016
"14550","chr3",49120335,49121030,49120682,695
"14551","chr17",43483672,43484002,43483837,330
"14552","chr4",54226794,54227075,54226934,281
"14553","chr14",105419676,105420248,105419962,572
"14554","chr14",63727523,63728331,63727927,808
"14555","chr2",26764162,26764632,26764397,470
"14556","chr17",81280607,81280808,81280707,201
"14557","chr17",22435374,22435685,22435529,311
"14558","chr5",154690700,154690910,154690805,210
"14559","chr21",44903745,44904037,44903891,292
"14560","chr1",89820630,89821928,89821279,1298
"14561","chr2",47369490,47370117,47369803,627
"14562","chr9",71910595,71910972,71910783,377
"14563","chr16",21663955,21664305,21664130,350
"14564","chr10",45373270,45374708,45373989,1438
"14565","chr11",32426715,32427501,32427108,786
"14566","chr14",102516613,102517609,102517111,996
"14567","chr7",100693560,100694643,100694101,1083
"14568","chr18",2905952,2907350,2906651,1398
"14569","chr6",26225158,26225562,26225360,404
"14570","chr1",211830089,211830938,211830513,849
"14571","chr19",3676301,3676585,3676443,284
"14572","chr21",17611687,17611980,17611833,293
"14573","chr12",132591213,132591539,132591376,326
"14574","chr5",141414791,141415478,141415134,687
"14575","chr14",19267047,19267318,19267182,271
"14576","chr2",98444711,98445385,98445048,674
"14577","chr21",42973974,42975740,42974857,1766
"14578","chr5",41903930,41904377,41904153,447
"14579","chr9",133163029,133164190,133163609,1161
"14580","chr15",85233893,85234907,85234400,1014
"14581","chr5",32585497,32586259,32585878,762
"14582","chr12",108562412,108562983,108562697,571
"14583","chr2",109760494,109761336,109760915,842
"14584","chr9",36190873,36191539,36191206,666
"14585","chr11",64844255,64845162,64844708,907
"14586","chr4",87006776,87007515,87007145,739
"14587","chr22",31399264,31399972,31399618,708
"14588","chr5",73119784,73120939,73120361,1155
"14589","chr20",61969774,61969989,61969881,215
"14590","chr5",1086947,1087247,1087097,300
"14591","chr15",62163816,62165449,62164632,1633
"14592","chr4",143184531,143185679,143185105,1148
"14593","chr4",82797856,82799088,82798472,1232
"14594","chr12",22625054,22625279,22625166,225
"14595","chr14",104135622,104139335,104137478,3713
"14596","chr11",76444363,76445783,76445073,1420
"14597","chr12",131801427,131801982,131801704,555
"14598","chr14",104179216,104179425,104179320,209
"14599","chr16",30805473,30805922,30805697,449
"14600","chr7",157612317,157613916,157613116,1599
"14601","chr3",14573859,14574450,14574154,591
"14602","chrX",2907397,2907605,2907501,208
"14603","chr11",45285890,45286424,45286157,534
"14604","chr10",63133337,63133576,63133456,239
"14605","chr16",50065809,50066623,50066216,814
"14606","chr15",84600847,84601367,84601107,520
"14607","chr5",1667072,1667966,1667519,894
"14608","chr11",59668728,59669759,59669243,1031
"14609","chr12",1661535,1663347,1662441,1812
"14610","chr7",144403705,144404047,144403876,342
"14611","chr14",67514797,67515663,67515230,866
"14612","chr16",75478647,75479818,75479232,1171
"14613","chr14",24315941,24316663,24316302,722
"14614","chr4",80072221,80073256,80072738,1035
"14615","chr3",195657650,195658709,195658179,1059
"14616","chr10",13471907,13472169,13472038,262
"14617","chr18",54828373,54828776,54828574,403
"14618","chr16",526725,528511,527618,1786
"14619","chr16",30532546,30533011,30532778,465
"14620","chr14",32201211,32201886,32201548,675
"14621","chr16",3977421,3977708,3977564,287
"14622","chr5",59893219,59893681,59893450,462
"14623","chr7",128739060,128739643,128739351,583
"14624","chr10",101136585,101136908,101136746,323
"14625","chr5",131164533,131165402,131164967,869
"14626","chr20",32030990,32031335,32031162,345
"14627","chr2",130139546,130139817,130139681,271
"14628","chr7",27107970,27108764,27108367,794
"14629","chr20",63272142,63273349,63272745,1207
"14630","chr3",125915455,125917106,125916280,1651
"14631","chr12",4809107,4810491,4809799,1384
"14632","chr11",355947,356447,356197,500
"14633","chr4",1735214,1735419,1735316,205
"14634","chr12",108768632,108768946,108768789,314
"14635","chr11",70176951,70177198,70177074,247
"14636","chr16",31508060,31508619,31508339,559
"14637","chr15",64095786,64096429,64096107,643
"14638","chr3",27720862,27722504,27721683,1642
"14639","chr7",64045599,64045920,64045759,321
"14640","chr16",14285467,14285890,14285678,423
"14641","chr2",210170754,210171913,210171333,1159
"14642","chr6",27893539,27893817,27893678,278
"14643","chr2",55223383,55223795,55223589,412
"14644","chr15",85840646,85840884,85840765,238
"14645","chr14",59463916,59465533,59464724,1617
"14646","chr16",3134275,3135311,3134793,1036
"14647","chr1",244730139,244731064,244730601,925
"14648","chr7",151059304,151060210,151059757,906
"14649","chrX",70062534,70063435,70062984,901
"14650","chr10",19817714,19818017,19817865,303
"14651","chr5",69369260,69370039,69369649,779
"14652","chr15",92655144,92655951,92655547,807
"14653","chr3",46892256,46892803,46892529,547
"14654","chr7",1937650,1938276,1937963,626
"14655","chr11",65591821,65592857,65592339,1036
"14656","chr15",74132750,74136480,74134615,3730
"14657","chr1",12019194,12019846,12019520,652
"14658","chr10",98446549,98447021,98446785,472
"14659","chr3",45995521,45995981,45995751,460
"14660","chr15",31215603,31216149,31215876,546
"14661","chr12",109880206,109880973,109880589,767
"14662","chr20",44521658,44522138,44521898,480
"14663","chr3",184275922,184276559,184276240,637
"14664","chr18",78977005,78981362,78979183,4357
"14665","chr15",73998003,73998419,73998211,416
"14666","chr11",65607228,65607837,65607532,609
"14667","chr20",3407318,3408254,3407786,936
"14668","chr8",24913389,24915034,24914211,1645
"14669","chr16",56450953,56451862,56451407,909
"14670","chr5",476202,476818,476510,616
"14671","chr20",64255335,64256110,64255722,775
"14672","chr12",57765072,57765645,57765358,573
"14673","chr15",74889921,74890281,74890101,360
"14674","chr18",77978538,77978945,77978741,407
"14675","chr12",52233009,52233793,52233401,784
"14676","chr12",42325959,42326317,42326138,358
"14677","chr11",1443065,1443694,1443379,629
"14678","chr22",37843785,37844402,37844093,617
"14679","chr5",76818737,76819219,76818978,482
"14680","chr13",39602712,39603439,39603075,727
"14681","chr21",34459399,34460067,34459733,668
"14682","chr12",66188915,66189565,66189240,650
"14683","chr11",66744332,66745267,66744799,935
"14684","chr2",111223227,111223586,111223406,359
"14685","chr4",16256324,16256604,16256464,280
"14686","chr6",139167022,139167237,139167129,215
"14687","chr7",128842549,128842923,128842736,374
"14688","chr1",205849770,205850063,205849916,293
"14689","chr1",247330947,247332538,247331742,1591
"14690","chr5",61330678,61333982,61332330,3304
"14691","chr12",114414152,114414555,114414353,403
"14692","chr15",90000178,90000603,90000390,425
"14693","chr7",5303119,5303358,5303238,239
"14694","chr9",131282773,131283295,131283034,522
"14695","chr20",61881229,61881556,61881392,327
"14696","chr13",95676614,95677692,95677153,1078
"14697","chr3",135966064,135966525,135966294,461
"14698","chr1",75130128,75130477,75130302,349
"14699","chr17",55264837,55265673,55265255,836
"14700","chr16",376038,376290,376164,252
"14701","chr11",65497486,65497927,65497706,441
"14702","chr5",783947,785594,784770,1647
"14703","chr14",89619021,89619367,89619194,346
"14704","chr19",35845373,35846236,35845804,863
"14705","chr6",157672778,157673048,157672913,270
"14706","chr6",26550554,26550886,26550720,332
"14707","chr16",50368328,50369071,50368699,743
"14708","chr5",168291518,168292683,168292100,1165
"14709","chr5",180208995,180209444,180209219,449
"14710","chr11",26331990,26332265,26332127,275
"14711","chrX",104156719,104157097,104156908,378
"14712","chr7",16851144,16851463,16851303,319
"14713","chr11",59615439,59615937,59615688,498
"14714","chr5",71719090,71719888,71719489,798
"14715","chr11",1571268,1573148,1572208,1880
"14716","chr14",75051014,75051521,75051267,507
"14717","chr12",125185571,125187566,125186568,1995
"14718","chr3",98901287,98902052,98901669,765
"14719","chr19",925120,926870,925995,1750
"14720","chr22",21952182,21953030,21952606,848
"14721","chr4",152975899,152976208,152976053,309
"14722","chr1",1676459,1676804,1676631,345
"14723","chr1",54980414,54981173,54980793,759
"14724","chr3",44624985,44625328,44625156,343
"14725","chr21",37220686,37221373,37221029,687
"14726","chr6",99993530,99994276,99993903,746
"14727","chr19",48680241,48680910,48680575,669
"14728","chr4",122152239,122152621,122152430,382
"14729","chr11",67492942,67495244,67494093,2302
"14730","chr8",143283472,143283814,143283643,342
"14731","chr17",63535699,63535941,63535820,242
"14732","chr20",63573856,63574534,63574195,678
"14733","chr12",106582403,106582934,106582668,531
"14734","chr4",1537050,1537310,1537180,260
"14735","chr16",56608217,56608683,56608450,466
"14736","chr2",96986027,96986704,96986365,677
"14737","chr22",37198625,37199671,37199148,1046
"14738","chr22",50431234,50431463,50431348,229
"14739","chr17",7627387,7627933,7627660,546
"14740","chr7",2067445,2067746,2067595,301
"14741","chr11",65013978,65014913,65014445,935
"14742","chr2",27369978,27371232,27370605,1254
"14743","chrX",57591969,57592895,57592432,926
"14744","chrX",49073764,49074295,49074029,531
"14745","chr22",20142873,20143775,20143324,902
"14746","chr15",89334366,89335366,89334866,1000
"14747","chr11",70486161,70487308,70486734,1147
"14748","chr14",49598466,49600147,49599306,1681
"14749","chr6",28251745,28251967,28251856,222
"14750","chr8",118621687,118622074,118621880,387
"14751","chr20",35698899,35699779,35699339,880
"14752","chr11",70398182,70398895,70398538,713
"14753","chr3",30894555,30894773,30894664,218
"14754","chr15",65286275,65287152,65286713,877
"14755","chr11",111512443,111513167,111512805,724
"14756","chr8",144048384,144053124,144050754,4740
"14757","chr7",56787452,56787807,56787629,355
"14758","chr22",37608436,37609264,37608850,828
"14759","chr20",6052029,6052871,6052450,842
"14760","chr13",27917351,27918381,27917866,1030
"14761","chr16",50467933,50468396,50468164,463
"14762","chr13",26186284,26186755,26186519,471
"14763","chrX",51743318,51743914,51743616,596
"14764","chr11",110092514,110093951,110093232,1437
"14765","chr16",2720136,2720499,2720317,363
"14766","chr18",21110979,21112098,21111538,1119
"14767","chr16",1313812,1314495,1314153,683
"14768","chr14",24366604,24367014,24366809,410
"14769","chr7",6348579,6349112,6348845,533
"14770","chr4",1194397,1195374,1194885,977
"14771","chr15",52788261,52791502,52789881,3241
"14772","chr13",22897624,22897830,22897727,206
"14773","chr3",168095041,168096314,168095677,1273
"14774","chr2",159712126,159713168,159712647,1042
"14775","chr7",100603991,100604210,100604100,219
"14776","chr7",4817227,4817535,4817381,308
"14777","chr5",88689653,88689993,88689823,340
"14778","chr1",923590,926252,924921,2662
"14779","chr9",94639070,94639785,94639427,715
"14780","chr18",8785435,8785646,8785540,211
"14781","chr16",89268166,89268680,89268423,514
"14782","chr20",5126556,5127440,5126998,884
"14783","chr12",8406980,8407215,8407097,235
"14784","chr6",33315078,33315419,33315248,341
"14785","chr16",67178030,67178490,67178260,460
"14786","chr12",120194419,120194981,120194700,562
"14787","chr13",25017908,25018970,25018439,1062
"14788","chr6",40392031,40392699,40392365,668
"14789","chr17",49788612,49789362,49788987,750
"14790","chr4",6563024,6564088,6563556,1064
"14791","chr8",103371181,103371872,103371526,691
"14792","chr18",78363612,78363926,78363769,314
"14793","chr7",63054137,63054605,63054371,468
"14794","chr12",109833537,109833777,109833657,240
"14795","chr7",122310195,122310873,122310534,678
"14796","chr2",231037311,231038407,231037859,1096
"14797","chr11",85934768,85935148,85934958,380
"14798","chr16",1308728,1310231,1309479,1503
"14799","chr12",100573515,100574067,100573791,552
"14800","chr12",129855138,129859039,129857088,3901
"14801","chr6",142926672,142927301,142926986,629
"14802","chr14",93058422,93059072,93058747,650
"14803","chr2",240983360,240983726,240983543,366
"14804","chr2",216412314,216412834,216412574,520
"14805","chr19",603638,603945,603791,307
"14806","chr11",64007874,64008141,64008007,267
"14807","chrX",47217764,47219040,47218402,1276
"14808","chr22",23750839,23751434,23751136,595
"14809","chr20",4247885,4249703,4248794,1818
"14810","chr3",49718330,49719884,49719107,1554
"14811","chr7",144835669,144836160,144835914,491
"14812","chr5",163459773,163460236,163460004,463
"14813","chr11",116580872,116581195,116581033,323
"14814","chr5",1385863,1386747,1386305,884
"14815","chr22",40044848,40045806,40045327,958
"14816","chr21",33641570,33641951,33641760,381
"14817","chr11",75240602,75242446,75241524,1844
"14818","chr6",166381880,166383813,166382846,1933
"14819","chr13",99086077,99087971,99087024,1894
"14820","chr22",49369092,49369369,49369230,277
"14821","chr12",92144934,92146557,92145745,1623
"14822","chr22",38681800,38682395,38682097,595
"14823","chr11",45355380,45355692,45355536,312
"14824","chr15",65530347,65531051,65530699,704
"14825","chr2",238846455,238849422,238847938,2967
"14826","chr3",47163299,47164846,47164072,1547
"14827","chr16",30183426,30184036,30183731,610
"14828","chr10",96089811,96090338,96090074,527
"14829","chr12",57935940,57936221,57936080,281
"14830","chr5",80654184,80655054,80654619,870
"14831","chr11",64924588,64925024,64924806,436
"14832","chr11",64829503,64830047,64829775,544
"14833","chr11",61967142,61968460,61967801,1318
"14834","chr15",34366774,34367769,34367271,995
"14835","chr20",63802584,63802850,63802717,266
"14836","chr19",3606373,3607272,3606822,899
"14837","chrY",17567843,17568055,17567949,212
"14838","chr8",28092953,28093351,28093152,398
"14839","chr21",46037245,46037825,46037535,580
"14840","chr11",1161859,1162244,1162051,385
"14841","chr21",45295069,45295291,45295180,222
"14842","chr2",36965988,36967144,36966566,1156
"14843","chr14",55766227,55766563,55766395,336
"14844","chr3",35639017,35640072,35639544,1055
"14845","chr9",35071759,35072888,35072323,1129
"14846","chr4",3772124,3772335,3772229,211
"14847","chr7",27150655,27151496,27151075,841
"14848","chr6",7909854,7911185,7910519,1331
"14849","chr10",55628308,55628768,55628538,460
"14850","chrX",123184900,123185297,123185098,397
"14851","chr5",132227401,132228261,132227831,860
"14852","chr8",86342315,86343217,86342766,902
"14853","chr9",125200264,125200846,125200555,582
"14854","chr13",25300856,25302062,25301459,1206
"14855","chr15",73367519,73369674,73368596,2155
"14856","chr8",62144388,62144853,62144620,465
"14857","chr6",16128761,16129792,16129276,1031
"14858","chr5",52788112,52788453,52788282,341
"14859","chr8",48260441,48260866,48260653,425
"14860","chr3",126389176,126389645,126389410,469
"14861","chr11",111298579,111299703,111299141,1124
"14862","chrX",150898319,150899699,150899009,1380
"14863","chr21",45440452,45440714,45440583,262
"14864","chr6",28786092,28786361,28786226,269
"14865","chr16",3295145,3295605,3295375,460
"14866","chrX",140439396,140439732,140439564,336
"14867","chr4",105708418,105709057,105708737,639
"14868","chr12",6867228,6868229,6867728,1001
"14869","chr19",56621790,56622816,56622303,1026
"14870","chr12",54419151,54419407,54419279,256
"14871","chr14",56811350,56811569,56811459,219
"14872","chr15",90994006,90994988,90994497,982
"14873","chr15",96330179,96330751,96330465,572
"14874","chr5",135050305,135050680,135050492,375
"14875","chr13",29514421,29514635,29514528,214
"14876","chr14",74357232,74357434,74357333,202
"14877","chr10",125023444,125023662,125023553,218
"14878","chr5",166978479,166978687,166978583,208
"14879","chr11",65261569,65262455,65262012,886
"14880","chr4",173369799,173372122,173370960,2323
"14881","chr5",126423355,126423606,126423480,251
"14882","chr12",1796111,1797599,1796855,1488
"14883","chr11",27363072,27363323,27363197,251
"14884","chr5",180090442,180090664,180090553,222
"14885","chrX",152897652,152898267,152897959,615
"14886","chr22",50244758,50245465,50245111,707
"14887","chrY",10195324,10197077,10196200,1753
"14888","chr19",18868542,18870744,18869643,2202
"14889","chr1",3509012,3509233,3509122,221
"14890","chr17",81158079,81158284,81158181,205
"14891","chrX",130120580,130121122,130120851,542
"14892","chr7",27172797,27174777,27173787,1980
"14893","chr22",23856871,23858019,23857445,1148
"14894","chr22",48560078,48560294,48560186,216
"14895","chr19",6463980,6464769,6464374,789
"14896","chr18",7566559,7568832,7567695,2273
"14897","chr12",109573189,109573794,109573491,605
"14898","chr15",77070398,77071218,77070808,820
"14899","chr4",40043891,40044113,40044002,222
"14900","chr13",111411222,111411675,111411448,453
"14901","chr14",44887469,44887792,44887630,323
"14902","chr16",2099841,2100522,2100181,681
"14903","chr2",200585803,200586304,200586053,501
"14904","chr12",54378903,54379205,54379054,302
"14905","chr20",25195391,25195984,25195687,593
"14906","chr22",30635371,30635628,30635499,257
"14907","chr5",81971758,81972548,81972153,790
"14908","chr4",151408672,151409721,151409196,1049
"14909","chr9",34522680,34523359,34523019,679
"14910","chr13",20391819,20392370,20392094,551
"14911","chr16",48810640,48811353,48810996,713
"14912","chr7",5898542,5899117,5898829,575
"14913","chr11",116787695,116788179,116787937,484
"14914","chr4",25088484,25088888,25088686,404
"14915","chrX",67546195,67546437,67546316,242
"14916","chr17",42180579,42181453,42181016,874
"14917","chr15",96368282,96368579,96368430,297
"14918","chr17",76932628,76932840,76932734,212
"14919","chr20",4592530,4592850,4592690,320
"14920","chr19",56314398,56315417,56314907,1019
"14921","chr1",33472424,33472727,33472575,303
"14922","chr11",95923748,95924201,95923974,453
"14923","chrX",65406863,65408165,65407514,1302
"14924","chr4",76896862,76898447,76897654,1585
"14925","chr14",101364954,101365358,101365156,404
"14926","chr15",43824485,43824838,43824661,353
"14927","chr9",128656392,128657168,128656780,776
"14928","chr16",909714,909977,909845,263
"14929","chr19",44757095,44758552,44757823,1457
"14930","chr3",13895689,13896095,13895892,406
"14931","chr11",119334313,119334858,119334585,545
"14932","chr5",180628849,180629126,180628987,277
"14933","chr15",62390946,62392197,62391571,1251
"14934","chr4",7054293,7054854,7054573,561
"14935","chr9",136514493,136514793,136514643,300
"14936","chr22",21628497,21630195,21629346,1698
"14937","chr14",24213196,24213631,24213413,435
"14938","chr5",554708,555217,554962,509
"14939","chr14",105219115,105219396,105219255,281
"14940","chr17",30600074,30601436,30600755,1362
"14941","chr16",3036282,3037055,3036668,773
"14942","chrX",151177143,151178105,151177624,962
"14943","chr6",7389401,7390084,7389742,683
"14944","chr15",63277571,63277901,63277736,330
"14945","chr9",95515846,95517472,95516659,1626
"14946","chr10",97401057,97401359,97401208,302
"14947","chr11",86800142,86800847,86800494,705
"14948","chr15",96353699,96354072,96353885,373
"14949","chr16",15649902,15650566,15650234,664
"14950","chr17",18246965,18247858,18247411,893
"14951","chr2",240322894,240323342,240323118,448
"14952","chr10",131344232,131344579,131344405,347
"14953","chr11",15114512,15114999,15114755,487
"14954","chr13",20946189,20946425,20946307,236
"14955","chr16",58249799,58250180,58249989,381
"14956","chr11",134664348,134664563,134664455,215
"14957","chr21",44369207,44369993,44369600,786
"14958","chr5",141430927,141433050,141431988,2123
"14959","chr14",101457238,101459658,101458448,2420
"14960","chr12",32755440,32755889,32755664,449
"14961","chr1",205504749,205504981,205504865,232
"14962","chr10",118342052,118342425,118342238,373
"14963","chr11",68212544,68214616,68213580,2072
"14964","chr11",27720512,27720726,27720619,214
"14965","chr4",8586988,8587224,8587106,236
"14966","chr5",140557170,140557608,140557389,438
"14967","chr12",120368243,120369556,120368899,1313
"14968","chr14",77980996,77981381,77981188,385
"14969","chr8",37841328,37842413,37841870,1085
"14970","chr12",132710174,132711406,132710790,1232
"14971","chr12",21774490,21775057,21774773,567
"14972","chr10",70381804,70382881,70382342,1077
"14973","chr20",62797072,62797286,62797179,214
"14974","chr10",42782401,42783084,42782742,683
"14975","chr5",110738904,110739522,110739213,618
"14976","chrX",3814532,3816531,3815531,1999
"14977","chr4",8688229,8688448,8688338,219
"14978","chr5",155727944,155729374,155728659,1430
"14979","chr11",71813493,71813807,71813650,314
"14980","chr2",232485568,232488264,232486916,2696
"14981","chr8",41577841,41578640,41578240,799
"14982","chr3",142947356,142947702,142947529,346
"14983","chr3",71724675,71725722,71725198,1047
"14984","chr5",494688,495981,495334,1293
"14985","chr12",119667697,119668427,119668062,730
"14986","chr10",87862015,87862839,87862427,824
"14987","chr3",197665018,197665610,197665314,592
"14988","chr12",55728233,55729402,55728817,1169
"14989","chr5",141174100,141175056,141174578,956
"14990","chr17",7444955,7445511,7445233,556
"14991","chr5",119452430,119452733,119452581,303
"14992","chr9",137015426,137015815,137015620,389
"14993","chr1",145960385,145962107,145961246,1722
"14994","chr1",1615073,1616635,1615854,1562
"14995","chr12",132496811,132497046,132496928,235
"14996","chr16",69339158,69339979,69339568,821
"14997","chr16",75250782,75251764,75251273,982
"14998","chr6",138161397,138162573,138161985,1176
"14999","chr2",19347721,19348531,19348126,810
"15000","chr9",93346184,93346710,93346447,526
"15001","chr8",139702342,139706109,139704225,3767
"15002","chr9",116701,118177,117439,1476
"15003","chr11",72781236,72781602,72781419,366
"15004","chr17",19507407,19508064,19507735,657
"15005","chr16",3364964,3365167,3365065,203
"15006","chr18",79772390,79772593,79772491,203
"15007","chr5",172617849,172618077,172617963,228
"15008","chr8",57259517,57261304,57260410,1787
"15009","chr2",52571265,52572919,52572092,1654
"15010","chr19",29606158,29606372,29606265,214
"15011","chr5",179623001,179624610,179623805,1609
"15012","chr18",67516000,67516736,67516368,736
"15013","chr11",78658131,78658336,78658233,205
"15014","chr1",85200135,85201967,85201051,1832
"15015","chr5",60699547,60700504,60700025,957
"15016","chr2",190648220,190649713,190648966,1493
"15017","chr5",61162013,61162827,61162420,814
"15018","chr2",222860840,222861705,222861272,865
"15019","chr11",125887160,125888212,125887686,1052
"15020","chr6",99613103,99614781,99613942,1678
"15021","chr11",126355460,126356178,126355819,718
"15022","chr21",46145371,46146431,46145901,1060
"15023","chr7",150322861,150323663,150323262,802
"15024","chr22",50285241,50285806,50285523,565
"15025","chr18",78238674,78239123,78238898,449
"15026","chr10",43728368,43728578,43728473,210
"15027","chr11",1992103,1992387,1992245,284
"15028","chr5",175871512,175872622,175872067,1110
"15029","chr4",56048956,56049735,56049345,779
"15030","chr10",91153633,91153937,91153785,304
"15031","chr11",60841919,60842313,60842116,394
"15032","chr12",6290096,6291605,6290850,1509
"15033","chr20",662028,662251,662139,223
"15034","chr11",16610961,16611178,16611069,217
"15035","chr1",25922714,25923122,25922918,408
"15036","chr7",95434761,95435097,95434929,336
"15037","chr8",101493284,101494202,101493743,918
"15038","chr22",43342342,43344279,43343310,1937
"15039","chr17",21275507,21276378,21275942,871
"15040","chr11",119018168,119019405,119018786,1237
"15041","chr9",112916,114839,113877,1923
"15042","chr1",45750561,45750842,45750701,281
"15043","chr13",40664363,40667613,40665988,3250
"15044","chr14",62056857,62057068,62056962,211
"15045","chr14",104931739,104934153,104932946,2414
"15046","chr8",98064526,98065016,98064771,490
"15047","chr16",89232866,89233466,89233166,600
"15048","chr3",195873974,195875490,195874732,1516
"15049","chr7",157819344,157819624,157819484,280
"15050","chr6",82363699,82365602,82364650,1903
"15051","chr12",104597,105061,104829,464
"15052","chr14",90758485,90758765,90758625,280
"15053","chr21",32411606,32413409,32412507,1803
"15054","chr15",24848044,24848435,24848239,391
"15055","chr12",123761977,123762707,123762342,730
"15056","chr19",38519236,38519502,38519369,266
"15057","chr22",39557445,39558663,39558054,1218
"15058","chr9",100098493,100099395,100098944,902
"15059","chrX",49042984,49043943,49043463,959
"15060","chr17",8799024,8799506,8799265,482
"15061","chr16",88467989,88468281,88468135,292
"15062","chr20",346732,348333,347532,1601
"15063","chr20",63734897,63735183,63735040,286
"15064","chr22",29837934,29838410,29838172,476
"15065","chr6",99424850,99425330,99425090,480
"15066","chr17",13496441,13496771,13496606,330
"15067","chr1",2855561,2856100,2855830,539
"15068","chr5",111757499,111758217,111757858,718
"15069","chrX",15790067,15790701,15790384,634
"15070","chr11",124953897,124954433,124954165,536
"15071","chr11",1952809,1953103,1952956,294
"15072","chr17",15786194,15786913,15786553,719
"15073","chr9",91423369,91425014,91424191,1645
"15074","chr6",166306751,166308787,166307769,2036
"15075","chr2",25204232,25204708,25204470,476
"15076","chr15",98707565,98707789,98707677,224
"15077","chr22",50031437,50031991,50031714,554
"15078","chr11",75525144,75526736,75525940,1592
"15079","chrX",154370595,154372236,154371415,1641
"15080","chr1",1067283,1069938,1068610,2655
"15081","chr14",63852824,63853808,63853316,984
"15082","chr8",93740747,93741271,93741009,524
"15083","chr11",101582626,101583953,101583289,1327
"15084","chr17",2852807,2854644,2853725,1837
"15085","chr9",95317357,95317931,95317644,574
"15086","chrX",139194665,139195007,139194836,342
"15087","chr21",46228277,46229708,46228992,1431
"15088","chr14",73026937,73027262,73027099,325
"15089","chr8",7954998,7955416,7955207,418
"15090","chr4",70993441,70994167,70993804,726
"15091","chr15",33194722,33195089,33194905,367
"15092","chr12",9239863,9240090,9239976,227
"15093","chr3",123447371,123450281,123448826,2910
"15094","chr11",3855057,3856201,3855629,1144
"15095","chr17",17752144,17752568,17752356,424
"15096","chr5",54517549,54519476,54518512,1927
"15097","chr9",124769761,124771412,124770586,1651
"15098","chr11",123577385,123577674,123577529,289
"15099","chr7",6663872,6664444,6664158,572
"15100","chr6",112087203,112087707,112087455,504
"15101","chr14",103207142,103208006,103207574,864
"15102","chr6",27873223,27873466,27873344,243
"15103","chr16",87654859,87655271,87655065,412
"15104","chr10",124592819,124593045,124592932,226
"15105","chr17",38563308,38563702,38563505,394
"15106","chr5",69217687,69218373,69218030,686
"15107","chr19",10602460,10602879,10602669,419
"15108","chr6",710834,711297,711065,463
"15109","chr9",92114990,92115500,92115245,510
"15110","chr17",30906241,30906520,30906380,279
"15111","chr17",60078649,60079066,60078857,417
"15112","chr7",66681738,66683024,66682381,1286
"15113","chr13",77918290,77919247,77918768,957
"15114","chr4",11368670,11369262,11368966,592
"15115","chr3",194633032,194633761,194633396,729
"15116","chr7",156949529,156950380,156949954,851
"15117","chr7",35185751,35186968,35186359,1217
"15118","chr4",1659091,1659442,1659266,351
"15119","chr19",2650661,2650913,2650787,252
"15120","chr1",152036362,152036636,152036499,274
"15121","chr1",12191277,12191928,12191602,651
"15122","chr11",82901460,82901802,82901631,342
"15123","chr22",46262500,46263435,46262967,935
"15124","chr13",43970066,43970442,43970254,376
"15125","chr9",74951857,74953122,74952489,1265
"15126","chr11",17351472,17352118,17351795,646
"15127","chr7",6165765,6166051,6165908,286
"15128","chr22",43955022,43955782,43955402,760
"15129","chr15",26628950,26629381,26629165,431
"15130","chr5",173293944,173294166,173294055,222
"15131","chr22",20429179,20431914,20430546,2735
"15132","chr12",132231172,132234872,132233022,3700
"15133","chr19",17215305,17215742,17215523,437
"15134","chr12",111319950,111320717,111320333,767
"15135","chr5",176388287,176389447,176388867,1160
"15136","chr2",234495858,234497897,234496877,2039
"15137","chr13",36673812,36674326,36674069,514
"15138","chr11",124876013,124876877,124876445,864
"15139","chr4",156971544,156972134,156971839,590
"15140","chr6",39901803,39902024,39901913,221
"15141","chr12",98503826,98504071,98503948,245
"15142","chr19",17393872,17394267,17394069,395
"15143","chr10",110497405,110498926,110498165,1521
"15144","chr20",59403746,59404020,59403883,274
"15145","chr6",10422088,10422415,10422251,327
"15146","chr6",31652079,31652748,31652413,669
"15147","chr17",80191278,80191494,80191386,216
"15148","chr20",44326685,44327088,44326886,403
"15149","chr13",108218154,108218980,108218567,826
"15150","chr14",60248647,60250088,60249367,1441
"15151","chr20",64084935,64085180,64085057,245
"15152","chr7",6170299,6171087,6170693,788
"15153","chr12",132508197,132508774,132508485,577
"15154","chr11",64118109,64118316,64118212,207
"15155","chr21",14383050,14383765,14383407,715
"15156","chr12",34166664,34167049,34166856,385
"15157","chr5",73419497,73420170,73419833,673
"15158","chr19",17337373,17337661,17337517,288
"15159","chr5",75053975,75054414,75054194,439
"15160","chr9",113400928,113401568,113401248,640
"15161","chr16",4766763,4767352,4767057,589
"15162","chr17",6555809,6556604,6556206,795
"15163","chr2",128471027,128471233,128471130,206
"15164","chr20",31951720,31952156,31951938,436
"15165","chr9",36036801,36037567,36037184,766
"15166","chr16",1343033,1343240,1343136,207
"15167","chr7",55951678,55952286,55951982,608
"15168","chr6",100464195,100465461,100464828,1266
"15169","chr5",10562704,10565568,10564136,2864
"15170","chr12",132764294,132764528,132764411,234
"15171","chr22",29306332,29308733,29307532,2401
"15172","chr2",9393443,9393678,9393560,235
"15173","chr19",662284,663200,662742,916
"15174","chr1",16692188,16694464,16693326,2276
"15175","chr14",49768130,49768820,49768475,690
"15176","chr20",33720011,33720314,33720162,303
"15177","chr6",27515109,27515310,27515209,201
"15178","chr14",99792823,99793892,99793357,1069
"15179","chr14",34982428,34983338,34982883,910
"15180","chr11",1010479,1010753,1010616,274
"15181","chr14",93206783,93207572,93207177,789
"15182","chr17",64496764,64497205,64496984,441
"15183","chr6",45663249,45664077,45663663,828
"15184","chr8",143706321,143708889,143707605,2568
"15185","chr16",4327507,4328161,4327834,654
"15186","chr19",19272894,19273474,19273184,580
"15187","chr18",12271658,12271921,12271789,263
"15188","chr4",88158604,88159302,88158953,698
"15189","chr19",17205948,17206396,17206172,448
"15190","chr9",123268073,123269068,123268570,995
"15191","chr19",47430038,47430570,47430304,532
"15192","chr19",34404247,34404907,34404577,660
"15193","chr9",133534245,133535152,133534698,907
"15194","chr11",2928558,2930526,2929542,1968
"15195","chr20",56249256,56249528,56249392,272
"15196","chr19",3721466,3721707,3721586,241
"15197","chr20",38926111,38927192,38926651,1081
"15198","chr10",639904,640800,640352,896
"15199","chr13",107866944,107868715,107867829,1771
"15200","chr19",47113417,47113844,47113630,427
"15201","chr5",74639900,74641726,74640813,1826
"15202","chr14",100329281,100329664,100329472,383
"15203","chr11",1240853,1241368,1241110,515
"15204","chr11",1825926,1826151,1826038,225
"15205","chr9",83622842,83623621,83623231,779
"15206","chr3",194204092,194204345,194204218,253
"15207","chr12",56129159,56129501,56129330,342
"15208","chr20",46013966,46014472,46014219,506
"15209","chr5",1093464,1093722,1093593,258
"15210","chr2",219060097,219061408,219060752,1311
"15211","chr14",90396699,90398559,90397629,1860
"15212","chr18",79650035,79650246,79650140,211
"15213","chr14",104653283,104653668,104653475,385
"15214","chr21",45266992,45267206,45267099,214
"15215","chr12",57229637,57230120,57229878,483
"15216","chr7",30026803,30027069,30026936,266
"15217","chr2",169768174,169768631,169768402,457
"15218","chr12",53952993,53953317,53953155,324
"15219","chr19",52637922,52638560,52638241,638
"15220","chr6",108176391,108176792,108176591,401
"15221","chr19",57708821,57709149,57708985,328
"15222","chr2",3635439,3635700,3635569,261
"15223","chr12",1639589,1639897,1639743,308
"15224","chr20",62169870,62170077,62169973,207
"15225","chr8",10839418,10840124,10839771,706
"15226","chr21",31872597,31874296,31873446,1699
"15227","chr2",73926726,73927154,73926940,428
"15228","chr7",149713767,149715260,149714513,1493
"15229","chr6",36387500,36388239,36387869,739
"15230","chr10",1326708,1327696,1327202,988
"15231","chr14",96038974,96040065,96039519,1091
"15232","chr14",50871994,50872428,50872211,434
"15233","chr16",69109596,69110016,69109806,420
"15234","chr12",65169415,65170616,65170015,1201
"15235","chr10",98467681,98468075,98467878,394
"15236","chr9",63817918,63818178,63818048,260
"15237","chr2",66444523,66444727,66444625,204
"15238","chr19",40420733,40421461,40421097,728
"15239","chr5",113294522,113294927,113294724,405
"15240","chr2",74198317,74199296,74198806,979
"15241","chr14",99644783,99645569,99645176,786
"15242","chr10",341354,341604,341479,250
"15243","chr15",93109526,93109820,93109673,294
"15244","chr13",67230376,67231327,67230851,951
"15245","chr19",11887989,11888316,11888152,327
"15246","chr20",61942977,61948820,61945898,5843
"15247","chr19",49442850,49443965,49443407,1115
"15248","chr8",11015814,11016777,11016295,963
"15249","chr21",45393080,45393327,45393203,247
"15250","chr11",66863783,66863999,66863891,216
"15251","chr11",1271932,1272841,1272386,909
"15252","chr19",48619020,48619666,48619343,646
"15253","chr19",12484436,12485069,12484752,633
"15254","chr5",141188643,141189545,141189094,902
"15255","chr20",36572920,36575087,36574003,2167
"15256","chr17",75563269,75563482,75563375,213
"15257","chr10",100744156,100746389,100745272,2233
"15258","chrX",34387790,34388171,34387980,381
"15259","chr1",72283326,72284053,72283689,727
"15260","chr7",4718171,4718406,4718288,235
"15261","chr9",136472733,136472957,136472845,224
"15262","chr7",2256718,2257614,2257166,896
"15263","chr10",132798048,132799633,132798840,1585
"15264","chr1",40818168,40818919,40818543,751
"15265","chr6",71886333,71887065,71886699,732
"15266","chr11",33700167,33700954,33700560,787
"15267","chr17",81103517,81103718,81103617,201
"15268","chr5",176447628,176448427,176448027,799
"15269","chr2",218883590,218884083,218883836,493
"15270","chr11",567938,569184,568561,1246
"15271","chr22",49764291,49764569,49764430,278
"15272","chr12",122526714,122527218,122526966,504
"15273","chr1",154961452,154962259,154961855,807
"15274","chr2",138501463,138502342,138501902,879
"15275","chr17",17700269,17700833,17700551,564
"15276","chr5",177504109,177504400,177504254,291
"15277","chr16",88452321,88456106,88454213,3785
"15278","chr5",139847925,139848702,139848313,777
"15279","chr17",50781274,50781577,50781425,303
"15280","chr16",2289258,2289551,2289404,293
"15281","chr15",40239043,40239388,40239215,345
"15282","chr20",63400064,63401070,63400567,1006
"15283","chr17",41966587,41967283,41966935,696
"15284","chr11",1024746,1025359,1025052,613
"15285","chr3",11719164,11720604,11719884,1440
"15286","chr13",27620046,27622112,27621079,2066
"15287","chr16",23148600,23149645,23149122,1045
"15288","chr17",38464897,38465165,38465031,268
"15289","chr2",215311826,215312409,215312117,583
"15290","chr22",17773849,17774611,17774230,762
"15291","chr7",100585778,100587002,100586390,1224
"15292","chr6",160767052,160767607,160767329,555
"15293","chr5",175658012,175658753,175658382,741
"15294","chr13",106567644,106568316,106567980,672
"15295","chr18",59696482,59697769,59697125,1287
"15296","chr5",39721446,39721733,39721589,287
"15297","chr16",4733861,4734757,4734309,896
"15298","chr7",57203140,57203757,57203448,617
"15299","chr8",53250743,53251883,53251313,1140
"15300","chr5",173234483,173235225,173234854,742
"15301","chr19",15189020,15189356,15189188,336
"15302","chr11",115153887,115154224,115154055,337
"15303","chr11",119741381,119741766,119741573,385
"15304","chr8",94948523,94950144,94949333,1621
"15305","chr11",59810617,59810906,59810761,289
"15306","chr21",40144310,40144545,40144427,235
"15307","chrX",15646618,15647055,15646836,437
"15308","chr7",129952192,129953051,129952621,859
"15309","chr19",40811887,40812246,40812066,359
"15310","chrX",49157244,49157530,49157387,286
"15311","chr12",6477654,6477946,6477800,292
"15312","chr11",124865173,124866569,124865871,1396
"15313","chrX",18425000,18426306,18425653,1306
"15314","chr19",41643879,41644262,41644070,383
"15315","chr18",5894867,5896250,5895558,1383
"15316","chr5",141636864,141638118,141637491,1254
"15317","chr10",13528128,13529395,13528761,1267
"15318","chr14",106460339,106460686,106460512,347
"15319","chr20",35277530,35278288,35277909,758
"15320","chr15",98957243,98957492,98957367,249
"15321","chr9",26956303,26956772,26956537,469
"15322","chr21",17818778,17819740,17819259,962
"15323","chr7",155802998,155810541,155806769,7543
"15324","chr5",175796606,175797676,175797141,1070
"15325","chr14",75661165,75661571,75661368,406
"15326","chr19",589490,591719,590604,2229
"15327","chr19",10928280,10929609,10928944,1329
"15328","chr12",7970750,7970965,7970857,215
"15329","chr3",72887945,72888567,72888256,622
"15330","chr8",144429134,144429427,144429280,293
"15331","chr16",57462564,57463126,57462845,562
"15332","chr22",50464620,50464923,50464771,303
"15333","chr22",22644457,22644743,22644600,286
"15334","chr7",56174713,56175605,56175159,892
"15335","chr21",26169575,26170890,26170232,1315
"15336","chr8",47831280,47831616,47831448,336
"15337","chr19",2702534,2702771,2702652,237
"15338","chr2",241932621,241932837,241932729,216
"15339","chr11",65477165,65477659,65477412,494
"15340","chr11",12008190,12009294,12008742,1104
"15341","chr8",144713107,144714323,144713715,1216
"15342","chr15",65302077,65302311,65302194,234
"15343","chr6",108557627,108562201,108559914,4574
"15344","chr19",4173156,4173486,4173321,330
"15345","chr8",63085668,63086178,63085923,510
"15346","chr14",103921243,103921699,103921471,456
"15347","chr19",58347087,58347617,58347352,530
"15348","chr7",97731820,97733706,97732763,1886
"15349","chr9",36487110,36488086,36487598,976
"15350","chr4",75990690,75991099,75990894,409
"15351","chr19",11382808,11383687,11383247,879
"15352","chr8",142454123,142454531,142454327,408
"15353","chr16",2084258,2084631,2084444,373
"15354","chr6",14117385,14117975,14117680,590
"15355","chr4",185142893,185143848,185143370,955
"15356","chr8",80029882,80030358,80030120,476
"15357","chr17",40647692,40648451,40648071,759
"15358","chr6",41895323,41895597,41895460,274
"15359","chr14",21300984,21301221,21301102,237
"15360","chr3",142888353,142889387,142888870,1034
"15361","chr13",114048466,114048981,114048723,515
"15362","chr3",170585255,170585979,170585617,724
"15363","chr3",138347953,138349012,138348482,1059
"15364","chrX",115233532,115233890,115233711,358
"15365","chr12",51590690,51591500,51591095,810
"15366","chr3",125357388,125357637,125357512,249
"15367","chr21",42218838,42220022,42219430,1184
"15368","chr10",133166798,133167555,133167176,757
"15369","chr19",55476177,55476804,55476490,627
"15370","chr2",70767315,70768414,70767864,1099
"15371","chr17",82931170,82931486,82931328,316
"15372","chr8",143483092,143483308,143483200,216
"15373","chr12",111037149,111037438,111037293,289
"15374","chr19",42177152,42177478,42177315,326
"15375","chr5",178589557,178590669,178590113,1112
"15376","chr19",40383919,40384145,40384032,226
"15377","chr7",159064126,159064518,159064322,392
"15378","chr12",128945058,128945298,128945178,240
"15379","chr12",106955374,106956311,106955842,937
"15380","chr4",5708258,5708768,5708513,510
"15381","chr2",120735281,120737658,120736469,2377
"15382","chr19",11766905,11767465,11767185,560
"15383","chr12",48004106,48004948,48004527,842
"15384","chr15",65102075,65102703,65102389,628
"15385","chr17",82083175,82083590,82083382,415
"15386","chr19",4101773,4101975,4101874,202
"15387","chr10",42149373,42150964,42150168,1591
"15388","chr3",94937888,94938315,94938101,427
"15389","chr10",11869555,11870433,11869994,878
"15390","chr11",1694117,1694377,1694247,260
"15391","chr19",12555429,12555868,12555648,439
"15392","chr19",50210373,50210816,50210594,443
"15393","chr11",18012582,18013721,18013151,1139
"15394","chr10",86399856,86401860,86400858,2004
"15395","chr20",35600797,35602345,35601571,1548
"15396","chr7",73578104,73579067,73578585,963
"15397","chr17",35373468,35373741,35373604,273
"15398","chr7",76626841,76627521,76627181,680
"15399","chr2",176128751,176130829,176129790,2078
"15400","chr18",8608765,8610372,8609568,1607
"15401","chr19",58470962,58472145,58471553,1183
"15402","chr3",42803944,42804863,42804403,919
"15403","chr17",39607839,39608051,39607945,212
"15404","chr19",53962924,53963471,53963197,547
"15405","chr17",28384364,28385292,28384828,928
"15406","chr11",114199141,114199395,114199268,254
"15407","chr9",134047899,134048577,134048238,678
"15408","chr14",35046056,35046731,35046393,675
"15409","chr9",111482764,111484504,111483634,1740
"15410","chr19",1908119,1908510,1908314,391
"15411","chr17",76139841,76141721,76140781,1880
"15412","chr2",239096317,239096579,239096448,262
"15413","chr5",3594353,3603136,3598744,8783
"15414","chr12",107775209,107775793,107775501,584
"15415","chr10",49609555,49612310,49610932,2755
"15416","chr8",2127580,2127833,2127706,253
"15417","chr18",12433996,12434487,12434241,491
"15418","chr19",16571846,16572981,16572413,1135
"15419","chr2",47906418,47906913,47906665,495
"15420","chr12",106357638,106358187,106357912,549
"15421","chr9",4679325,4679999,4679662,674
"15422","chr22",25564641,25565401,25565021,760
"15423","chr2",81467198,81467557,81467377,359
"15424","chr5",88660671,88661369,88661020,698
"15425","chr11",16604506,16605677,16605091,1171
"15426","chr12",1907967,1908581,1908274,614
"15427","chr17",56780331,56780553,56780442,222
"15428","chr2",227163963,227164461,227164212,498
"15429","chr20",41998584,41999385,41998984,801
"15430","chr19",55362268,55362625,55362446,357
"15431","chr19",19262692,19262904,19262798,212
"15432","chr19",1230975,1231324,1231149,349
"15433","chr10",92420558,92420997,92420777,439
"15434","chr4",3531916,3533061,3532488,1145
"15435","chr11",2444907,2445588,2445247,681
"15436","chr1",26826739,26827183,26826961,444
"15437","chr9",124008384,124009812,124009098,1428
"15438","chr10",48479618,48479827,48479722,209
"15439","chr11",11841725,11842471,11842098,746
"15440","chr6",163630453,163631291,163630872,838
"15441","chr19",12956771,12957338,12957054,567
"15442","chr16",70289224,70289586,70289405,362
"15443","chr5",561711,565852,563781,4141
"15444","chr19",48404919,48405340,48405129,421
"15445","chr22",21516734,21518280,21517507,1546
"15446","chr7",101244788,101245207,101244997,419
"15447","chr19",19514145,19516449,19515297,2304
"15448","chr10",93893884,93894424,93894154,540
"15449","chr19",55613539,55616801,55615170,3262
"15450","chr15",40382818,40383427,40383122,609
"15451","chr5",141345484,141346324,141345904,840
"15452","chr8",22565021,22566189,22565605,1168
"15453","chr5",53479703,53480682,53480192,979
"15454","chr10",132331673,132332521,132332097,848
"15455","chr20",49906065,49906597,49906331,532
"15456","chr9",113463483,113463853,113463668,370
"15457","chr12",132288650,132288920,132288785,270
"15458","chrX",41084420,41086667,41085543,2247
"15459","chr16",86497141,86499388,86498264,2247
"15460","chr14",28785159,28785863,28785511,704
"15461","chr6",116764576,116765779,116765177,1203
"15462","chr3",49786049,49786913,49786481,864
"15463","chr11",10930803,10931525,10931164,722
"15464","chr17",79978046,79978492,79978269,446
"15465","chr10",119651054,119652315,119651684,1261
"15466","chrX",48897217,48898046,48897631,829
"15467","chr13",44575929,44578152,44577040,2223
"15468","chr16",34133933,34134214,34134073,281
"15469","chr5",41925187,41925614,41925400,427
"15470","chr19",21505820,21506037,21505928,217
"15471","chr3",32685025,32685657,32685341,632
"15472","chr19",2302467,2303000,2302733,533
"15473","chr20",44750027,44750797,44750412,770
"15474","chr12",110124333,110124895,110124614,562
"15475","chr4",80183607,80184373,80183990,766
"15476","chr22",18905738,18906778,18906258,1040
"15477","chr5",88680277,88680729,88680503,452
"15478","chr12",102824342,102824910,102824626,568
"15479","chr4",1720452,1722123,1721287,1671
"15480","chr7",895394,896011,895702,617
"15481","chr9",121550534,121550908,121550721,374
"15482","chr16",16223379,16223707,16223543,328
"15483","chr5",132257732,132258120,132257926,388
"15484","chr17",42679664,42680434,42680049,770
"15485","chr16",31094130,31095000,31094565,870
"15486","chr4",1598982,1599333,1599157,351
"15487","chr7",76999946,77000172,77000059,226
"15488","chr19",52007975,52008329,52008152,354
"15489","chr1",235128425,235129072,235128748,647
"15490","chr9",41073887,41074942,41074414,1055
"15491","chr5",72816330,72817279,72816804,949
"15492","chr16",30930109,30930581,30930345,472
"15493","chr7",150979090,150979497,150979293,407
"15494","chr19",3531570,3532193,3531881,623
"15495","chr12",53079244,53079712,53079478,468
"15496","chr10",69571693,69571935,69571814,242
"15497","chr2",17540270,17540754,17540512,484
"15498","chr7",129611396,129612600,129611998,1204
"15499","chr17",48047684,48048871,48048277,1187
"15500","chr12",56221739,56221983,56221861,244
"15501","chrX",71224196,71224420,71224308,224
"15502","chr6",50714621,50715501,50715061,880
"15503","chr19",35643251,35644879,35644065,1628
"15504","chr6",145814298,145815029,145814663,731
"15505","chr1",2440407,2440634,2440520,227
"15506","chr9",133356273,133357090,133356681,817
"15507","chrX",134796757,134797325,134797041,568
"15508","chr3",3126640,3127547,3127093,907
"15509","chr13",34942234,34943290,34942762,1056
"15510","chr12",28190356,28190974,28190665,618
"15511","chrX",13938108,13938942,13938525,834
"15512","chr10",132927297,132927529,132927413,232
"15513","chr2",98821834,98823421,98822627,1587
"15514","chr8",744469,744697,744583,228
"15515","chr19",52492687,52493342,52493014,655
"15516","chr5",90529299,90529987,90529643,688
"15517","chr3",72928848,72929174,72929011,326
"15518","chr7",157621209,157621454,157621331,245
"15519","chr6",100136004,100136278,100136141,274
"15520","chr11",66025261,66025462,66025361,201
"15521","chr13",71867362,71867644,71867503,282
"15522","chr9",128127419,128128865,128128142,1446
"15523","chrY",2789761,2790058,2789909,297
"15524","chr4",176195392,176195742,176195567,350
"15525","chr12",122986006,122986555,122986280,549
"15526","chr7",121329533,121330689,121330111,1156
"15527","chr19",7629209,7629711,7629460,502
"15528","chr11",133082643,133083412,133083027,769
"15529","chr7",6622244,6623064,6622654,820
"15530","chr2",54115497,54115951,54115724,454
"15531","chr12",14774357,14775089,14774723,732
"15532","chr7",33904053,33905897,33904975,1844
"15533","chr16",86505512,86505880,86505696,368
"15534","chr2",1512400,1512601,1512500,201
"15535","chr20",63479938,63480163,63480050,225
"15536","chr2",127422860,127423805,127423332,945
"15537","chr5",43040243,43040531,43040387,288
"15538","chr2",25376807,25377026,25376916,219
"15539","chr3",169966606,169967218,169966912,612
"15540","chr18",50374992,50375292,50375142,300
"15541","chr19",36214531,36215360,36214945,829
"15542","chr7",74453457,74454649,74454053,1192
"15543","chr11",94512380,94512725,94512552,345
"15544","chr7",36366761,36367408,36367084,647
"15545","chr3",9890495,9891082,9890788,587
"15546","chr21",44958363,44958730,44958546,367
"15547","chr2",85538572,85539860,85539216,1288
"15548","chr11",123194718,123196278,123195498,1560
"15549","chr4",68349586,68350203,68349894,617
"15550","chr7",57835589,57835825,57835707,236
"15551","chr21",45439268,45440155,45439711,887
"15552","chrX",63351073,63351547,63351310,474
"15553","chr7",100435639,100436630,100436134,991
"15554","chr5",1645009,1645597,1645303,588
"15555","chr4",119300471,119300852,119300661,381
"15556","chr19",50639027,50639729,50639378,702
"15557","chr10",65053877,65054303,65054090,426
"15558","chr8",142516128,142516533,142516330,405
"15559","chr5",173988921,173989564,173989242,643
"15560","chr5",3590530,3591886,3591208,1356
"15561","chr10",72354057,72355034,72354545,977
"15562","chr19",33194019,33195179,33194599,1160
"15563","chr14",95360338,95360604,95360471,266
"15564","chrX",119073544,119073816,119073680,272
"15565","chr11",18394375,18395133,18394754,758
"15566","chr19",9584245,9584757,9584501,512
"15567","chr6",30451067,30451853,30451460,786
"15568","chr5",500273,500497,500385,224
"15569","chr19",48182466,48182828,48182647,362
"15570","chr3",184338631,184338883,184338757,252
"15571","chr10",86520878,86522332,86521605,1454
"15572","chr17",64919064,64919919,64919491,855
"15573","chrX",123960073,123960732,123960402,659
"15574","chr1",6784253,6786306,6785279,2053
"15575","chr9",129027869,129028129,129027999,260
"15576","chrX",16711802,16712815,16712308,1013
"15577","chr16",176174,177255,176714,1081
"15578","chr5",14487733,14488427,14488080,694
"15579","chr16",29220555,29221017,29220786,462
"15580","chr10",114239249,114239844,114239546,595
"15581","chr1",67134707,67135032,67134869,325
"15582","chr3",15098528,15099383,15098955,855
"15583","chr6",169231664,169232728,169232196,1064
"15584","chr1",229270899,229271382,229271140,483
"15585","chr6",27019819,27020295,27020057,476
"15586","chr17",77402202,77402445,77402323,243
"15587","chr8",22440599,22441629,22441114,1030
"15588","chr16",31117478,31117893,31117685,415
"15589","chr6",35731473,35732176,35731824,703
"15590","chr22",49999263,50000347,49999805,1084
"15591","chr15",90819215,90819428,90819321,213
"15592","chr3",119677142,119677540,119677341,398
"15593","chr6",42746969,42747304,42747136,335
"15594","chr3",180036732,180037457,180037094,725
"15595","chr15",20358729,20358956,20358842,227
"15596","chr13",18608943,18609819,18609381,876
"15597","chr17",7929214,7929846,7929530,632
"15598","chr15",82985838,82986493,82986165,655
"15599","chr19",42216674,42217980,42217327,1306
"15600","chr22",37818540,37819168,37818854,628
"15601","chr1",42463126,42463829,42463477,703
"15602","chr16",1487698,1487926,1487812,228
"15603","chr17",48597682,48598227,48597954,545
"15604","chr16",66922040,66922348,66922194,308
"15605","chr16",88018455,88018786,88018620,331
"15606","chr21",36134900,36135961,36135430,1061
"15607","chrX",74535810,74536135,74535972,325
"15608","chr4",881708,882108,881908,400
"15609","chr6",89886552,89887137,89886844,585
"15610","chr9",34370775,34372904,34371839,2129
"15611","chr6",166862232,166863056,166862644,824
"15612","chr19",55440433,55440736,55440584,303
"15613","chr13",112014934,112015975,112015454,1041
"15614","chr10",119206615,119207481,119207048,866
"15615","chr1",228646195,228648421,228647308,2226
"15616","chr2",128493062,128493730,128493396,668
"15617","chr13",48000945,48001439,48001192,494
"15618","chr19",17648366,17648601,17648483,235
"15619","chr22",37686295,37686789,37686542,494
"15620","chr3",197960048,197960463,197960255,415
"15621","chr1",231162066,231163651,231162858,1585
"15622","chr2",169364262,169364604,169364433,342
"15623","chr2",240647240,240647682,240647461,442
"15624","chr19",9435107,9435626,9435366,519
"15625","chr20",62929081,62929602,62929341,521
"15626","chr5",179698340,179699339,179698839,999
"15627","chr8",96493519,96495379,96494449,1860
"15628","chr5",132271325,132272196,132271760,871
"15629","chr2",45510,46603,46056,1093
"15630","chr2",73214185,73214689,73214437,504
"15631","chr7",157902333,157902666,157902499,333
"15632","chr17",82388721,82389174,82388947,453
"15633","chr16",86878797,86879064,86878930,267
"15634","chr17",30235369,30236168,30235768,799
"15635","chr10",43304705,43304997,43304851,292
"15636","chr19",47456848,47457560,47457204,712
"15637","chr13",112055570,112058351,112056960,2781
"15638","chr6",27807551,27808480,27808015,929
"15639","chr1",25998058,25998443,25998250,385
"15640","chr21",45001301,45001608,45001454,307
"15641","chr1",204685004,204685757,204685380,753
"15642","chr17",7740479,7740993,7740736,514
"15643","chr19",37217981,37218279,37218130,298
"15644","chr7",28409097,28409953,28409525,856
"15645","chr2",70124183,70124418,70124300,235
"15646","chr2",41840797,41841063,41840930,266
"15647","chr15",41827404,41828424,41827914,1020
"15648","chr14",103056731,103058094,103057412,1363
"15649","chr17",17236803,17237766,17237284,963
"15650","chr19",16111302,16112342,16111822,1040
"15651","chr4",78775553,78776804,78776178,1251
"15652","chr10",132547355,132547580,132547467,225
"15653","chr19",506526,507133,506829,607
"15654","chrX",119235899,119237010,119236454,1111
"15655","chr20",36839238,36839446,36839342,208
"15656","chr20",51523151,51524001,51523576,850
"15657","chr19",40530483,40530830,40530656,347
"15658","chr16",30775297,30776143,30775720,846
"15659","chr3",38453597,38455660,38454628,2063
"15660","chr15",27541572,27541914,27541743,342
"15661","chr13",114070591,114071045,114070818,454
"15662","chr11",72752047,72752672,72752359,625
"15663","chr19",3572547,3574554,3573550,2007
"15664","chr1",161605744,161607118,161606431,1374
"15665","chr3",44510396,44510667,44510531,271
"15666","chr10",128541262,128541513,128541387,251
"15667","chr4",25676186,25676510,25676348,324
"15668","chr1",6142058,6142299,6142178,241
"15669","chr19",1940304,1941941,1941122,1637
"15670","chr20",297190,298511,297850,1321
"15671","chrX",21857260,21857520,21857390,260
"15672","chr19",12194737,12195489,12195113,752
"15673","chr16",825105,825589,825347,484
"15674","chr4",140150796,140151657,140151226,861
"15675","chr15",70033853,70034084,70033968,231
"15676","chr19",8498557,8499341,8498949,784
"15677","chr19",54449013,54449804,54449408,791
"15678","chr21",34888153,34891390,34889771,3237
"15679","chr15",64703003,64703497,64703250,494
"15680","chr17",42387819,42388757,42388288,938
"15681","chr21",44709476,44709774,44709625,298
"15682","chr16",632634,637481,635057,4847
"15683","chr7",128166624,128168796,128167710,2172
"15684","chrX",153647037,153648224,153647630,1187
"15685","chr20",45316481,45317021,45316751,540
"15686","chr7",100538825,100539592,100539208,767
"15687","chr7",120275008,120275431,120275219,423
"15688","chr20",31587654,31588255,31587954,601
"15689","chr19",23273772,23274066,23273919,294
"15690","chr19",41264108,41265208,41264658,1100
"15691","chr7",100620888,100621100,100620994,212
"15692","chr7",74338489,74339013,74338751,524
"15693","chr6",157020926,157022258,157021592,1332
"15694","chr17",9645072,9646299,9645685,1227
"15695","chr15",34582660,34584224,34583442,1564
"15696","chr19",58544009,58545115,58544562,1106
"15697","chr4",140523945,140524544,140524244,599
"15698","chr8",7686351,7686863,7686607,512
"15699","chr1",168178725,168179399,168179062,674
"15700","chr17",4584103,4585187,4584645,1084
"15701","chr16",543299,543500,543399,201
"15702","chr2",183260615,183260855,183260735,240
"15703","chr12",22046128,22046655,22046391,527
"15704","chr17",714515,715319,714917,804
"15705","chr15",44194543,44195662,44195102,1119
"15706","chr15",59105071,59105550,59105310,479
"15707","chr22",43109945,43110161,43110053,216
"15708","chr17",40093007,40093350,40093178,343
"15709","chr1",77682532,77683733,77683132,1201
"15710","chr4",140150369,140150666,140150517,297
"15711","chr13",112886036,112886244,112886140,208
"15712","chrX",119757960,119759564,119758762,1604
"15713","chr9",38487605,38488287,38487946,682
"15714","chr2",112159533,112159898,112159715,365
"15715","chr1",116152043,116152362,116152202,319
"15716","chr21",44872794,44874829,44873811,2035
"15717","chr13",110812391,110813641,110813016,1250
"15718","chr6",30100715,30101017,30100866,302
"15719","chr10",102410411,102411115,102410763,704
"15720","chr14",55051413,55052239,55051826,826
"15721","chr4",784873,786804,785838,1931
"15722","chr12",132328863,132329990,132329426,1127
"15723","chr16",35506441,35506991,35506716,550
"15724","chr6",2891695,2891948,2891821,253
"15725","chr6",170212957,170213322,170213139,365
"15726","chr16",71845860,71846393,71846126,533
"15727","chr6",108260512,108261465,108260988,953
"15728","chr4",2430071,2430601,2430336,530
"15729","chr20",34111451,34112475,34111963,1024
"15730","chr17",7314856,7315641,7315248,785
"15731","chr16",2038752,2038997,2038874,245
"15732","chr22",38316679,38317277,38316978,598
"15733","chr16",1319052,1319524,1319288,472
"15734","chr10",42111033,42113380,42112206,2347
"15735","chr1",58903699,58904228,58903963,529
"15736","chr12",124814928,124815328,124815128,400
"15737","chr19",10142029,10142241,10142135,212
"15738","chr21",43826370,43826609,43826489,239
"15739","chr5",177362977,177363252,177363114,275
"15740","chr10",43137518,43138774,43138146,1256
"15741","chr3",181695226,181696234,181695730,1008
"15742","chr17",44503009,44503678,44503343,669
"15743","chr10",46911235,46911769,46911502,534
"15744","chr3",107522998,107523884,107523441,886
"15745","chr9",37464817,37466572,37465694,1755
"15746","chr15",67542448,67543172,67542810,724
"15747","chr21",31343729,31344170,31343949,441
"15748","chr6",95577365,95578166,95577765,801
"15749","chr6",166253349,166254053,166253701,704
"15750","chr9",137221534,137224014,137222774,2480
"15751","chr16",1385192,1385582,1385387,390
"15752","chr11",63670829,63671842,63671335,1013
"15753","chr4",102344470,102345628,102345049,1158
"15754","chr17",82036904,82037933,82037418,1029
"15755","chr13",21319017,21319466,21319241,449
"15756","chr7",157468244,157468527,157468385,283
"15757","chr16",10878925,10879448,10879186,523
"15758","chr21",44293626,44293930,44293778,304
"15759","chr3",38138366,38139198,38138782,832
"15760","chr2",88691451,88692069,88691760,618
"15761","chr7",118214074,118214667,118214370,593
"15762","chr10",101843409,101843669,101843539,260
"15763","chr7",139133641,139133852,139133746,211
"15764","chr9",126722562,126723608,126723085,1046
"15765","chr6",7229644,7230632,7230138,988
"15766","chr15",90930084,90930362,90930223,278
"15767","chr15",79923016,79924158,79923587,1142
"15768","chr6",167951836,167952048,167951942,212
"15769","chr11",64291336,64292646,64291991,1310
"15770","chr17",29592856,29594087,29593471,1231
"15771","chr3",121545622,121546096,121545859,474
"15772","chr4",6105403,6105910,6105656,507
"15773","chr4",686258,686577,686417,319
"15774","chr8",123156799,123157209,123157004,410
"15775","chr7",107169016,107169884,107169450,868
"15776","chr12",57737087,57738951,57738019,1864
"15777","chr12",130933397,130933673,130933535,276
"15778","chr1",2428487,2428728,2428607,241
"15779","chr10",72297677,72298279,72297978,602
"15780","chr9",136192667,136194246,136193456,1579
"15781","chr20",64048071,64049979,64049025,1908
"15782","chr2",26245302,26245539,26245420,237
"15783","chr2",231961367,231962126,231961746,759
"15784","chr16",30445409,30445750,30445579,341
"15785","chr8",1033687,1036272,1034979,2585
"15786","chr16",70685211,70686538,70685874,1327
"15787","chr12",49741246,49742260,49741753,1014
"15788","chr12",111405134,111406588,111405861,1454
"15789","chr8",115648205,115648520,115648362,315
"15790","chr3",42905988,42906678,42906333,690
"15791","chr1",156848910,156849400,156849155,490
"15792","chr2",177263545,177265119,177264332,1574
"15793","chr3",32570208,32571271,32570739,1063
"15794","chr17",3723630,3724545,3724087,915
"15795","chr6",27260321,27260585,27260453,264
"15796","chr15",30044441,30044933,30044687,492
"15797","chr4",8373315,8373615,8373465,300
"15798","chr16",29082044,29082512,29082278,468
"15799","chr5",88672817,88673089,88672953,272
"15800","chr17",76471745,76472074,76471909,329
"15801","chr6",83065655,83066047,83065851,392
"15802","chrX",74105329,74105687,74105508,358
"15803","chr6",33193168,33193560,33193364,392
"15804","chr7",157684194,157686254,157685224,2060
"15805","chr21",38805078,38806743,38805910,1665
"15806","chr17",3892357,3893401,3892879,1044
"15807","chr7",152131270,152131557,152131413,287
"15808","chr10",73495275,73495817,73495546,542
"15809","chr1",21668570,21669450,21669010,880
"15810","chr7",150404818,150405880,150405349,1062
"15811","chr3",89114485,89114957,89114721,472
"15812","chr11",18526513,18527082,18526797,569
"15813","chr9",134011887,134014625,134013256,2738
"15814","chr15",100350037,100350289,100350163,252
"15815","chr10",398969,399191,399080,222
"15816","chr3",58009194,58009491,58009342,297
"15817","chr22",29071303,29071829,29071566,526
"15818","chr7",100687265,100687532,100687398,267
"15819","chr15",75178570,75178864,75178717,294
"15820","chr6",149316882,149318382,149317632,1500
"15821","chr2",44932754,44932973,44932863,219
"15822","chr17",60042391,60043067,60042729,676
"15823","chr20",57264231,57264710,57264470,479
"15824","chr15",59206760,59207139,59206949,379
"15825","chr22",45975589,45979354,45977471,3765
"15826","chr8",142315903,142316123,142316013,220
"15827","chr13",114040243,114041024,114040633,781
"15828","chr17",5111410,5112061,5111735,651
"15829","chr9",97741271,97741734,97741502,463
"15830","chr3",134795488,134797138,134796313,1650
"15831","chr16",85650501,85650885,85650693,384
"15832","chr10",110207670,110210965,110209317,3295
"15833","chr14",103188904,103189770,103189337,866
"15834","chr12",117046500,117046822,117046661,322
"15835","chr12",120584513,120584901,120584707,388
"15836","chr9",19230225,19231320,19230772,1095
"15837","chr1",23979873,23980527,23980200,654
"15838","chr7",75994039,75994846,75994442,807
"15839","chrX",130268484,130269114,130268799,630
"15840","chr1",205430602,205430853,205430727,251
"15841","chrX",24313526,24314230,24313878,704
"15842","chr10",71212318,71214138,71213228,1820
"15843","chr10",49768301,49769091,49768696,790
"15844","chr1",18902334,18903140,18902737,806
"15845","chr16",1022638,1023068,1022853,430
"15846","chrX",101098020,101098287,101098153,267
"15847","chr8",141307729,141308442,141308085,713
"15848","chr20",3204228,3204739,3204483,511
"15849","chr12",124543586,124543832,124543709,246
"15850","chr5",42950974,42952308,42951641,1334
"15851","chr3",49357422,49358509,49357965,1087
"15852","chr1",162822386,162822784,162822585,398
"15853","chr4",997103,997837,997470,734
"15854","chr15",88894945,88895619,88895282,674
"15855","chr16",2002208,2002717,2002462,509
"15856","chr10",27242009,27242434,27242221,425
"15857","chr6",168795872,168796091,168795981,219
"15858","chr9",34628798,34629064,34628931,266
"15859","chr11",66420863,66421926,66421394,1063
"15860","chrX",153807099,153807340,153807219,241
"15861","chr11",2137721,2141254,2139487,3533
"15862","chr11",117143983,117144844,117144413,861
"15863","chr15",90954764,90955385,90955074,621
"15864","chr5",38556120,38557461,38556790,1341
"15865","chr5",140870149,140871364,140870756,1215
"15866","chr5",602009,602438,602223,429
"15867","chr20",10034962,10035266,10035114,304
"15868","chr2",70301476,70302205,70301840,729
"15869","chr11",44519987,44520406,44520196,419
"15870","chr17",43900554,43900762,43900658,208
"15871","chrX",151396739,151397393,151397066,654
"15872","chr11",133918337,133918619,133918478,282
"15873","chr11",61281621,61281935,61281778,314
"15874","chr7",55344272,55345303,55344787,1031
"15875","chr17",37489184,37490377,37489780,1193
"15876","chr6",27472834,27473286,27473060,452
"15877","chr4",110620906,110623308,110622107,2402
"15878","chr16",75555789,75556461,75556125,672
"15879","chr7",157560301,157560538,157560419,237
"15880","chr19",49594487,49594814,49594650,327
"15881","chrX",19121819,19122976,19122397,1157
"15882","chr19",450801,451376,451088,575
"15883","chr12",50111597,50112452,50112024,855
"15884","chr7",66413476,66413990,66413733,514
"15885","chr2",32039733,32039950,32039841,217
"15886","chrX",130902773,130903184,130902978,411
"15887","chr7",73297939,73298169,73298054,230
"15888","chr2",27378474,27378809,27378641,335
"15889","chr10",321529,323476,322502,1947
"15890","chr11",18698534,18699274,18698904,740
"15891","chr10",49941466,49942365,49941915,899
"15892","chr19",1854575,1854864,1854719,289
"15893","chr3",13854494,13854808,13854651,314
"15894","chr11",589803,590121,589962,318
"15895","chrX",103215012,103215491,103215251,479
"15896","chr11",68448821,68449079,68448950,258
"15897","chr3",32391612,32392670,32392141,1058
"15898","chrX",146619275,146620763,146620019,1488
"15899","chr16",23452669,23453308,23452988,639
"15900","chrX",57137213,57137435,57137324,222
"15901","chr5",146345723,146346289,146346006,566
"15902","chr2",215435544,215436137,215435840,593
"15903","chr3",184583329,184584346,184583837,1017
"15904","chr10",133017017,133018705,133017861,1688
"15905","chr11",67303266,67304330,67303798,1064
"15906","chr3",40452923,40453408,40453165,485
"15907","chr1",40884068,40884621,40884344,553
"15908","chr12",121352167,121352471,121352319,304
"15909","chr3",147412555,147412790,147412672,235
"15910","chr2",236237676,236237933,236237804,257
"15911","chr5",523561,524680,524120,1119
"15912","chr17",47423414,47424341,47423877,927
"15913","chr19",49064904,49065189,49065046,285
"15914","chr16",46621090,46621462,46621276,372
"15915","chr3",48088435,48089406,48088920,971
"15916","chrX",21856143,21856707,21856425,564
"15917","chr5",164595,166543,165569,1948
"15918","chr22",37324678,37325195,37324936,517
"15919","chr11",126211474,126212133,126211803,659
"15920","chr1",207052936,207053497,207053216,561
"15921","chr19",52734339,52735246,52734792,907
"15922","chr17",17303213,17303824,17303518,611
"15923","chr20",62394711,62395055,62394883,344
"15924","chr11",128451766,128452000,128451883,234
"15925","chr3",138944876,138947565,138946220,2689
"15926","chr2",239728304,239728511,239728407,207
"15927","chr17",72591632,72592941,72592286,1309
"15928","chr7",65038008,65039051,65038529,1043
"15929","chr1",37761407,37762069,37761738,662
"15930","chr19",18446228,18446474,18446351,246
"15931","chr19",996075,996680,996377,605
"15932","chr10",103854753,103855736,103855244,983
"15933","chr17",63476576,63477648,63477112,1072
"15934","chr19",50402220,50402812,50402516,592
"15935","chr10",22340431,22341399,22340915,968
"15936","chr4",56530582,56531103,56530842,521
"15937","chr18",4453969,4455647,4454808,1678
"15938","chr19",55592362,55593605,55592983,1243
"15939","chr3",141487017,141487918,141487467,901
"15940","chr6",25882099,25882332,25882215,233
"15941","chr19",49196441,49196813,49196627,372
"15942","chr2",219309148,219309561,219309354,413
"15943","chr6",13614669,13615671,13615170,1002
"15944","chr19",44212308,44212562,44212435,254
"15945","chr19",51571058,51571283,51571170,225
"15946","chrX",125202921,125203142,125203031,221
"15947","chr16",69329694,69330932,69330313,1238
"15948","chr2",11592715,11593177,11592946,462
"15949","chr19",17455723,17455969,17455846,246
"15950","chr19",36916029,36916561,36916295,532
"15951","chr11",119067482,119068104,119067793,622
"15952","chr11",69082417,69083083,69082750,666
"15953","chr3",122384004,122384351,122384177,347
"15954","chr7",5356241,5356669,5356455,428
"15955","chr4",847862,848082,847972,220
"15956","chr1",150067267,150067758,150067512,491
"15957","chr2",231395389,231396423,231395906,1034
"15958","chr2",189783840,189784758,189784299,918
"15959","chr10",121974512,121975062,121974787,550
"15960","chr5",146338726,146340532,146339629,1806
"15961","chr6",99590779,99591601,99591190,822
"15962","chr6",69796400,69797132,69796766,732
"15963","chr17",81941143,81941615,81941379,472
"15964","chr19",1816027,1816785,1816406,758
"15965","chr14",88792052,88793243,88792647,1191
"15966","chr2",113277017,113278464,113277740,1447
"15967","chr16",89286120,89286331,89286225,211
"15968","chr5",179137773,179137976,179137874,203
"15969","chr17",4263410,4264058,4263734,648
"15970","chr22",17748639,17748840,17748739,201
"15971","chr15",43493045,43493292,43493168,247
"15972","chr19",48728899,48729568,48729233,669
"15973","chr8",144115350,144116534,144115942,1184
"15974","chr7",135246307,135246758,135246532,451
"15975","chr6",29850308,29850564,29850436,256
"15976","chr17",48733210,48733583,48733396,373
"15977","chr2",101473908,101474668,101474288,760
"15978","chr17",51259741,51261222,51260481,1481
"15979","chr19",3801394,3801821,3801607,427
"15980","chr13",111844553,111844873,111844713,320
"15981","chr16",11493763,11494096,11493929,333
"15982","chr4",154743667,154744681,154744174,1014
"15983","chr12",15221052,15221580,15221316,528
"15984","chr7",102572420,102572815,102572617,395
"15985","chr19",867904,868301,868102,397
"15986","chr2",239111451,239111757,239111604,306
"15987","chr7",129785646,129786019,129785832,373
"15988","chr12",121918409,121918947,121918678,538
"15989","chr1",155562495,155563489,155562992,994
"15990","chr19",11549484,11549706,11549595,222
"15991","chr1",26993636,26994655,26994145,1019
"15992","chr1",180935180,180935575,180935377,395
"15993","chr9",6715976,6716503,6716239,527
"15994","chr15",40807045,40807680,40807362,635
"15995","chr6",41921130,41921825,41921477,695
"15996","chr19",46513591,46513861,46513726,270
"15997","chr1",64469871,64470931,64470401,1060
"15998","chr12",102950620,102950862,102950741,242
"15999","chr1",87335152,87335549,87335350,397
"16000","chr10",91908245,91909014,91908629,769
"16001","chr12",98515274,98516483,98515878,1209
"16002","chr1",27356786,27357099,27356942,313
"16003","chr3",160399224,160401090,160400157,1866
"16004","chr4",9474375,9474651,9474513,276
"16005","chr9",131026358,131026569,131026463,211
"16006","chr6",168075640,168076181,168075910,541
"16007","chr19",18831623,18832749,18832186,1126
"16008","chr5",123035874,123037127,123036500,1253
"16009","chr6",1601389,1601903,1601646,514
"16010","chr19",18149489,18149715,18149602,226
"16011","chr5",65624087,65624461,65624274,374
"16012","chr3",63911716,63912840,63912278,1124
"16013","chr1",244652897,244653778,244653337,881
"16014","chr1",204981854,204982082,204981968,228
"16015","chr6",34544286,34544489,34544387,203
"16016","chr4",1624910,1625826,1625368,916
"16017","chr5",6632627,6634049,6633338,1422
"16018","chr17",32349982,32350441,32350211,459
"16019","chr2",177552567,177553233,177552900,666
"16020","chr16",29790375,29790997,29790686,622
"16021","chr1",27321962,27322515,27322238,553
"16022","chr3",194070692,194071477,194071084,785
"16023","chr17",27793343,27793918,27793630,575
"16024","chr9",136132470,136133045,136132757,575
"16025","chr1",167439275,167439900,167439587,625
"16026","chr1",246506846,246507466,246507156,620
"16027","chr19",7488813,7489147,7488980,334
"16028","chr7",191875,193799,192837,1924
"16029","chr1",32972857,32973378,32973117,521
"16030","chr19",44643774,44644421,44644097,647
"16031","chr8",85774772,85776599,85775685,1827
"16032","chr7",76549224,76550170,76549697,946
"16033","chr5",87267540,87267797,87267668,257
"16034","chr1",116168216,116168639,116168427,423
"16035","chr2",231680637,231681433,231681035,796
"16036","chr20",21510655,21513742,21512198,3087
"16037","chr19",55160655,55161844,55161249,1189
"16038","chr3",19148196,19148608,19148402,412
"16039","chrX",37905764,37906004,37905884,240
"16040","chr11",68411450,68411694,68411572,244
"16041","chr7",102749033,102749466,102749249,433
"16042","chr4",26319511,26321528,26320519,2017
"16043","chr6",168840117,168841395,168840756,1278
"16044","chr1",54805992,54806299,54806145,307
"16045","chr7",44104293,44104912,44104602,619
"16046","chr7",100673252,100676380,100674816,3128
"16047","chr11",16613410,16614422,16613916,1012
"16048","chr12",107903649,107903966,107903807,317
"16049","chr4",26857250,26857786,26857518,536
"16050","chr9",134025341,134026326,134025833,985
"16051","chr16",87779227,87779464,87779345,237
"16052","chr9",15552735,15553336,15553035,601
"16053","chr17",7786827,7787093,7786960,266
"16054","chr19",4759806,4760050,4759928,244
"16055","chr12",124466159,124466393,124466276,234
"16056","chr2",55617131,55617930,55617530,799
"16057","chr5",141201150,141202052,141201601,902
"16058","chr19",10701341,10701779,10701560,438
"16059","chr17",2704441,2704711,2704576,270
"16060","chr4",84501776,84502037,84501906,261
"16061","chr15",75023514,75023837,75023675,323
"16062","chr6",4078818,4079487,4079152,669
"16063","chr1",53889574,53889983,53889778,409
"16064","chr8",43093389,43093785,43093587,396
"16065","chr4",78057211,78058102,78057656,891
"16066","chr1",79006596,79006852,79006724,256
"16067","chr9",19027852,19028066,19027959,214
"16068","chr19",401970,402280,402125,310
"16069","chr16",62853,63164,63008,311
"16070","chr10",132490803,132491111,132490957,308
"16071","chr16",2610771,2610977,2610874,206
"16072","chr2",91839805,91840396,91840100,591
"16073","chr22",37373130,37375404,37374267,2274
"16074","chr12",66169422,66170165,66169793,743
"16075","chr19",45238616,45238889,45238752,273
"16076","chr16",52547443,52547698,52547570,255
"16077","chr6",169701566,169702963,169702264,1397
"16078","chrX",104040090,104040397,104040243,307
"16079","chr17",80260142,80261484,80260813,1342
"16080","chr13",112838172,112838522,112838347,350
"16081","chr13",50123848,50128150,50125999,4302
"16082","chr3",68931632,68932884,68932258,1252
"16083","chr2",176099334,176100781,176100057,1447
"16084","chr1",13554915,13555117,13555016,202
"16085","chr17",48593160,48594096,48593628,936
"16086","chr19",9538258,9538734,9538496,476
"16087","chr8",61139087,61139872,61139479,785
"16088","chr5",122845268,122845986,122845627,718
"16089","chr12",125533554,125533819,125533686,265
"16090","chr17",28952317,28952651,28952484,334
"16091","chr4",8386668,8386944,8386806,276
"16092","chr12",76083937,76085351,76084644,1414
"16093","chr7",55449178,55449556,55449367,378
"16094","chr9",121698688,121699911,121699299,1223
"16095","chr22",28772640,28772994,28772817,354
"16096","chr11",12377610,12378316,12377963,706
"16097","chr3",150408185,150410902,150409543,2717
"16098","chr2",197453243,197453907,197453575,664
"16099","chr8",22668785,22669244,22669014,459
"16100","chr20",26208002,26209712,26208857,1710
"16101","chr19",10431986,10432444,10432215,458
"16102","chr11",68021575,68021871,68021723,296
"16103","chr9",133148836,133149725,133149280,889
"16104","chr22",21665843,21666363,21666103,520
"16105","chr8",713998,714794,714396,796
"16106","chr19",10252095,10252708,10252401,613
"16107","chr4",1540681,1540928,1540804,247
"16108","chr12",112125380,112125984,112125682,604
"16109","chr3",13479412,13480359,13479885,947
"16110","chr11",1276779,1277246,1277012,467
"16111","chr7",99374026,99375547,99374786,1521
"16112","chr3",133805724,133806355,133806039,631
"16113","chr6",5998916,5999730,5999323,814
"16114","chr9",75027788,75028679,75028233,891
"16115","chr7",933486,934252,933869,766
"16116","chr7",157400226,157400461,157400343,235
"16117","chr3",57227427,57228570,57227998,1143
"16118","chr16",1460881,1461422,1461151,541
"16119","chr7",73842374,73842596,73842485,222
"16120","chr17",18781212,18781696,18781454,484
"16121","chrX",41332721,41335025,41333873,2304
"16122","chr1",224330027,224330491,224330259,464
"16123","chr11",134253315,134254102,134253708,787
"16124","chr4",3642042,3642557,3642299,515
"16125","chr20",31547273,31547489,31547381,216
"16126","chr15",72685949,72686417,72686183,468
"16127","chr3",12287495,12288834,12288164,1339
"16128","chr20",62860767,62862274,62861520,1507
"16129","chr14",104977730,104978888,104978309,1158
"16130","chr1",155172866,155173462,155173164,596
"16131","chr2",230827982,230828781,230828381,799
"16132","chrX",73563109,73563329,73563219,220
"16133","chr19",51098565,51099184,51098874,619
"16134","chr9",133144321,133144747,133144534,426
"16135","chr4",131723192,131723568,131723380,376
"16136","chr2",7032165,7032381,7032273,216
"16137","chr19",34838819,34839277,34839048,458
"16138","chr1",84996902,84997752,84997327,850
"16139","chr2",216013176,216013629,216013402,453
"16140","chr2",176151688,176152761,176152224,1073
"16141","chr5",102755745,102755962,102755853,217
"16142","chr12",94147951,94150224,94149087,2273
"16143","chr5",114361143,114363498,114362320,2355
"16144","chr1",40691490,40692303,40691896,813
"16145","chr20",63920269,63920561,63920415,292
"16146","chrX",104166240,104167111,104166675,871
"16147","chr17",38825120,38825497,38825308,377
"16148","chr11",65961303,65962176,65961739,873
"16149","chr19",1110400,1110695,1110547,295
"16150","chr22",26756734,26757170,26756952,436
"16151","chr17",18006825,18007154,18006989,329
"16152","chr3",128432813,128433337,128433075,524
"16153","chr17",1997832,1998903,1998367,1071
"16154","chr20",63411910,63412231,63412070,321
"16155","chr11",66042523,66043640,66043081,1117
"16156","chr2",10913535,10913826,10913680,291
"16157","chr1",109483831,109484281,109484056,450
"16158","chr22",39388349,39389099,39388724,750
"16159","chr5",140857277,140858306,140857791,1029
"16160","chr1",228109095,228109575,228109335,480
"16161","chr4",41747167,41747794,41747480,627
"16162","chr16",2234115,2234345,2234230,230
"16163","chr8",134831455,134832825,134832140,1370
"16164","chr10",62268282,62268947,62268614,665
"16165","chr13",41311115,41312060,41311587,945
"16166","chr2",9474065,9475106,9474585,1041
"16167","chr15",72117521,72118661,72118091,1140
"16168","chr17",79131323,79131524,79131423,201
"16169","chr1",46612908,46613295,46613101,387
"16170","chr1",155254833,155255864,155255348,1031
"16171","chr1",3323351,3323697,3323524,346
"16172","chr11",3120412,3120647,3120529,235
"16173","chr5",141343981,141344333,141344157,352
"16174","chr8",15540127,15540778,15540452,651
"16175","chr2",172234754,172235012,172234883,258
"16176","chr19",12266007,12266505,12266256,498
"16177","chr19",2488289,2488572,2488430,283
"16178","chrX",71872622,71873346,71872984,724
"16179","chr19",35744906,35745647,35745276,741
"16180","chr10",129958426,129960523,129959474,2097
"16181","chr8",125431990,125432198,125432094,208
"16182","chr6",26196842,26197309,26197075,467
"16183","chr1",41366304,41366870,41366587,566
"16184","chr1",54499350,54499718,54499534,368
"16185","chr1",10659810,10660524,10660167,714
"16186","chr1",56644990,56645564,56645277,574
"16187","chr16",70113763,70114856,70114309,1093
"16188","chr1",22052516,22053536,22053026,1020
"16189","chr10",125151222,125152465,125151843,1243
"16190","chr10",108466169,108466707,108466438,538
"16191","chr5",138032416,138033033,138032724,617
"16192","chr19",53192776,53193397,53193086,621
"16193","chr1",166884016,166884553,166884284,537
"16194","chr5",133026131,133026821,133026476,690
"16195","chr1",107964629,107965419,107965024,790
"16196","chr7",1323175,1324007,1323591,832
"16197","chr6",99603142,99604096,99603619,954
"16198","chr1",184973730,184974645,184974187,915
"16199","chr8",144108130,144110564,144109347,2434
"16200","chr22",50220564,50220971,50220767,407
"16201","chr14",76761226,76762348,76761787,1122
"16202","chr11",47848241,47848804,47848522,563
"16203","chr19",43774121,43774625,43774373,504
"16204","chr9",707021,707420,707220,399
"16205","chr19",30719610,30719977,30719793,367
"16206","chr3",187698723,187698938,187698830,215
"16207","chr10",133423183,133425243,133424213,2060
"16208","chr11",45649647,45650862,45650254,1215
"16209","chr7",76959681,76960291,76959986,610
"16210","chr1",161258687,161259238,161258962,551
"16211","chrX",36985437,36986451,36985944,1014
"16212","chr20",35434209,35434704,35434456,495
"16213","chrY",12904633,12905387,12905010,754
"16214","chr16",1204801,1205081,1204941,280
"16215","chr8",116755691,116755900,116755795,209
"16216","chr19",11987756,11988135,11987945,379
"16217","chr9",35657755,35658780,35658267,1025
"16218","chr11",134411486,134413025,134412255,1539
"16219","chr19",50666402,50668888,50667645,2486
"16220","chr12",131044752,131045342,131045047,590
"16221","chr1",165827416,165828446,165827931,1030
"16222","chr3",62376935,62377407,62377171,472
"16223","chr20",36745897,36746251,36746074,354
"16224","chr6",79077095,79078620,79077857,1525
"16225","chr9",136455071,136455353,136455212,282
"16226","chr12",19129391,19130967,19130179,1576
"16227","chr9",136399634,136400361,136399997,727
"16228","chr1",1918659,1919952,1919305,1293
"16229","chr19",32674360,32677193,32675776,2833
"16230","chr3",15205939,15206813,15206376,874
"16231","chr10",103660927,103661198,103661062,271
"16232","chr1",2305003,2307630,2306316,2627
"16233","chr1",155208756,155209168,155208962,412
"16234","chr4",52051222,52052114,52051668,892
"16235","chr1",160261965,160262661,160262313,696
"16236","chr1",156893623,156893919,156893771,296
"16237","chr11",62337307,62338164,62337735,857
"16238","chr1",15837257,15837628,15837442,371
"16239","chr1",6497090,6497812,6497451,722
"16240","chr9",98056447,98057086,98056766,639
"16241","chr13",22696441,22696780,22696610,339
"16242","chr11",46936619,46936842,46936730,223
"16243","chrX",154436415,154437719,154437067,1304
"16244","chr11",489247,490115,489681,868
"16245","chr2",16013822,16014297,16014059,475
"16246","chr12",95473808,95474243,95474025,435
"16247","chr17",40818808,40819208,40819008,400
"16248","chr10",987850,988675,988262,825
"16249","chr17",75855179,75856141,75855660,962
"16250","chr7",76281434,76283178,76282306,1744
"16251","chr17",58692504,58692934,58692719,430
"16252","chr10",73252368,73252773,73252570,405
"16253","chr10",100529393,100529985,100529689,592
"16254","chr2",99336025,99337937,99336981,1912
"16255","chr10",114100920,114101334,114101127,414
"16256","chr6",110357651,110358630,110358140,979
"16257","chr1",3073466,3074154,3073810,688
"16258","chr1",46203149,46203586,46203367,437
"16259","chr19",3805861,3806174,3806017,313
"16260","chr19",7943164,7944079,7943621,915
"16261","chr11",67468793,67469482,67469137,689
"16262","chr8",73092786,73093621,73093203,835
"16263","chr11",133787728,133787949,133787838,221
"16264","chr19",6659875,6660083,6659979,208
"16265","chr2",73112164,73113605,73112884,1441
"16266","chr20",4172219,4172751,4172485,532
"16267","chr20",58649639,58651266,58650452,1627
"16268","chr11",119030276,119031039,119030657,763
"16269","chr17",65536837,65537815,65537326,978
"16270","chr5",93620614,93621634,93621124,1020
"16271","chr1",9715650,9715939,9715794,289
"16272","chr16",88771704,88772051,88771877,347
"16273","chr10",29409433,29410115,29409774,682
"16274","chr1",23167746,23168947,23168346,1201
"16275","chr19",45506520,45508034,45507277,1514
"16276","chr15",101250946,101252509,101251727,1563
"16277","chr11",32090848,32091731,32091289,883
"16278","chr14",73136190,73137039,73136614,849
"16279","chr3",75658472,75659047,75658759,575
"16280","chr13",113033107,113033514,113033310,407
"16281","chr19",4584170,4585160,4584665,990
"16282","chr19",5455470,5456251,5455860,781
"16283","chr1",229342162,229343188,229342675,1026
"16284","chr1",236141458,236141725,236141591,267
"16285","chr11",534691,537718,536204,3027
"16286","chr5",172006000,172007078,172006539,1078
"16287","chr1",94237134,94237788,94237461,654
"16288","chr12",6927538,6928761,6928149,1223
"16289","chr1",1213675,1214144,1213909,469
"16290","chr17",4785333,4786268,4785800,935
"16291","chr7",39622944,39624193,39623568,1249
"16292","chr11",30584011,30584253,30584132,242
"16293","chr17",1606588,1606807,1606697,219
"16294","chr16",1413761,1414772,1414266,1011
"16295","chr19",57363389,57363742,57363565,353
"16296","chr11",114058911,114061468,114060189,2557
"16297","chr3",51390981,51392168,51391574,1187
"16298","chr2",239178929,239179156,239179042,227
"16299","chr11",112086628,112086957,112086792,329
"16300","chr16",32884867,32886501,32885684,1634
"16301","chr17",15699464,15700001,15699732,537
"16302","chr4",2275792,2276182,2275987,390
"16303","chr22",38074256,38074477,38074366,221
"16304","chr3",168249458,168250342,168249900,884
"16305","chr17",81859993,81861423,81860708,1430
"16306","chr20",50510080,50510898,50510489,818
"16307","chr22",45202840,45203199,45203019,359
"16308","chr17",55561301,55561603,55561452,302
"16309","chr18",10525844,10526436,10526140,592
"16310","chr5",43017866,43018566,43018216,700
"16311","chr17",63941663,63941959,63941811,296
"16312","chr16",80803427,80804963,80804195,1536
"16313","chr3",130893441,130894641,130894041,1200
"16314","chr12",109097459,109098626,109098042,1167
"16315","chr1",206557069,206557580,206557324,511
"16316","chr1",54715672,54716180,54715926,508
"16317","chr19",58037937,58038344,58038140,407
"16318","chr15",50424124,50424629,50424376,505
"16319","chr17",41968215,41968453,41968334,238
"16320","chr8",120811175,120812480,120811827,1305
"16321","chr4",1023736,1025150,1024443,1414
"16322","chr22",37804665,37805684,37805174,1019
"16323","chr11",119381420,119381854,119381637,434
"16324","chr16",1474519,1475533,1475026,1014
"16325","chr12",5827710,5827919,5827814,209
"16326","chr11",46845643,46846526,46846084,883
"16327","chr6",125099597,125099995,125099796,398
"16328","chr1",7783400,7785044,7784222,1644
"16329","chr19",33684438,33684862,33684650,424
"16330","chr16",291081,291421,291251,340
"16331","chr21",44133139,44134155,44133647,1016
"16332","chr10",133403059,133403352,133403205,293
"16333","chr16",35196404,35196633,35196518,229
"16334","chr17",43399902,43400114,43400008,212
"16335","chr1",87131860,87132832,87132346,972
"16336","chr19",17302924,17303677,17303300,753
"16337","chr17",3867990,3868382,3868186,392
"16338","chr11",2399810,2401244,2400527,1434
"16339","chr2",118855455,118857989,118856722,2534
"16340","chr9",5832579,5833261,5832920,682
"16341","chr8",97775607,97776646,97776126,1039
"16342","chr13",22926110,22927259,22926684,1149
"16343","chr16",2195865,2197099,2196482,1234
"16344","chr12",125025023,125025269,125025146,246
"16345","chr3",133746105,133746576,133746340,471
"16346","chr10",1464149,1464513,1464331,364
"16347","chr20",21705561,21707051,21706306,1490
"16348","chr19",18202538,18202767,18202652,229
"16349","chr11",33161441,33161718,33161579,277
"16350","chr4",55346127,55346896,55346511,769
"16351","chr15",90387930,90388787,90388358,857
"16352","chr1",160031505,160032199,160031852,694
"16353","chr6",128580408,128580780,128580594,372
"16354","chr4",73981811,73982113,73981962,302
"16355","chr11",64207357,64207576,64207466,219
"16356","chr10",3556283,3556738,3556510,455
"16357","chr3",133783717,133784119,133783918,402
"16358","chr15",74245468,74245743,74245605,275
"16359","chr9",137069703,137070832,137070267,1129
"16360","chr5",72417440,72418032,72417736,592
"16361","chr16",1983491,1984799,1984145,1308
"16362","chr14",60642236,60643068,60642652,832
"16363","chr19",18428971,18429531,18429251,560
"16364","chr19",53979767,53980318,53980042,551
"16365","chr20",9506464,9506827,9506645,363
"16366","chr10",114938134,114938617,114938375,483
"16367","chr8",53879285,53882581,53880933,3296
"16368","chr19",57435126,57435823,57435474,697
"16369","chr16",990965,991365,991165,400
"16370","chr15",65517347,65517830,65517588,483
"16371","chr8",48735143,48735429,48735286,286
"16372","chr3",45795988,45796764,45796376,776
"16373","chr8",144624500,144626613,144625556,2113
"16374","chr19",7730038,7731524,7730781,1486
"16375","chr19",6110055,6110867,6110461,812
"16376","chr20",44960079,44960542,44960310,463
"16377","chr16",87765517,87766141,87765829,624
"16378","chr8",41701737,41702091,41701914,354
"16379","chr22",39349655,39350629,39350142,974
"16380","chr6",29632264,29633378,29632821,1114
"16381","chr17",7478947,7479884,7479415,937
"16382","chr19",41124580,41124889,41124734,309
"16383","chr2",27306215,27308597,27307406,2382
"16384","chr17",74671056,74671571,74671313,515
"16385","chr15",45135098,45136008,45135553,910
"16386","chr20",23988512,23988796,23988654,284
"16387","chr10",132965179,132965569,132965374,390
"16388","chr17",59619293,59619919,59619606,626
"16389","chr11",62612166,62613084,62612625,918
"16390","chr4",139115123,139115535,139115329,412
"16391","chr7",155466132,155468708,155467420,2576
"16392","chr4",2462279,2463069,2462674,790
"16393","chr16",23678570,23679350,23678960,780
"16394","chr10",6163536,6164248,6163892,712
"16395","chr11",62123726,62124073,62123899,347
"16396","chr19",52095227,52095985,52095606,758
"16397","chr3",180989478,180989839,180989658,361
"16398","chr8",71547329,71548288,71547808,959
"16399","chr16",67159102,67159316,67159209,214
"16400","chr22",26512248,26512576,26512412,328
"16401","chr10",96129879,96130655,96130267,776
"16402","chr20",63569299,63569600,63569449,301
"16403","chr20",58756178,58756382,58756280,204
"16404","chr8",62248039,62249505,62248772,1466
"16405","chr20",49915066,49915779,49915422,713
"16406","chr3",48240935,48241327,48241131,392
"16407","chr3",51983040,51983576,51983308,536
"16408","chr1",21427995,21429502,21428748,1507
"16409","chr3",160449396,160450412,160449904,1016
"16410","chr17",49851106,49851994,49851550,888
"16411","chr17",20532261,20532741,20532501,480
"16412","chr10",132140341,132140775,132140558,434
"16413","chr3",12908199,12908525,12908362,326
"16414","chr8",78804446,78805168,78804807,722
"16415","chr20",46057132,46058971,46058051,1839
"16416","chr16",10818302,10818862,10818582,560
"16417","chr4",25030406,25031098,25030752,692
"16418","chr6",53359092,53359868,53359480,776
"16419","chr7",1496985,1497853,1497419,868
"16420","chr1",225881905,225883198,225882551,1293
"16421","chrX",101407839,101408313,101408076,474
"16422","chr6",27680014,27680226,27680120,212
"16423","chr17",19724564,19724985,19724774,421
"16424","chr10",27258739,27259473,27259106,734
"16425","chr19",18007099,18007496,18007297,397
"16426","chr22",20507392,20507965,20507678,573
"16427","chr19",51702991,51703473,51703232,482
"16428","chr4",95548305,95548516,95548410,211
"16429","chr19",18854826,18855276,18855051,450
"16430","chr4",11428611,11429632,11429121,1021
"16431","chr9",87706220,87706471,87706345,251
"16432","chr20",36436113,36436407,36436260,294
"16433","chr11",66677526,66678000,66677763,474
"16434","chrX",52934784,52935529,52935156,745
"16435","chr4",24799487,24800280,24799883,793
"16436","chr11",67317217,67318342,67317779,1125
"16437","chr19",57632971,57633631,57633301,660
"16438","chr17",80840460,80842063,80841261,1603
"16439","chr3",48655685,48657335,48656510,1650
"16440","chr10",45427383,45427927,45427655,544
"16441","chr19",29524874,29530460,29527667,5586
"16442","chr2",27582887,27583211,27583049,324
"16443","chr17",29615514,29618370,29616942,2856
"16444","chr3",157120194,157120636,157120415,442
"16445","chr10",17453408,17454722,17454065,1314
"16446","chr19",10416306,10416970,10416638,664
"16447","chr2",240818724,240821366,240820045,2642
"16448","chr17",1179644,1180539,1180091,895
"16449","chr8",95133532,95134501,95134016,969
"16450","chr8",143597067,143599681,143598374,2614
"16451","chr19",2900331,2901205,2900768,874
"16452","chr1",16367126,16367775,16367450,649
"16453","chr8",144424051,144424331,144424191,280
"16454","chr19",10565591,10566302,10565946,711
"16455","chr2",8027892,8028156,8028024,264
"16456","chr9",112513457,112513743,112513600,286
"16457","chr8",42050855,42052621,42051738,1766
"16458","chr2",200963292,200963791,200963541,499
"16459","chr6",96924305,96924987,96924646,682
"16460","chr19",49339397,49340371,49339884,974
"16461","chr11",1388889,1391116,1390002,2227
"16462","chr17",48636564,48636769,48636666,205
"16463","chr19",56086672,56088927,56087799,2255
"16464","chr4",75724354,75725273,75724813,919
"16465","chr11",1747749,1749482,1748615,1733
"16466","chr11",66371335,66372258,66371796,923
"16467","chr4",41745491,41746128,41745809,637
"16468","chr15",67863534,67863787,67863660,253
"16469","chr9",38423950,38424449,38424199,499
"16470","chr11",33039153,33040300,33039726,1147
"16471","chr11",416419,417650,417034,1231
"16472","chr2",118841483,118841723,118841603,240
"16473","chr6",34391843,34393025,34392434,1182
"16474","chr17",28571087,28571763,28571425,676
"16475","chr19",1953779,1954024,1953901,245
"16476","chr1",220690165,220690907,220690536,742
"16477","chr6",170074980,170075206,170075093,226
"16478","chr17",64836651,64837410,64837030,759
"16479","chr12",26124950,26126774,26125862,1824
"16480","chr9",111896338,111897493,111896915,1155
"16481","chr19",47019647,47021933,47020790,2286
"16482","chr6",4774897,4776695,4775796,1798
"16483","chrX",52920717,52921442,52921079,725
"16484","chr2",3379579,3380205,3379892,626
"16485","chr17",4365330,4366860,4366095,1530
"16486","chr6",165804519,165805388,165804953,869
"16487","chr12",103956725,103957291,103957008,566
"16488","chr12",42286805,42287087,42286946,282
"16489","chrX",103918559,103919267,103918913,708
"16490","chr11",34438618,34439310,34438964,692
"16491","chr4",41216523,41216751,41216637,228
"16492","chr2",224584539,224585771,224585155,1232
"16493","chr5",156850291,156850674,156850482,383
"16494","chr11",68425042,68425330,68425186,288
"16495","chr11",76783131,76784628,76783879,1497
"16496","chr6",109290246,109290653,109290449,407
"16497","chrX",37571453,37572531,37571992,1078
"16498","chr11",14358262,14359306,14358784,1044
"16499","chr19",48799598,48799861,48799729,263
"16500","chr2",110677741,110678307,110678024,566
"16501","chr19",651197,653193,652195,1996
"16502","chr5",176817604,176818283,176817943,679
"16503","chr19",719098,720953,720025,1855
"16504","chr16",28936679,28937129,28936904,450
"16505","chr20",35292101,35292412,35292256,311
"16506","chr2",74654337,74654892,74654614,555
"16507","chr2",176140636,176140938,176140787,302
"16508","chr17",75131101,75131900,75131500,799
"16509","chr4",76689171,76689790,76689480,619
"16510","chr22",24011223,24011610,24011416,387
"16511","chr13",112071967,112074105,112073036,2138
"16512","chr20",3785696,3786989,3786342,1293
"16513","chr11",44316147,44317233,44316690,1086
"16514","chr10",71377214,71377595,71377404,381
"16515","chr11",20596651,20598374,20597512,1723
"16516","chr2",42827574,42828158,42827866,584
"16517","chr19",10636465,10636812,10636638,347
"16518","chr4",1247624,1250323,1248973,2699
"16519","chr12",53626028,53626499,53626263,471
"16520","chr1",33050993,33051332,33051162,339
"16521","chr20",21508761,21509052,21508906,291
"16522","chr11",32892443,32893968,32893205,1525
"16523","chr12",120686308,120687676,120686992,1368
"16524","chr8",1039167,1040699,1039933,1532
"16525","chr12",29389285,29389905,29389595,620
"16526","chr21",37266934,37268190,37267562,1256
"16527","chr2",182866080,182866629,182866354,549
"16528","chr7",100892360,100892744,100892552,384
"16529","chr17",39926973,39927799,39927386,826
"16530","chr15",90902333,90903538,90902935,1205
"16531","chr19",48333884,48334292,48334088,408
"16532","chr8",103498827,103501685,103500256,2858
"16533","chr19",8444751,8445881,8445316,1130
"16534","chr12",49341936,49343092,49342514,1156
"16535","chr10",111076232,111079545,111077888,3313
"16536","chr17",82596931,82597143,82597037,212
"16537","chr11",975211,975776,975493,565
"16538","chr5",180792007,180792883,180792445,876
"16539","chr19",21082358,21082627,21082492,269
"16540","chr19",48442543,48444379,48443461,1836
"16541","chr6",168931742,168932206,168931974,464
"16542","chr17",6894110,6894405,6894257,295
"16543","chr2",74497912,74499911,74498911,1999
"16544","chr20",62683275,62683476,62683375,201
"16545","chr7",143380581,143382076,143381328,1495
"16546","chr17",43360836,43361306,43361071,470
"16547","chr20",50794864,50795605,50795234,741
"16548","chr10",42367505,42367768,42367636,263
"16549","chr7",143345415,143345774,143345594,359
"16550","chr11",67464575,67465087,67464831,512
"16551","chr17",2392628,2394277,2393452,1649
"16552","chrX",71910829,71911970,71911399,1141
"16553","chr14",105721791,105722344,105722067,553
"16554","chr10",100654668,100656723,100655695,2055
"16555","chr14",45252945,45253599,45253272,654
"16556","chr1",2518483,2518767,2518625,284
"16557","chr16",31371605,31371818,31371711,213
"16558","chr1",50426809,50427571,50427190,762
"16559","chr3",42013289,42014437,42013863,1148
"16560","chr1",22593280,22593714,22593497,434
"16561","chr6",165854487,165854973,165854730,486
"16562","chr11",89065781,89066110,89065945,329
"16563","chr1",2478353,2478610,2478481,257
"16564","chr11",6259846,6260077,6259961,231
"16565","chr10",86755669,86757460,86756564,1791
"16566","chr20",45097656,45098731,45098193,1075
"16567","chr9",126482458,126482968,126482713,510
"16568","chr19",19537325,19538581,19537953,1256
"16569","chr9",2014831,2018105,2016468,3274
"16570","chr8",99893429,99893775,99893602,346
"16571","chr6",35485999,35486658,35486328,659
"16572","chr1",197146148,197146861,197146504,713
"16573","chr8",1144750,1144967,1144858,217
"16574","chr22",40856142,40857236,40856689,1094
"16575","chr8",142798178,142798390,142798284,212
"16576","chr19",55312947,55313232,55313089,285
"16577","chr8",11347316,11348180,11347748,864
"16578","chr19",35868330,35868873,35868601,543
"16579","chr6",96015993,96016260,96016126,267
"16580","chr11",65386255,65387135,65386695,880
"16581","chrX",40171565,40172928,40172246,1363
"16582","chr19",4064088,4067982,4066035,3894
"16583","chr18",79714603,79715523,79715063,920
"16584","chr4",176001322,176001669,176001495,347
"16585","chr11",71786525,71788019,71787272,1494
"16586","chr1",145287326,145287743,145287534,417
"16587","chr9",133701451,133701774,133701612,323
"16588","chr1",2314275,2315647,2314961,1372
"16589","chr7",23490815,23491071,23490943,256
"16590","chr4",154491867,154492241,154492054,374
"16591","chr7",2734810,2735021,2734915,211
"16592","chr11",87037618,87038051,87037834,433
"16593","chr3",120093928,120095802,120094865,1874
"16594","chr4",25655497,25655925,25655711,428
"16595","chr4",127730264,127730822,127730543,558
"16596","chr2",24076099,24077424,24076761,1325
"16597","chr16",1065368,1066468,1065918,1100
"16598","chr19",48445777,48446185,48445981,408
"16599","chr18",8704723,8707559,8706141,2836
"16600","chr2",2750970,2751368,2751169,398
"16601","chr12",133037179,133037939,133037559,760
"16602","chr7",111728310,111728609,111728459,299
"16603","chr6",121334525,121334876,121334700,351
"16604","chrX",123732349,123733247,123732798,898
"16605","chr2",181656494,181657200,181656847,706
"16606","chr12",24902665,24903312,24902988,647
"16607","chr1",16154989,16155965,16155477,976
"16608","chr16",76634938,76635255,76635096,317
"16609","chr16",929422,929663,929542,241
"16610","chr14",34714179,34714990,34714584,811
"16611","chr3",97971941,97972565,97972253,624
"16612","chr14",24369562,24369788,24369675,226
"16613","chr19",39264333,39265900,39265116,1567
"16614","chr4",120921993,120923038,120922515,1045
"16615","chr19",757817,758492,758154,675
"16616","chr6",2244884,2245919,2245401,1035
"16617","chr11",112961802,112963768,112962785,1966
"16618","chr20",3660483,3661467,3660975,984
"16619","chr14",104250802,104252085,104251443,1283
"16620","chr7",1036291,1036492,1036391,201
"16621","chr19",47048129,47048879,47048504,750
"16622","chr20",2470429,2470926,2470677,497
"16623","chr14",73569423,73569989,73569706,566
"16624","chr7",99392534,99393299,99392916,765
"16625","chr13",27970387,27970753,27970570,366
"16626","chr18",10454085,10455271,10454678,1186
"16627","chr17",44829442,44830693,44830067,1251
"16628","chr12",132840652,132840886,132840769,234
"16629","chr9",33076494,33076777,33076635,283
"16630","chr9",35756951,35757342,35757146,391
"16631","chr17",48059287,48059607,48059447,320
"16632","chr6",109690386,109690601,109690493,215
"16633","chr11",72103157,72103483,72103320,326
"16634","chr19",51394369,51394624,51394496,255
"16635","chr11",61891097,61892120,61891608,1023
"16636","chr16",2205167,2205827,2205497,660
"16637","chr7",23247602,23247889,23247745,287
"16638","chr6",85678275,85679440,85678857,1165
"16639","chr19",11418537,11419308,11418922,771
"16640","chr1",155277200,155277957,155277578,757
"16641","chr19",2196913,2197163,2197038,250
"16642","chr6",41427491,41428546,41428018,1055
"16643","chr12",52079566,52080394,52079980,828
"16644","chr11",1804120,1804338,1804229,218
"16645","chr22",40346399,40346724,40346561,325
"16646","chr19",49071872,49072959,49072415,1087
"16647","chr22",24763898,24764245,24764071,347
"16648","chr17",78855677,78855891,78855784,214
"16649","chr2",118858557,118859250,118858903,693
"16650","chr19",18774991,18775372,18775181,381
"16651","chr16",49838538,49839015,49838776,477
"16652","chr17",83084750,83085368,83085059,618
"16653","chr6",123803032,123804164,123803598,1132
"16654","chr13",49691088,49691720,49691404,632
"16655","chr13",19957408,19959490,19958449,2082
"16656","chr15",84657965,84658487,84658226,522
"16657","chr16",1399294,1399544,1399419,250
"16658","chr19",18557664,18558127,18557895,463
"16659","chr7",1091989,1093551,1092770,1562
"16660","chr11",16606856,16607633,16607244,777
"16661","chr6",167220443,167220652,167220547,209
"16662","chr19",6414779,6415091,6414935,312
"16663","chr11",94973127,94973896,94973511,769
"16664","chr1",9610559,9610810,9610684,251
"16665","chr19",55652296,55655891,55654093,3595
"16666","chr6",36885814,36886151,36885982,337
"16667","chr20",25148128,25148974,25148551,846
"16668","chr11",61917119,61917744,61917431,625
"16669","chr2",218367652,218368169,218367910,517
"16670","chr4",1096061,1096500,1096280,439
"16671","chr8",38386223,38387177,38386700,954
"16672","chr6",42451772,42452005,42451888,233
"16673","chr17",50558742,50561918,50560330,3176
"16674","chr14",74302663,74303112,74302887,449
"16675","chr19",44094221,44094701,44094461,480
"16676","chr6",85286018,85286238,85286128,220
"16677","chr19",49651274,49653034,49652154,1760
"16678","chr10",100373264,100373800,100373532,536
"16679","chr1",1373760,1375659,1374709,1899
"16680","chr14",104659853,104660395,104660124,542
"16681","chr6",170214542,170220892,170217717,6350
"16682","chr16",31061667,31062285,31061976,618
"16683","chr6",8435081,8435908,8435494,827
"16684","chr19",56368048,56368626,56368337,578
"16685","chr7",140924197,140925149,140924673,952
"16686","chr19",58575330,58575932,58575631,602
"16687","chr1",148334776,148335046,148334911,270
"16688","chr12",54081728,54082032,54081880,304
"16689","chr12",6363310,6364156,6363733,846
"16690","chr11",57335367,57335956,57335661,589
"16691","chr14",81435747,81436803,81436275,1056
"16692","chr21",44333755,44334557,44334156,802
"16693","chr1",1745362,1746894,1746128,1532
"16694","chr19",55685300,55685753,55685526,453
"16695","chr10",48306288,48307357,48306822,1069
"16696","chr20",35771751,35772328,35772039,577
"16697","chr12",132245922,132246150,132246036,228
"16698","chr10",123857541,123857813,123857677,272
"16699","chr4",151325039,151325788,151325413,749
"16700","chr6",105136386,105137746,105137066,1360
"16701","chr6",108157319,108158354,108157836,1035
"16702","chr20",21507762,21507971,21507866,209
"16703","chr9",4804490,4804780,4804635,290
"16704","chr22",50342761,50343580,50343170,819
"16705","chr11",66559016,66559443,66559229,427
"16706","chr4",117085382,117085703,117085542,321
"16707","chr11",43580995,43581665,43581330,670
"16708","chr14",55026896,55027314,55027105,418
"16709","chr9",136949840,136950241,136950040,401
"16710","chr17",38558172,38558589,38558380,417
"16711","chr12",94139953,94140176,94140064,223
"16712","chr6",75601614,75602847,75602230,1233
"16713","chr12",57185537,57185842,57185689,305
"16714","chr17",42548161,42548841,42548501,680
"16715","chr17",59154494,59155294,59154894,800
"16716","chr8",9555871,9556583,9556227,712
"16717","chr19",2494097,2494904,2494500,807
"16718","chr1",38990983,38991599,38991291,616
"16719","chr14",77800004,77800392,77800198,388
"16720","chr1",87152009,87152303,87152156,294
"16721","chr9",3526021,3526945,3526483,924
"16722","chr8",26382774,26383748,26383261,974
"16723","chr19",14205278,14207644,14206461,2366
"16724","chr6",27251013,27252034,27251523,1021
"16725","chr8",64377551,64378389,64377970,838
"16726","chr11",2396420,2396763,2396591,343
"16727","chr14",69397996,69398356,69398176,360
"16728","chr11",1964785,1965132,1964958,347
"16729","chr17",75753537,75754097,75753817,560
"16730","chr10",46541206,46541532,46541369,326
"16731","chr19",45363672,45364104,45363888,432
"16732","chr11",64116383,64117710,64117046,1327
"16733","chr1",156435368,156436558,156435963,1190
"16734","chr19",29714983,29715590,29715286,607
"16735","chr12",48957056,48957676,48957366,620
"16736","chr14",103727564,103728290,103727927,726
"16737","chr9",14312953,14316014,14314483,3061
"16738","chr20",9838623,9839213,9838918,590
"16739","chr6",26246587,26246872,26246729,285
"16740","chr17",80844640,80844896,80844768,256
"16741","chr19",41263310,41263512,41263411,202
"16742","chr19",39970604,39971021,39970812,417
"16743","chr8",144291037,144292277,144291657,1240
"16744","chr12",114448549,114448774,114448661,225
"16745","chr4",6199185,6200997,6200091,1812
"16746","chr19",35958969,35960233,35959601,1264
"16747","chr6",26659308,26659937,26659622,629
"16748","chr3",198080158,198081863,198081010,1705
"16749","chr17",34039924,34040387,34040155,463
"16750","chr3",44648634,44649095,44648864,461
"16751","chr1",11735918,11736206,11736062,288
"16752","chr14",104116699,104118237,104117468,1538
"16753","chr4",76251434,76251907,76251670,473
"16754","chr14",64986669,64987280,64986974,611
"16755","chr8",7733011,7733446,7733228,435
"16756","chr17",81261686,81261951,81261818,265
"16757","chr17",81003813,81004647,81004230,834
"16758","chr19",3047180,3047446,3047313,266
"16759","chr11",62771529,62771850,62771689,321
"16760","chr6",28895566,28895768,28895667,202
"16761","chr17",58156960,58157466,58157213,506
"16762","chrX",40091646,40092412,40092029,766
"16763","chr22",50014627,50015708,50015167,1081
"16764","chrX",50813259,50814179,50813719,920
"16765","chr11",18721143,18721966,18721554,823
"16766","chr17",42998275,42998632,42998453,357
"16767","chr1",115089229,115089963,115089596,734
"16768","chr1",110223043,110223390,110223216,347
"16769","chr19",12400794,12401330,12401062,536
"16770","chrY",9396612,9396875,9396743,263
"16771","chr19",49746235,49746637,49746436,402
"16772","chr20",44810096,44810905,44810500,809
"16773","chrX",129931643,129933251,129932447,1608
"16774","chr17",81994952,81995228,81995090,276
"16775","chr4",102826474,102828235,102827354,1761
"16776","chr16",71358631,71358846,71358738,215
"16777","chr12",53960745,53961707,53961226,962
"16778","chr1",45583918,45584910,45584414,992
"16779","chr12",54053960,54054252,54054106,292
"16780","chr6",98842403,98842895,98842649,492
"16781","chr5",140834483,140834879,140834681,396
"16782","chr20",3749714,3750434,3750074,720
"16783","chr17",80922636,80923003,80922819,367
"16784","chr1",228650239,228650457,228650348,218
"16785","chr12",1630120,1630667,1630393,547
"16786","chr12",132828294,132829399,132828846,1105
"16787","chr4",9381002,9381409,9381205,407
"16788","chr20",61873719,61874007,61873863,288
"16789","chr7",63694311,63694769,63694540,458
"16790","chr6",167421377,167423128,167422252,1751
"16791","chr12",12356977,12357494,12357235,517
"16792","chr19",21474767,21475233,21475000,466
"16793","chr13",114138309,114138944,114138626,635
"16794","chr22",47028318,47028579,47028448,261
"16795","chr13",114096186,114096401,114096293,215
"16796","chr11",72243772,72244649,72244210,877
"16797","chr8",144436760,144437000,144436880,240
"16798","chr19",1248184,1251180,1249682,2996
"16799","chr19",8389947,8390961,8390454,1014
"16800","chr22",20155284,20155519,20155401,235
"16801","chr12",114440338,114441350,114440844,1012
"16802","chr3",127033952,127034178,127034065,226
"16803","chr4",5568408,5568624,5568516,216
"16804","chr17",19533475,19534379,19533927,904
"16805","chr11",2869158,2870107,2869632,949
"16806","chrX",140507805,140508315,140508060,510
"16807","chr7",5045780,5046711,5046245,931
"16808","chr11",1956293,1956535,1956414,242
"16809","chrX",120244791,120245184,120244987,393
"16810","chr7",140175611,140177693,140176652,2082
"16811","chr3",8985472,8985927,8985699,455
"16812","chr19",13764230,13765137,13764683,907
"16813","chr19",58554784,58555295,58555039,511
"16814","chr7",1539810,1541025,1540417,1215
"16815","chr13",75549302,75550132,75549717,830
"16816","chr11",18189337,18189658,18189497,321
"16817","chr9",33447448,33447826,33447637,378
"16818","chr19",56595207,56595528,56595367,321
"16819","chr19",572278,573134,572706,856
"16820","chr4",30719582,30723220,30721401,3638
"16821","chr11",46243422,46243784,46243603,362
"16822","chr8",143684331,143684823,143684577,492
"16823","chrX",49053397,49053964,49053680,567
"16824","chr16",10906922,10907176,10907049,254
"16825","chr1",89843280,89844047,89843663,767
"16826","chr4",78181746,78182107,78181926,361
"16827","chr5",141320331,141320928,141320629,597
"16828","chr14",99652540,99652851,99652695,311
"16829","chr17",19062164,19062415,19062289,251
"16830","chr3",37994210,37994509,37994359,299
"16831","chr16",88967121,88967378,88967249,257
"16832","chrX",37043542,37043933,37043737,391
"16833","chr11",128692776,128695170,128693973,2394
"16834","chr14",45134170,45134703,45134436,533
"16835","chr12",120725689,120726110,120725899,421
"16836","chr7",6854628,6855914,6855271,1286
"16837","chr20",16573191,16573615,16573403,424
"16838","chr6",153129982,153131657,153130819,1675
"16839","chr9",137814400,137814614,137814507,214
"16840","chr1",1537727,1537962,1537844,235
"16841","chr9",122159671,122159891,122159781,220
"16842","chr17",82971186,82971478,82971332,292
"16843","chr16",3731213,3731417,3731315,204
"16844","chr16",23557077,23558167,23557622,1090
"16845","chr7",158164219,158164581,158164400,362
"16846","chr5",93593562,93593783,93593672,221
"16847","chr8",116874113,116875080,116874596,967
"16848","chr4",2731930,2732293,2732111,363
"16849","chr15",101651962,101653142,101652552,1180
"16850","chr3",101561701,101562108,101561904,407
"16851","chr14",85530150,85530614,85530382,464
"16852","chr8",70401910,70404535,70403222,2625
"16853","chr14",100192759,100193274,100193016,515
"16854","chr6",168886100,168886593,168886346,493
"16855","chr21",39388700,39388903,39388801,203
"16856","chr11",62591341,62592202,62591771,861
"16857","chr20",23361508,23362769,23362138,1261
"16858","chr14",104172905,104173554,104173229,649
"16859","chr19",18650462,18650859,18650660,397
"16860","chr7",156318541,156318752,156318646,211
"16861","chr17",21042599,21043756,21043177,1157
"16862","chr11",47355100,47355797,47355448,697
"16863","chr7",150958020,150958555,150958287,535
"16864","chr17",80035277,80037285,80036281,2008
"16865","chr11",3217987,3218758,3218372,771
"16866","chrX",40012279,40015513,40013896,3234
"16867","chr8",2001079,2003206,2002142,2127
"16868","chr13",24541466,24542291,24541878,825
"16869","chr20",62053241,62053582,62053411,341
"16870","chr7",4682006,4683148,4682577,1142
"16871","chr19",16185702,16185931,16185816,229
"16872","chr9",84140470,84140785,84140627,315
"16873","chr19",14565389,14565730,14565559,341
"16874","chr21",33069900,33072237,33071068,2337
"16875","chr8",23682294,23683089,23682691,795
"16876","chr4",183483348,183483618,183483483,270
"16877","chr14",59483742,59484809,59484275,1067
"16878","chr9",137406886,137407374,137407130,488
"16879","chr19",45641614,45642373,45641993,759
"16880","chr9",93566484,93566848,93566666,364
"16881","chr17",48100787,48101581,48101184,794
"16882","chr17",8015703,8016549,8016126,846
"16883","chr19",47608094,47610428,47609261,2334
"16884","chr8",42338342,42338707,42338524,365
"16885","chr6",136289010,136290147,136289578,1137
"16886","chr16",56662980,56663318,56663149,338
"16887","chr19",22617890,22618239,22618064,349
"16888","chr16",88121986,88122502,88122244,516
"16889","chr17",4796088,4796343,4796215,255
"16890","chr14",105526162,105530077,105528119,3915
"16891","chr4",1170727,1172794,1171760,2067
"16892","chr16",401474,402132,401803,658
"16893","chr7",56823696,56824105,56823900,409
"16894","chr5",108380608,108382600,108381604,1992
"16895","chr5",50666433,50667943,50667188,1510
"16896","chr3",50327875,50328454,50328164,579
"16897","chr5",10333110,10333989,10333549,879
"16898","chr11",65047568,65048250,65047909,682
"16899","chr14",91574067,91574532,91574299,465
"16900","chr19",4343269,4344030,4343649,761
"16901","chr19",12640057,12640342,12640199,285
"16902","chr9",137322414,137323613,137323013,1199
"16903","chr16",55323609,55325128,55324368,1519
"16904","chr14",104155529,104155812,104155670,283
"16905","chr16",54928510,54933893,54931201,5383
"16906","chr6",143060307,143061248,143060777,941
"16907","chr14",65279611,65280254,65279932,643
"16908","chr14",105355145,105355431,105355288,286
"16909","chr17",37920928,37921155,37921041,227
"16910","chr1",85276182,85276852,85276517,670
"16911","chr7",152675895,152676336,152676115,441
"16912","chr1",243483092,243483586,243483339,494
"16913","chr3",196502939,196503920,196503429,981
"16914","chr19",45370081,45370775,45370428,694
"16915","chr14",100292271,100293102,100292686,831
"16916","chr5",1099279,1099621,1099450,342
"16917","chr16",1347679,1348244,1347961,565
"16918","chr16",693471,693702,693586,231
"16919","chr6",159761397,159762738,159762067,1341
"16920","chr16",50152643,50154388,50153515,1745
"16921","chr1",228165407,228166285,228165846,878
"16922","chr19",46303741,46304360,46304050,619
"16923","chr13",111586325,111586546,111586435,221
"16924","chr1",209937834,209938709,209938271,875
"16925","chr4",905986,906197,906091,211
"16926","chr10",22334421,22336708,22335564,2287
"16927","chr7",892130,892377,892253,247
"16928","chr1",224182883,224184053,224183468,1170
"16929","chr14",77270390,77271429,77270909,1039
"16930","chr8",102600831,102601162,102600996,331
"16931","chr6",28218698,28219106,28218902,408
"16932","chr5",150449580,150450068,150449824,488
"16933","chr11",64226117,64226362,64226239,245
"16934","chr9",104093681,104094512,104094096,831
"16935","chr20",33791031,33791385,33791208,354
"16936","chr7",5332649,5333086,5332867,437
"16937","chr11",74397849,74398892,74398370,1043
"16938","chr14",20622935,20623280,20623107,345
"16939","chr1",11664056,11664828,11664442,772
"16940","chr11",791953,792400,792176,447
"16941","chr16",88877019,88877261,88877140,242
"16942","chr6",107488862,107490243,107489552,1381
"16943","chr6",151240148,151241415,151240781,1267
"16944","chr16",31464467,31464879,31464673,412
"16945","chr6",50819573,50820378,50819975,805
"16946","chrX",47144351,47145588,47144969,1237
"16947","chr17",1108604,1109728,1109166,1124
"16948","chr16",22915022,22915318,22915170,296
"16949","chrX",119692428,119693768,119693098,1340
"16950","chr8",8319010,8319259,8319134,249
"16951","chr22",50289012,50290225,50289618,1213
"16952","chr11",24496678,24497192,24496935,514
"16953","chr11",57459363,57461234,57460298,1871
"16954","chr14",23351878,23352897,23352387,1019
"16955","chr6",169241708,169241925,169241816,217
"16956","chr22",43014415,43015504,43014959,1089
"16957","chr22",49418453,49418819,49418636,366
"16958","chr14",69726750,69727238,69726994,488
"16959","chr1",70354050,70355036,70354543,986
"16960","chr8",10924544,10924793,10924668,249
"16961","chr22",50169394,50171198,50170296,1804
"16962","chr9",34048641,34049617,34049129,976
"16963","chr13",31199782,31200897,31200339,1115
"16964","chr9",96875563,96875999,96875781,436
"16965","chr1",116372669,116374191,116373430,1522
"16966","chr5",69234770,69235174,69234972,404
"16967","chrX",100411902,100412226,100412064,324
"16968","chr16",164344,166721,165532,2377
"16969","chr19",11694446,11695085,11694765,639
"16970","chr19",5680422,5681420,5680921,998
"16971","chr3",44555043,44555526,44555284,483
"16972","chr1",107141044,107141841,107141442,797
"16973","chr8",52939141,52941866,52940503,2725
"16974","chr3",54121212,54122998,54122105,1786
"16975","chr7",150947367,150947679,150947523,312
"16976","chr17",28552267,28552769,28552518,502
"16977","chr17",80058478,80058773,80058625,295
"16978","chr5",172834142,172834668,172834405,526
"16979","chr21",46006464,46006712,46006588,248
"16980","chr1",241640245,241640590,241640417,345
"16981","chr7",1874193,1874441,1874317,248
"16982","chr11",8168679,8169124,8168901,445
"16983","chr17",82779666,82779898,82779782,232
"16984","chr10",1553347,1553597,1553472,250
"16985","chr1",147242439,147243628,147243033,1189
"16986","chr22",50447028,50447281,50447154,253
"16987","chr7",27160042,27161341,27160691,1299
"16988","chr18",21241422,21243388,21242405,1966
"16989","chr19",10587110,10587423,10587266,313
"16990","chrX",134549409,134551433,134550421,2024
"16991","chrX",149505022,149505454,149505238,432
"16992","chr1",109655919,109656505,109656212,586
"16993","chr7",27242467,27243517,27242992,1050
"16994","chr17",38509752,38510998,38510375,1246
"16995","chrX",49235474,49235773,49235623,299
"16996","chr19",40623942,40624207,40624074,265
"16997","chr14",105474251,105475563,105474907,1312
"16998","chr1",44786290,44786620,44786455,330
"16999","chr17",82085023,82085413,82085218,390
"17000","chr20",62880869,62882355,62881612,1486
"17001","chr1",153977236,153978049,153977642,813
"17002","chr1",245673021,245673445,245673233,424
"17003","chr17",8965152,8966055,8965603,903
"17004","chr8",39107494,39107904,39107699,410
"17005","chr8",10334430,10335110,10334770,680
"17006","chr9",96777743,96778190,96777966,447
"17007","chr17",81386583,81387923,81387253,1340
"17008","chr11",45917745,45918585,45918165,840
"17009","chr9",120579848,120580235,120580041,387
"17010","chr11",64085331,64085610,64085470,279
"17011","chr2",219057418,219058408,219057913,990
"17012","chr19",468706,468950,468828,244
"17013","chr1",25875231,25876025,25875628,794
"17014","chr14",36521668,36522004,36521836,336
"17015","chr1",150294056,150294269,150294162,213
"17016","chr1",31714530,31714886,31714708,356
"17017","chr19",53291158,53291479,53291318,321
"17018","chr6",6007154,6007564,6007359,410
"17019","chr3",126179819,126180725,126180272,906
"17020","chr19",18866657,18867024,18866840,367
"17021","chr22",46335482,46336440,46335961,958
"17022","chr7",44573612,44574276,44573944,664
"17023","chr16",18925708,18926804,18926256,1096
"17024","chr17",82371190,82372332,82371761,1142
"17025","chr10",69451360,69452024,69451692,664
"17026","chr5",177351571,177352089,177351830,518
"17027","chr20",62220390,62221065,62220727,675
"17028","chr9",42974804,42975061,42974932,257
"17029","chr13",114042156,114042358,114042257,202
"17030","chr1",114152514,114154050,114153282,1536
"17031","chr9",136410015,136411343,136410679,1328
"17032","chr9",87824690,87825177,87824933,487
"17033","chr14",74425763,74426332,74426047,569
"17034","chr2",130228088,130229610,130228849,1522
"17035","chr3",179562574,179563675,179563124,1101
"17036","chr8",67952190,67952711,67952450,521
"17037","chr11",61587566,61587891,61587728,325
"17038","chr3",16604441,16605624,16605032,1183
"17039","chr17",48641998,48642872,48642435,874
"17040","chr9",137156610,137157278,137156944,668
"17041","chr15",65076788,65078115,65077451,1327
"17042","chr16",19183561,19183887,19183724,326
"17043","chr8",1990354,1991124,1990739,770
"17044","chr15",74540900,74541620,74541260,720
"17045","chr11",65184253,65184564,65184408,311
"17046","chr11",50267860,50268155,50268007,295
"17047","chr7",23680000,23680387,23680193,387
"17048","chr12",133080118,133081227,133080672,1109
"17049","chrX",34130623,34130840,34130731,217
"17050","chr6",3849037,3850814,3849925,1777
"17051","chr2",9950778,9952327,9951552,1549
"17052","chr17",74446788,74447055,74446921,267
"17053","chr16",21376614,21376840,21376727,226
"17054","chr2",216633050,216634124,216633587,1074
"17055","chr17",43778266,43779365,43778815,1099
"17056","chr19",2339008,2340238,2339623,1230
"17057","chr2",235384656,235384925,235384790,269
"17058","chr4",146637079,146637431,146637255,352
"17059","chr12",103302312,103302640,103302476,328
"17060","chr9",96027384,96028023,96027703,639
"17061","chr8",27592234,27592546,27592390,312
"17062","chr8",143407364,143407792,143407578,428
"17063","chr7",44606466,44607224,44606845,758
"17064","chr20",63751604,63752974,63752289,1370
"17065","chr16",2251156,2251968,2251562,812
"17066","chr1",22025424,22025701,22025562,277
"17067","chrX",44343466,44343768,44343617,302
"17068","chr5",31638946,31639997,31639471,1051
"17069","chr19",16896290,16898046,16897168,1756
"17070","chr1",155262021,155262521,155262271,500
"17071","chr17",81034567,81035962,81035264,1395
"17072","chr16",21599371,21600373,21599872,1002
"17073","chr14",24171844,24173011,24172427,1167
"17074","chr12",15322384,15322967,15322675,583
"17075","chr20",63453114,63453550,63453332,436
"17076","chr11",15938309,15938531,15938420,222
"17077","chr5",141355153,141355461,141355307,308
"17078","chr14",91835857,91836448,91836152,591
"17079","chr16",2882266,2883764,2883015,1498
"17080","chr1",9909787,9910631,9910209,844
"17081","chr1",227494515,227495237,227494876,722
"17082","chr12",79934634,79935522,79935078,888
"17083","chr19",11814271,11814731,11814501,460
"17084","chr19",982689,983080,982884,391
"17085","chr2",127592710,127593065,127592887,355
"17086","chr11",90053484,90053788,90053636,304
"17087","chr2",113275782,113276040,113275911,258
"17088","chr22",24251399,24251632,24251515,233
"17089","chr12",53939051,53939903,53939477,852
"17090","chr1",37032776,37035023,37033899,2247
"17091","chr7",103279862,103281067,103280464,1205
"17092","chr5",115169120,115170901,115170010,1781
"17093","chr4",41360235,41361622,41360928,1387
"17094","chr4",121801180,121801603,121801391,423
"17095","chr22",47061004,47061265,47061134,261
"17096","chr7",984970,985258,985114,288
"17097","chr19",57240520,57240918,57240719,398
"17098","chr12",55716014,55716312,55716163,298
"17099","chr16",737070,737327,737198,257
"17100","chr17",42566668,42567615,42567141,947
"17101","chr5",149550686,149551681,149551183,995
"17102","chr2",71276417,71277103,71276760,686
"17103","chrX",54182506,54183309,54182907,803
"17104","chr4",82900535,82900912,82900723,377
"17105","chr6",165988038,165989171,165988604,1133
"17106","chr13",114234673,114235399,114235036,726
"17107","chr11",64712727,64714028,64713377,1301
"17108","chr1",209675098,209676083,209675590,985
"17109","chr5",926471,927286,926878,815
"17110","chr19",33064340,33065525,33064932,1185
"17111","chr11",2420840,2421172,2421006,332
"17112","chr19",10835840,10836740,10836290,900
"17113","chr20",2403588,2403790,2403689,202
"17114","chr18",35580927,35582300,35581613,1373
"17115","chr11",65662697,65663608,65663152,911
"17116","chr7",157801195,157801436,157801315,241
"17117","chr14",73457881,73458729,73458305,848
"17118","chr8",22551159,22552122,22551640,963
"17119","chr7",149459470,149460989,149460229,1519
"17120","chr12",104456475,104458617,104457546,2142
"17121","chr8",55879556,55880766,55880161,1210
"17122","chr11",27721925,27723017,27722471,1092
"17123","chr20",3045631,3046470,3046050,839
"17124","chr19",3730417,3730771,3730594,354
"17125","chr2",39243601,39244067,39243834,466
"17126","chr20",1184561,1185958,1185259,1397
"17127","chr11",10305466,10308284,10306875,2818
"17128","chr3",141778316,141778650,141778483,334
"17129","chr12",9647947,9648256,9648101,309
"17130","chr11",72813960,72815053,72814506,1093
"17131","chr16",33928042,33928392,33928217,350
"17132","chr5",135491689,135491954,135491821,265
"17133","chr22",37983086,37983957,37983521,871
"17134","chr4",1555834,1556045,1555939,211
"17135","chr11",17207464,17208286,17207875,822
"17136","chr19",10109936,10110471,10110203,535
"17137","chr11",31798512,31799868,31799190,1356
"17138","chr1",23790992,23791302,23791147,310
"17139","chr6",53061480,53062065,53061772,585
"17140","chr8",66432262,66432754,66432508,492
"17141","chr19",35860538,35861265,35860901,727
"17142","chr19",58326832,58327501,58327166,669
"17143","chr3",11705103,11705350,11705226,247
"17144","chr4",73944152,73944372,73944262,220
"17145","chr19",3546146,3546384,3546265,238
"17146","chr1",1623207,1623979,1623593,772
"17147","chr19",15428154,15428426,15428290,272
"17148","chr1",227787594,227788869,227788231,1275
"17149","chr12",109291767,109292021,109291894,254
"17150","chr7",102321274,102321759,102321516,485
"17151","chr12",53492778,53493213,53492995,435
"17152","chr4",37243628,37245357,37244492,1729
"17153","chr17",16568760,16569486,16569123,726
"17154","chr4",176792089,176793303,176792696,1214
"17155","chr19",39506950,39507651,39507300,701
"17156","chr8",30727273,30728134,30727703,861
"17157","chr11",122882678,122883243,122882960,565
"17158","chr14",39266598,39267698,39267148,1100
"17159","chr7",151603083,151603640,151603361,557
"17160","chr3",13895024,13895339,13895181,315
"17161","chr19",51326810,51327891,51327350,1081
"17162","chr14",104103162,104103443,104103302,281
"17163","chr17",81688132,81688485,81688308,353
"17164","chr12",132986124,132986867,132986495,743
"17165","chr9",134801098,134801432,134801265,334
"17166","chr19",58513941,58514338,58514139,397
"17167","chr8",98426464,98428197,98427330,1733
"17168","chrX",153411244,153411931,153411587,687
"17169","chr12",12786779,12787457,12787118,678
"17170","chr4",154626832,154627170,154627001,338
"17171","chr13",21603664,21604313,21603988,649
"17172","chr17",48564172,48564748,48564460,576
"17173","chr6",170423031,170423354,170423192,323
"17174","chr13",110511937,110512200,110512068,263
"17175","chr14",23390147,23390411,23390279,264
"17176","chr9",137301049,137303023,137302036,1974
"17177","chr13",31846493,31847137,31846815,644
"17178","chr4",2931917,2932152,2932034,235
"17179","chr19",1646118,1646714,1646416,596
"17180","chr12",106239644,106239864,106239754,220
"17181","chr19",39412396,39413663,39413029,1267
"17182","chr9",137693559,137694479,137694019,920
"17183","chr7",155002307,155004040,155003173,1733
"17184","chr5",55534320,55535292,55534806,972
"17185","chr5",160399801,160400104,160399952,303
"17186","chr6",163099952,163100553,163100252,601
"17187","chr9",127568261,127569655,127568958,1394
"17188","chr19",55451266,55452880,55452073,1614
"17189","chr20",56391980,56392945,56392462,965
"17190","chr11",62687601,62688396,62687998,795
"17191","chr13",48037510,48038132,48037821,622
"17192","chr8",22089057,22089899,22089478,842
"17193","chr19",48624131,48624463,48624297,332
"17194","chr7",55964353,55965210,55964781,857
"17195","chr20",36540786,36541684,36541235,898
"17196","chr16",714748,715994,715371,1246
"17197","chr14",24006828,24007366,24007097,538
"17198","chr17",42098254,42098470,42098362,216
"17199","chr19",55529821,55530313,55530067,492
"17200","chr4",146521939,146522910,146522424,971
"17201","chr7",155448628,155451062,155449845,2434
"17202","chr2",89767578,89768101,89767839,523
"17203","chr6",88963165,88963860,88963512,695
"17204","chr5",65924931,65926588,65925759,1657
"17205","chr5",146342904,146343362,146343133,458
"17206","chr12",96399413,96400752,96400082,1339
"17207","chr9",62897640,62898004,62897822,364
"17208","chr17",6995501,6997108,6996304,1607
"17209","chr2",60460687,60461857,60461272,1170
"17210","chr2",88451816,88453347,88452581,1531
"17211","chr2",47175670,47176966,47176318,1296
"17212","chr13",26221672,26222575,26222123,903
"17213","chr7",23105592,23106418,23106005,826
"17214","chr17",8126355,8126772,8126563,417
"17215","chr9",109319122,109321269,109320195,2147
"17216","chr4",143335778,143337374,143336576,1596
"17217","chr6",168370457,168370960,168370708,503
"17218","chr11",70826729,70826950,70826839,221
"17219","chr11",1556475,1557861,1557168,1386
"17220","chr17",19189743,19189992,19189867,249
"17221","chr11",57712014,57712836,57712425,822
"17222","chr1",153689727,153689963,153689845,236
"17223","chr5",176680067,176680520,176680293,453
"17224","chr17",42653656,42653939,42653797,283
"17225","chr5",174724475,174725361,174724918,886
"17226","chr12",123436035,123436915,123436475,880
"17227","chr22",50091132,50091369,50091250,237
"17228","chr5",6448640,6449404,6449022,764
"17229","chr16",88006010,88006298,88006154,288
"17230","chr2",91441994,91443568,91442781,1574
"17231","chr21",45100880,45101380,45101130,500
"17232","chr19",54159365,54160172,54159768,807
"17233","chr14",59870233,59870807,59870520,574
"17234","chr20",37522518,37522838,37522678,320
"17235","chr19",41331109,41331325,41331217,216
"17236","chr17",77887721,77888246,77887983,525
"17237","chr16",67154710,67155749,67155229,1039
"17238","chr14",50944174,50944746,50944460,572
"17239","chr2",99180885,99181160,99181022,275
"17240","chr5",149141429,149141904,149141666,475
"17241","chr19",35557654,35558771,35558212,1117
"17242","chr8",20303300,20304174,20303737,874
"17243","chr3",48660902,48664234,48662568,3332
"17244","chr19",57849771,57850192,57849981,421
"17245","chr3",4986724,4987218,4986971,494
"17246","chr19",740196,740609,740402,413
"17247","chr6",117547934,117548367,117548150,433
"17248","chr4",1238025,1238441,1238233,416
"17249","chr15",29968292,29969191,29968741,899
"17250","chrX",137573750,137574926,137574338,1176
"17251","chr4",110633809,110634348,110634078,539
"17252","chr8",72075245,72075788,72075516,543
"17253","chr7",6153782,6154886,6154334,1104
"17254","chr15",35092870,35093205,35093037,335
"17255","chr19",17351912,17352328,17352120,416
"17256","chr20",63454210,63454591,63454400,381
"17257","chr4",185209430,185210742,185210086,1312
"17258","chr15",42575139,42576056,42575597,917
"17259","chr5",665944,666186,666065,242
"17260","chr11",10857555,10858906,10858230,1351
"17261","chr19",17469388,17469789,17469588,401
"17262","chr14",36514235,36514533,36514384,298
"17263","chr2",232458670,232459226,232458948,556
"17264","chr12",130337200,130339538,130338369,2338
"17265","chr12",48924703,48925507,48925105,804
"17266","chr16",88643117,88643607,88643362,490
"17267","chr6",166898764,166902542,166900653,3778
"17268","chr17",42553158,42554965,42554061,1807
"17269","chr11",66643454,66644116,66643785,662
"17270","chr15",22494480,22495093,22494786,613
"17271","chr20",35455032,35455764,35455398,732
"17272","chr4",7067371,7068675,7068023,1304
"17273","chr7",37916020,37916953,37916486,933
"17274","chr2",54455762,54457237,54456499,1475
"17275","chr2",70142007,70142998,70142502,991
"17276","chr6",154994907,154995124,154995015,217
"17277","chr2",91685021,91686499,91685760,1478
"17278","chr4",6658645,6659090,6658867,445
"17279","chrX",18220112,18220609,18220360,497
"17280","chr9",83956132,83957112,83956622,980
"17281","chr19",14074295,14074789,14074542,494
"17282","chr12",131792026,131792238,131792132,212
"17283","chr6",77650140,77650627,77650383,487
"17284","chr11",73876628,73877057,73876842,429
"17285","chr15",63503930,63505439,63504684,1509
"17286","chr3",38028903,38030107,38029505,1204
"17287","chr7",16586523,16586906,16586714,383
"17288","chr12",53999590,54000864,54000227,1274
"17289","chr15",32345943,32347275,32346609,1332
"17290","chr19",23758438,23758736,23758587,298
"17291","chr19",13116083,13116846,13116464,763
"17292","chr22",50454407,50454613,50454510,206
"17293","chr11",15073411,15074326,15073868,915
"17294","chr12",113103892,113104281,113104086,389
"17295","chr4",110636780,110637289,110637034,509
"17296","chr2",37156758,37157089,37156923,331
"17297","chr6",4021210,4021770,4021490,560
"17298","chr3",32237931,32239250,32238590,1319
"17299","chr6",41560528,41561162,41560845,634
"17300","chr11",45847191,45847862,45847526,671
"17301","chr15",68578294,68579635,68578964,1341
"17302","chr9",98118816,98119378,98119097,562
"17303","chr12",130887429,130887909,130887669,480
"17304","chr20",34677137,34677389,34677263,252
"17305","chr17",81910811,81911935,81911373,1124
"17306","chr19",21767101,21767415,21767258,314
"17307","chr9",4297817,4300182,4298999,2365
"17308","chr2",218406285,218406746,218406515,461
"17309","chr19",4909250,4910469,4909859,1219
"17310","chr22",36409984,36410592,36410288,608
"17311","chr17",44779228,44779479,44779353,251
"17312","chr16",782827,783042,782934,215
"17313","chr17",15262479,15263189,15262834,710
"17314","chr17",7685972,7686185,7686078,213
"17315","chr11",27471694,27472810,27472252,1116
"17316","chr7",154793972,154794626,154794299,654
"17317","chr17",4731272,4731935,4731603,663
"17318","chr2",27211564,27212852,27212208,1288
"17319","chr7",67302158,67303044,67302601,886
"17320","chr6",26188769,26189067,26188918,298
"17321","chr17",78450564,78450788,78450676,224
"17322","chr12",5043764,5045180,5044472,1416
"17323","chr11",74948886,74949328,74949107,442
"17324","chr6",150142635,150143866,150143250,1231
"17325","chr17",68035319,68036176,68035747,857
"17326","chr19",48203912,48204204,48204058,292
"17327","chr21",44391462,44391667,44391564,205
"17328","chr17",76557138,76558279,76557708,1141
"17329","chr15",50765342,50765926,50765634,584
"17330","chr7",63567583,63567959,63567771,376
"17331","chr19",58386354,58387511,58386932,1157
"17332","chr17",81403729,81404070,81403899,341
"17333","chr17",64129509,64130690,64130099,1181
"17334","chr16",89191344,89193223,89192283,1879
"17335","chr11",66475605,66475920,66475762,315
"17336","chr13",112485810,112486013,112485911,203
"17337","chr5",180071399,180072338,180071868,939
"17338","chr15",89416511,89416759,89416635,248
"17339","chr4",76213413,76214224,76213818,811
"17340","chr7",143836688,143837459,143837073,771
"17341","chr16",87705011,87705245,87705128,234
"17342","chr15",101961151,101962226,101961688,1075
"17343","chr5",42994524,42994834,42994679,310
"17344","chr6",56954075,56955510,56954792,1435
"17345","chr19",11420610,11420922,11420766,312
"17346","chr15",45634679,45635560,45635119,881
"17347","chr12",115916982,115917382,115917182,400
"17348","chr9",136632448,136633224,136632836,776
"17349","chr2",26692577,26693683,26693130,1106
"17350","chr17",7173702,7174569,7174135,867
"17351","chr18",62522276,62524876,62523576,2600
"17352","chr22",46296313,46297452,46296882,1139
"17353","chr9",136133371,136133986,136133678,615
"17354","chr12",127145966,127146654,127146310,688
"17355","chr19",5831584,5832286,5831935,702
"17356","chr7",66903785,66904625,66904205,840
"17357","chr22",20085840,20086408,20086124,568
"17358","chr9",26892290,26892938,26892614,648
"17359","chr14",36522389,36523283,36522836,894
"17360","chr22",48334246,48334580,48334413,334
"17361","chr14",52729890,52730732,52730311,842
"17362","chr13",28819646,28820761,28820203,1115
"17363","chr19",12766075,12766294,12766184,219
"17364","chr6",152636675,152637337,152637006,662
"17365","chr17",79137845,79138093,79137969,248
"17366","chr17",80220181,80221155,80220668,974
"17367","chr16",67399225,67399651,67399438,426
"17368","chr7",157826164,157826610,157826387,446
"17369","chr19",51002658,51003107,51002882,449
"17370","chr19",13014145,13014445,13014295,300
"17371","chr1",39104993,39106187,39105590,1194
"17372","chr5",177553788,177554788,177554288,1000
"17373","chr13",31160972,31162533,31161752,1561
"17374","chr6",144095082,144095717,144095399,635
"17375","chr11",67710841,67712124,67711482,1283
"17376","chr4",128287142,128288625,128287883,1483
"17377","chr19",10987719,10987933,10987826,214
"17378","chr19",727956,728177,728066,221
"17379","chr17",44308442,44309025,44308733,583
"17380","chr19",17950386,17950664,17950525,278
"17381","chr11",129436764,129436987,129436875,223
"17382","chr3",134361548,134361754,134361651,206
"17383","chr11",842293,843396,842844,1103
"17384","chr14",59576524,59576876,59576700,352
"17385","chr13",110625065,110625304,110625184,239
"17386","chr16",1167128,1167406,1167267,278
"17387","chr3",194136786,194138226,194137506,1440
"17388","chr1",28736554,28737803,28737178,1249
"17389","chr5",77636492,77637698,77637095,1206
"17390","chr3",25789865,25790153,25790009,288
"17391","chr12",2052378,2054382,2053380,2004
"17392","chr4",30717231,30718225,30717728,994
"17393","chr19",1775068,1776731,1775899,1663
"17394","chr4",1209168,1209412,1209290,244
"17395","chr11",69377059,69377375,69377217,316
"17396","chr17",81052243,81052555,81052399,312
"17397","chr1",31617670,31618337,31618003,667
"17398","chr8",66666459,66667190,66666824,731
"17399","chr11",65637981,65638297,65638139,316
"17400","chr4",140152364,140153483,140152923,1119
"17401","chr18",59139376,59140193,59139784,817
"17402","chr12",30169830,30170622,30170226,792
"17403","chr19",55442004,55443301,55442652,1297
"17404","chr6",13710747,13712324,13711535,1577
"17405","chr4",139555227,139557474,139556350,2247
"17406","chr19",10479005,10479365,10479185,360
"17407","chr17",54968242,54969007,54968624,765
"17408","chr19",55279906,55280450,55280178,544
"17409","chr19",35775332,35775867,35775599,535
"17410","chr12",132295757,132296000,132295878,243
"17411","chr19",39084060,39084497,39084278,437
"17412","chr1",7680083,7681057,7680570,974
"17413","chr17",79023941,79024786,79024363,845
"17414","chr19",15181588,15181821,15181704,233
"17415","chr8",58411247,58411621,58411434,374
"17416","chr7",12211094,12211588,12211341,494
"17417","chr20",3071451,3072457,3071954,1006
"17418","chr15",82646365,82648790,82647577,2425
"17419","chr11",46617087,46617936,46617511,849
"17420","chr13",30408150,30408690,30408420,540
"17421","chr6",73157861,73158124,73157992,263
"17422","chr2",128026925,128028673,128027799,1748
"17423","chr19",19860768,19861054,19860911,286
"17424","chr8",144357671,144359105,144358388,1434
"17425","chr22",37566474,37566812,37566643,338
"17426","chrX",14872869,14873612,14873240,743
"17427","chr14",100376002,100376594,100376298,592
"17428","chr11",83285599,83286493,83286046,894
"17429","chr8",142428011,142428269,142428140,258
"17430","chr15",44663093,44663785,44663439,692
"17431","chr19",540021,542033,541027,2012
"17432","chr4",2047106,2047390,2047248,284
"17433","chr2",229270992,229271435,229271213,443
"17434","chr14",104991920,104992330,104992125,410
"17435","chr14",88478842,88480193,88479517,1351
"17436","chr16",87685483,87685701,87685592,218
"17437","chr22",38120728,38121023,38120875,295
"17438","chr2",107544245,107544456,107544350,211
"17439","chr9",37422571,37422918,37422744,347
"17440","chr7",151050889,151051432,151051160,543
"17441","chr4",155758943,155760234,155759588,1291
"17442","chr22",49631437,49632767,49632102,1330
"17443","chr6",73353796,73354748,73354272,952
"17444","chr7",768906,769198,769052,292
"17445","chr20",33663317,33664026,33663671,709
"17446","chr14",36517157,36521371,36519264,4214
"17447","chr14",103738733,103738992,103738862,259
"17448","chr1",171741705,171742467,171742086,762
"17449","chr17",82292390,82293104,82292747,714
"17450","chr8",48008277,48008854,48008565,577
"17451","chr14",20435236,20435561,20435398,325
"17452","chr17",59331560,59332784,59332172,1224
"17453","chr11",64317174,64318585,64317879,1411
"17454","chr7",5488295,5488549,5488422,254
"17455","chr22",27639022,27639345,27639183,323
"17456","chr15",80251672,80252320,80251996,648
"17457","chr19",43503862,43504741,43504301,879
"17458","chr19",41397209,41397456,41397332,247
"17459","chr19",17872100,17873012,17872556,912
"17460","chr14",104334107,104334640,104334373,533
"17461","chr12",112418653,112419439,112419046,786
"17462","chr11",497179,497573,497376,394
"17463","chr14",73245580,73246203,73245891,623
"17464","chr12",124304013,124304338,124304175,325
"17465","chr2",168246440,168247944,168247192,1504
"17466","chr2",169694273,169694861,169694567,588
"17467","chr7",75914647,75915457,75915052,810
"17468","chr6",5994676,5994970,5994823,294
"17469","chr20",2509150,2509352,2509251,202
"17470","chr12",48157041,48157735,48157388,694
"17471","chr12",132205794,132206026,132205910,232
"17472","chr19",7903440,7904536,7903988,1096
"17473","chr6",46652804,46653452,46653128,648
"17474","chr14",105196590,105197066,105196828,476
"17475","chr7",151518982,151520815,151519898,1833
"17476","chr16",51113579,51114033,51113806,454
"17477","chr13",70107600,70108087,70107843,487
"17478","chr4",1841353,1841625,1841489,272
"17479","chr4",141220817,141221205,141221011,388
"17480","chr2",240998299,240999511,240998905,1212
"17481","chr14",64465161,64465824,64465492,663
"17482","chr7",152025505,152026156,152025830,651
"17483","chr2",240781533,240782697,240782115,1164
"17484","chr3",119702993,119703487,119703240,494
"17485","chr8",144058307,144058654,144058480,347
"17486","chr11",35138828,35139453,35139140,625
"17487","chr15",77634699,77635020,77634859,321
"17488","chr11",86431337,86431554,86431445,217
"17489","chr5",131634722,131635812,131635267,1090
"17490","chr13",101453814,101454137,101453975,323
"17491","chr5",1003822,1005572,1004697,1750
"17492","chr4",72569372,72569604,72569488,232
"17493","chr11",34105281,34106026,34105653,745
"17494","chr6",170175638,170177453,170176545,1815
"17495","chr10",132536798,132538191,132537494,1393
"17496","chr11",35418874,35420335,35419604,1461
"17497","chr11",78961962,78962168,78962065,206
"17498","chr19",34359166,34359682,34359424,516
"17499","chr11",31812855,31813287,31813071,432
"17500","chr13",110914139,110916019,110915079,1880
"17501","chr7",129762380,129762951,129762665,571
"17502","chr6",168072373,168072665,168072519,292
"17503","chr11",68413618,68413821,68413719,203
"17504","chr2",96857619,96858449,96858034,830
"17505","chr19",53982049,53982954,53982501,905
"17506","chr7",74375900,74376180,74376040,280
"17507","chr11",66856149,66859143,66857646,2994
"17508","chr14",20990230,20990449,20990339,219
"17509","chr19",49464191,49464594,49464392,403
"17510","chr15",83447010,83448169,83447589,1159
"17511","chr7",124764646,124766188,124765417,1542
"17512","chr5",138257646,138257895,138257770,249
"17513","chr6",35765812,35766048,35765930,236
"17514","chr17",249928,250409,250168,481
"17515","chrX",102937257,102937638,102937447,381
"17516","chr7",1602068,1602287,1602177,219
"17517","chrX",12791036,12791314,12791175,278
"17518","chr14",102544447,102545288,102544867,841
"17519","chr11",65890403,65891499,65890951,1096
"17520","chr16",4476294,4476926,4476610,632
"17521","chr8",142563711,142564312,142564011,601
"17522","chrX",39688570,39689427,39688998,857
"17523","chr14",64749095,64749493,64749294,398
"17524","chr8",88327896,88328252,88328074,356
"17525","chr19",45152035,45153855,45152945,1820
"17526","chr11",118997931,118998494,118998212,563
"17527","chr7",157441419,157442548,157441983,1129
"17528","chr14",104220820,104221038,104220929,218
"17529","chr18",22559521,22560283,22559902,762
"17530","chr15",45111050,45112020,45111535,970
"17531","chr8",144950449,144950951,144950700,502
"17532","chr1",33180725,33182272,33181498,1547
"17533","chr16",1777103,1777404,1777253,301
"17534","chr8",54021768,54022600,54022184,832
"17535","chr9",122931397,122931834,122931615,437
"17536","chr19",16878198,16878889,16878543,691
"17537","chr8",22578782,22579563,22579172,781
"17538","chr10",48466200,48466733,48466466,533
"17539","chr5",150357469,150357887,150357678,418
"17540","chr15",66700901,66704233,66702567,3332
"17541","chr15",78437890,78438763,78438326,873
"17542","chr7",51315614,51317241,51316427,1627
"17543","chr19",12938224,12938995,12938609,771
"17544","chr16",72959204,72959968,72959586,764
"17545","chr7",158188094,158188770,158188432,676
"17546","chr13",112994029,112994396,112994212,367
"17547","chrX",65551526,65552313,65551919,787
"17548","chr19",19145742,19146015,19145878,273
"17549","chr4",658876,659119,658997,243
"17550","chr16",29664524,29664799,29664661,275
"17551","chr9",127944633,127944994,127944813,361
"17552","chr4",143559388,143559794,143559591,406
"17553","chr6",1515280,1515563,1515421,283
"17554","chr16",740211,741332,740771,1121
"17555","chr14",80954950,80955217,80955083,267
"17556","chr12",57224739,57225619,57225179,880
"17557","chr17",68020003,68020243,68020123,240
"17558","chr8",7528669,7528923,7528796,254
"17559","chrX",11757665,11758817,11758241,1152
"17560","chr3",183697814,183698281,183698047,467
"17561","chr12",132773077,132773412,132773244,335
"17562","chr6",80004432,80004851,80004641,419
"17563","chr4",56978691,56979036,56978863,345
"17564","chr3",39502280,39502732,39502506,452
"17565","chr20",45822962,45823188,45823075,226
"17566","chr15",20294622,20295605,20295113,983
"17567","chr16",30526207,30527572,30526889,1365
"17568","chr19",45250985,45252003,45251494,1018
"17569","chr20",4148550,4149765,4149157,1215
"17570","chr16",22843,23151,22997,308
"17571","chr11",119727672,119729593,119728632,1921
"17572","chr14",102319593,102320201,102319897,608
"17573","chr16",228839,229496,229167,657
"17574","chr3",134406645,134407029,134406837,384
"17575","chr17",44708532,44708910,44708721,378
"17576","chr9",122828136,122828645,122828390,509
"17577","chr20",844624,845633,845128,1009
"17578","chr7",5608026,5608353,5608189,327
"17579","chr10",72625709,72626283,72625996,574
"17580","chr12",123150279,123151629,123150954,1350
"17581","chr7",1044544,1044959,1044751,415
"17582","chr15",83066488,83067337,83066912,849
"17583","chr7",35257310,35258607,35257958,1297
"17584","chr5",141235819,141236781,141236300,962
"17585","chr5",95730996,95732108,95731552,1112
"17586","chr11",18791025,18792532,18791778,1507
"17587","chr11",206975,209225,208100,2250
"17588","chr14",60656895,60657895,60657395,1000
"17589","chr17",38799003,38800127,38799565,1124
"17590","chr5",176416117,176416843,176416480,726
"17591","chr4",155376449,155376942,155376695,493
"17592","chr5",172686674,172686902,172686788,228
"17593","chr15",61228224,61229517,61228870,1293
"17594","chr8",48380641,48380987,48380814,346
"17595","chr14",63542827,63543807,63543317,980
"17596","chr7",2531603,2531877,2531740,274
"17597","chr20",53581519,53581861,53581690,342
"17598","chr9",105244186,105245640,105244913,1454
"17599","chr11",32430598,32431162,32430880,564
"17600","chr11",72434111,72434592,72434351,481
"17601","chr1",47533238,47533555,47533396,317
"17602","chr20",62386514,62387697,62387105,1183
"17603","chr14",104785064,104785280,104785172,216
"17604","chr12",108857189,108857940,108857564,751
"17605","chr19",892970,893270,893120,300
"17606","chr11",85810967,85811237,85811102,270
"17607","chr11",881368,881666,881517,298
"17608","chr19",55377637,55378108,55377872,471
"17609","chr3",196528624,196529142,196528883,518
"17610","chr8",57207972,57208236,57208104,264
"17611","chr14",94771285,94771874,94771579,589
"17612","chr17",81481192,81481801,81481496,609
"17613","chr22",37639343,37639921,37639632,578
"17614","chr17",7214277,7214766,7214521,489
"17615","chr1",181104781,181105866,181105323,1085
"17616","chr11",61294171,61295591,61294881,1420
"17617","chr2",232350970,232352846,232351908,1876
"17618","chr13",112169182,112169414,112169298,232
"17619","chr11",63762416,63764418,63763417,2002
"17620","chr17",17158630,17158872,17158751,242
"17621","chr22",30802504,30803046,30802775,542
"17622","chr11",130473061,130473757,130473409,696
"17623","chr16",88778535,88778797,88778666,262
"17624","chr2",3313905,3314164,3314034,259
"17625","chr7",43926207,43926801,43926504,594
"17626","chr16",31063763,31064435,31064099,672
"17627","chr14",24333721,24333953,24333837,232
"17628","chr15",63189250,63189955,63189602,705
"17629","chr13",113401785,113402262,113402023,477
"17630","chr1",147072439,147072891,147072665,452
"17631","chr14",105672317,105672924,105672620,607
"17632","chr9",137480914,137481129,137481021,215
"17633","chr12",6548561,6548807,6548684,246
"17634","chr8",142726370,142727892,142727131,1522
"17635","chr17",180203,182077,181140,1874
"17636","chr7",66844516,66845053,66844784,537
"17637","chr10",130189947,130191068,130190507,1121
"17638","chr12",71754697,71755560,71755128,863
"17639","chr12",27332750,27333743,27333246,993
"17640","chr14",70907247,70908685,70907966,1438
"17641","chr6",2875367,2875577,2875472,210
"17642","chr14",65411768,65413652,65412710,1884
"17643","chr11",43680466,43681047,43680756,581
"17644","chr8",2181660,2182153,2181906,493
"17645","chr17",3963765,3964801,3964283,1036
"17646","chr13",36297530,36297922,36297726,392
"17647","chr2",191677847,191678867,191678357,1020
"17648","chr15",40322898,40324712,40323805,1814
"17649","chr7",143510892,143511705,143511298,813
"17650","chr11",504189,504659,504424,470
"17651","chr22",35539934,35541490,35540712,1556
"17652","chr3",52238823,52239615,52239219,792
"17653","chr2",234096108,234096512,234096310,404
"17654","chr7",999981,1000460,1000220,479
"17655","chr12",131163269,131163830,131163549,561
"17656","chr7",152463644,152465028,152464336,1384
"17657","chr16",58045046,58045428,58045237,382
"17658","chrY",6910533,6911987,6911260,1454
"17659","chr12",12350008,12350531,12350269,523
"17660","chr22",43891617,43892181,43891899,564
"17661","chr12",57238149,57240795,57239472,2646
"17662","chr11",64258441,64259264,64258852,823
"17663","chr2",181891701,181892792,181892246,1091
"17664","chr1",15758576,15759367,15758971,791
"17665","chr10",110871656,110872718,110872187,1062
"17666","chr6",12011307,12012195,12011751,888
"17667","chr4",25862138,25863223,25862680,1085
"17668","chr1",51330222,51330917,51330569,695
"17669","chr20",50112731,50113261,50112996,530
"17670","chr1",1045688,1046020,1045854,332
"17671","chr1",200873068,200874260,200873664,1192
"17672","chr3",138937785,138940265,138939025,2480
"17673","chr14",24242165,24242806,24242485,641
"17674","chr6",117602193,117602801,117602497,608
"17675","chr7",73719058,73719685,73719371,627
"17676","chr20",58150801,58151057,58150929,256
"17677","chr1",235650980,235651188,235651084,208
"17678","chr1",240823354,240823609,240823481,255
"17679","chr8",28411686,28412473,28412079,787
"17680","chr16",1430843,1431044,1430943,201
"17681","chr9",21396072,21396365,21396218,293
"17682","chr14",24339429,24339786,24339607,357
"17683","chr15",74695825,74696328,74696076,503
"17684","chr17",62423750,62424395,62424072,645
"17685","chr1",6460524,6461895,6461209,1371
"17686","chr9",91193218,91194138,91193678,920
"17687","chr17",40779547,40779841,40779694,294
"17688","chr11",118790596,118792317,118791456,1721
"17689","chr2",231249807,231250025,231249916,218
"17690","chr13",112809877,112810099,112809988,222
"17691","chr17",27353528,27354048,27353788,520
"17692","chr13",52450020,52450803,52450411,783
"17693","chr21",45133691,45134497,45134094,806
"17694","chr9",75890314,75892204,75891259,1890
"17695","chr3",170356865,170358329,170357597,1464
"17696","chrX",119943126,119943701,119943413,575
"17697","chr7",63349231,63349434,63349332,203
"17698","chr11",32829614,32830405,32830009,791
"17699","chr13",39037551,39037979,39037765,428
"17700","chr1",43389704,43390250,43389977,546
"17701","chr11",67056647,67057150,67056898,503
"17702","chr1",151762969,151763617,151763293,648
"17703","chr19",51271174,51271440,51271307,266
"17704","chr19",54095895,54096198,54096046,303
"17705","chr4",305014,305523,305268,509
"17706","chr17",31008379,31009434,31008906,1055
"17707","chr20",63769893,63770183,63770038,290
"17708","chr9",137618440,137619520,137618980,1080
"17709","chr16",29285160,29285400,29285280,240
"17710","chr16",58001086,58001295,58001190,209
"17711","chr18",50281487,50282995,50282241,1508
"17712","chr14",61864291,61864923,61864607,632
"17713","chr20",63955566,63956865,63956215,1299
"17714","chr9",132770054,132770375,132770214,321
"17715","chr13",36130903,36131570,36131236,667
"17716","chr1",11690644,11692594,11691619,1950
"17717","chr16",1149824,1150098,1149961,274
"17718","chr3",26622613,26623305,26622959,692
"17719","chr17",64778248,64781679,64779963,3431
"17720","chr3",183253185,183254847,183254016,1662
"17721","chr1",205528875,205529462,205529168,587
"17722","chr1",204257416,204257780,204257598,364
"17723","chr8",80485842,80487369,80486605,1527
"17724","chr1",156420611,156421927,156421269,1316
"17725","chr1",45205667,45206716,45206191,1049
"17726","chr8",57279940,57280325,57280132,385
"17727","chr16",511443,511648,511545,205
"17728","chr2",66445299,66446504,66445901,1205
"17729","chr16",565682,565927,565804,245
"17730","chr2",15591668,15592370,15592019,702
"17731","chr4",25233836,25234624,25234230,788
"17732","chr18",64002635,64003021,64002828,386
"17733","chr6",149566181,149567116,149566648,935
"17734","chr12",57627511,57628254,57627882,743
"17735","chr4",6640467,6641595,6641031,1128
"17736","chr7",16526627,16527049,16526838,422
"17737","chr1",21651791,21652220,21652005,429
"17738","chr2",61470222,61471665,61470943,1443
"17739","chr2",207529231,207530653,207529942,1422
"17740","chr9",98807620,98808067,98807843,447
"17741","chr22",45240189,45240832,45240510,643
"17742","chr6",24910398,24911358,24910878,960
"17743","chr16",48384516,48385990,48385253,1474
"17744","chr2",219447976,219449372,219448674,1396
"17745","chr1",935577,935956,935766,379
"17746","chr9",93292777,93293130,93292953,353
"17747","chr15",85768922,85769816,85769369,894
"17748","chr11",64230190,64230967,64230578,777
"17749","chr1",18107611,18108319,18107965,708
"17750","chr17",62477986,62479807,62478896,1821
"17751","chr2",85132833,85135470,85134151,2637
"17752","chr11",118145522,118146269,118145895,747
"17753","chr4",78058888,78059256,78059072,368
"17754","chr19",4791182,4793205,4792193,2023
"17755","chr17",17681166,17683047,17682106,1881
"17756","chr5",141422832,141423265,141423048,433
"17757","chrX",16785756,16787306,16786531,1550
"17758","chr4",56544643,56545054,56544848,411
"17759","chr16",89526761,89526987,89526874,226
"17760","chr22",48692946,48693150,48693048,204
"17761","chr1",27360533,27361252,27360892,719
"17762","chr17",82716461,82717360,82716910,899
"17763","chr12",4445239,4445458,4445348,219
"17764","chr7",158310644,158310909,158310776,265
"17765","chr5",50440773,50441466,50441119,693
"17766","chr17",82236548,82236901,82236724,353
"17767","chr20",62378358,62378612,62378485,254
"17768","chr7",158097964,158098865,158098414,901
"17769","chr2",227325120,227325785,227325452,665
"17770","chr2",19362988,19363204,19363096,216
"17771","chr7",73377397,73378036,73377716,639
"17772","chr13",19560126,19560345,19560235,219
"17773","chr4",110639407,110639652,110639529,245
"17774","chr14",88554505,88555155,88554830,650
"17775","chr16",58487665,58487937,58487801,272
"17776","chrX",49186223,49186606,49186414,383
"17777","chr4",1394826,1395642,1395234,816
"17778","chr9",125240666,125241693,125241179,1027
"17779","chr16",373871,374423,374147,552
"17780","chr2",26401735,26402189,26401962,454
"17781","chr19",19663182,19663958,19663570,776
"17782","chr15",74781834,74782805,74782319,971
"17783","chr20",63101923,63103169,63102546,1246
"17784","chr17",82964492,82964936,82964714,444
"17785","chr4",163494257,163495034,163494645,777
"17786","chr4",7664292,7664620,7664456,328
"17787","chr3",52278053,52279041,52278547,988
"17788","chr11",125904124,125904689,125904406,565
"17789","chr6",101398890,101399259,101399074,369
"17790","chr17",74922900,74924924,74923912,2024
"17791","chr11",124746704,124746930,124746817,226
"17792","chr9",20620425,20622246,20621335,1821
"17793","chr6",73369666,73370000,73369833,334
"17794","chr2",74414606,74416223,74415414,1617
"17795","chrX",42777757,42778256,42778006,499
"17796","chr11",73234234,73235183,73234708,949
"17797","chr2",27071271,27072047,27071659,776
"17798","chr11",776803,777998,777400,1195
"17799","chr2",233251454,233252089,233251771,635
"17800","chr20",31996517,31996975,31996746,458
"17801","chr19",46600529,46601607,46601068,1078
"17802","chrX",136146788,136147890,136147339,1102
"17803","chr18",55589787,55590078,55589932,291
"17804","chr11",88337333,88337874,88337603,541
"17805","chr2",1891925,1892160,1892042,235
"17806","chr19",12825697,12826076,12825886,379
"17807","chr9",98255100,98256299,98255699,1199
"17808","chr13",112819766,112820038,112819902,272
"17809","chr12",101877099,101878023,101877561,924
"17810","chr20",1777133,1777488,1777310,355
"17811","chr12",12716830,12718314,12717572,1484
"17812","chr7",128271666,128272141,128271903,475
"17813","chr17",30378762,30379800,30379281,1038
"17814","chr3",156674022,156675818,156674920,1796
"17815","chr4",173538049,173538903,173538476,854
"17816","chr9",134842307,134842629,134842468,322
"17817","chr3",193240920,193241584,193241252,664
"17818","chr11",67504188,67505471,67504829,1283
"17819","chr17",73285726,73286469,73286097,743
"17820","chr14",104794997,104796102,104795549,1105
"17821","chr6",43284996,43285738,43285367,742
"17822","chr7",100633026,100633697,100633361,671
"17823","chr2",97723934,97724496,97724215,562
"17824","chr16",67993171,67993493,67993332,322
"17825","chr17",74430644,74432838,74431741,2194
"17826","chr12",118980786,118981029,118980907,243
"17827","chr8",1630872,1631075,1630973,203
"17828","chr2",130693484,130693839,130693661,355
"17829","chr17",17561821,17562083,17561952,262
"17830","chr6",43368742,43370094,43369418,1352
"17831","chr9",97411817,97412664,97412240,847
"17832","chr19",11196819,11198033,11197426,1214
"17833","chr13",110990093,110990314,110990203,221
"17834","chr5",173238303,173239069,173238686,766
"17835","chr21",41689189,41689527,41689358,338
"17836","chr7",1547604,1548057,1547830,453
"17837","chr9",134641665,134642551,134642108,886
"17838","chr3",25783654,25783965,25783809,311
"17839","chr12",110048278,110048769,110048523,491
"17840","chr12",57236323,57236686,57236504,363
"17841","chr8",43276034,43276344,43276189,310
"17842","chr16",377415,377832,377623,417
"17843","chr1",247857028,247857950,247857489,922
"17844","chrX",10620159,10620446,10620302,287
"17845","chr9",96854119,96854658,96854388,539
"17846","chr14",24299414,24300158,24299786,744
"17847","chr8",144786805,144787528,144787166,723
"17848","chr9",137818479,137819673,137819076,1194
"17849","chr11",108222484,108223242,108222863,758
"17850","chr19",6425474,6425832,6425653,358
"17851","chr12",53231845,53232209,53232027,364
"17852","chr12",57087014,57089333,57088173,2319
"17853","chr17",78313871,78314470,78314170,599
"17854","chr14",35292194,35292648,35292421,454
"17855","chr6",90295076,90297225,90296150,2149
"17856","chr6",170421307,170421799,170421553,492
"17857","chr17",8476854,8477221,8477037,367
"17858","chr13",114018026,114018257,114018141,231
"17859","chr17",49880563,49880784,49880673,221
"17860","chr6",3224682,3225400,3225041,718
"17861","chr11",1435218,1435622,1435420,404
"17862","chr17",82856734,82856962,82856848,228
"17863","chr17",22454039,22454961,22454500,922
"17864","chr5",181223099,181223679,181223389,580
"17865","chr7",44884444,44885854,44885149,1410
"17866","chr7",97002071,97002488,97002279,417
"17867","chr14",105469927,105470207,105470067,280
"17868","chr17",78254171,78254747,78254459,576
"17869","chr8",1417008,1417337,1417172,329
"17870","chr17",321188,321549,321368,361
"17871","chrX",37685551,37686166,37685858,615
"17872","chr11",68903639,68904153,68903896,514
"17873","chr14",90256511,90256958,90256734,447
"17874","chr17",41918038,41919127,41918582,1089
"17875","chr11",120239788,120240179,120239983,391
"17876","chr2",46940719,46941839,46941279,1120
"17877","chr2",238203040,238203878,238203459,838
"17878","chr15",31483153,31484785,31483969,1632
"17879","chr1",63367438,63368150,63367794,712
"17880","chr20",23357773,23358441,23358107,668
"17881","chr2",94998213,94998511,94998362,298
"17882","chr5",139680970,139681349,139681159,379
"17883","chr5",77640301,77641159,77640730,858
"17884","chr1",40373712,40374350,40374031,638
"17885","chr2",107826823,107830045,107828434,3222
"17886","chr16",89166002,89166275,89166138,273
"17887","chr6",1379458,1379779,1379618,321
"17888","chr17",36482667,36483318,36482992,651
"17889","chr15",72184335,72184628,72184481,293
"17890","chr2",128471419,128471659,128471539,240
"17891","chr12",132389231,132389496,132389363,265
"17892","chr18",62324836,62326323,62325579,1487
"17893","chrX",107506649,107507632,107507140,983
"17894","chr12",131164704,131165063,131164883,359
"17895","chr7",157409676,157410431,157410053,755
"17896","chr1",150364355,150364580,150364467,225
"17897","chr5",169463,169683,169573,220
"17898","chr18",78502285,78503098,78502691,813
"17899","chr1",1013290,1013514,1013402,224
"17900","chr15",41283843,41284338,41284090,495
"17901","chr1",196608578,196608881,196608729,303
"17902","chr16",88698633,88698991,88698812,358
"17903","chr17",44911373,44911780,44911576,407
"17904","chr15",99997447,99997661,99997554,214
"17905","chr5",16936644,16936848,16936746,204
"17906","chr13",46437967,46438305,46438136,338
"17907","chr14",74257525,74258671,74258098,1146
"17908","chr15",41621135,41622162,41621648,1027
"17909","chr16",599465,600057,599761,592
"17910","chr14",101634828,101635259,101635043,431
"17911","chr20",62310911,62311124,62311017,213
"17912","chr6",79233686,79234833,79234259,1147
"17913","chr1",3121503,3121779,3121641,276
"17914","chr19",56393267,56393986,56393626,719
"17915","chr5",1170587,1170826,1170706,239
"17916","chr2",69437159,69437684,69437421,525
"17917","chr19",50826956,50827214,50827085,258
"17918","chr12",53097788,53098171,53097979,383
"17919","chr11",73362073,73362688,73362380,615
"17920","chr19",947547,947981,947764,434
"17921","chr1",213015177,213015482,213015329,305
"17922","chr1",179293636,179294186,179293911,550
"17923","chr2",86562851,86563519,86563185,668
"17924","chr14",46651665,46651956,46651810,291
"17925","chr21",46391215,46391436,46391325,221
"17926","chr1",34976636,34977276,34976956,640
"17927","chr1",116418560,116418920,116418740,360
"17928","chr7",149771637,149773965,149772801,2328
"17929","chr21",10616675,10616948,10616811,273
"17930","chr11",86954859,86956247,86955553,1388
"17931","chr8",144326321,144327554,144326937,1233
"17932","chr3",55483630,55483911,55483770,281
"17933","chr5",58582898,58583350,58583124,452
"17934","chr4",55157583,55157899,55157741,316
"17935","chr5",93583852,93585724,93584788,1872
"17936","chr4",119454591,119455208,119454899,617
"17937","chr8",140464319,140464951,140464635,632
"17938","chr12",48977907,48981767,48979837,3860
"17939","chr7",100705391,100706456,100705923,1065
"17940","chr2",201116339,201116966,201116652,627
"17941","chr20",63322554,63323056,63322805,502
"17942","chr15",89486700,89487097,89486898,397
"17943","chr8",143323073,143323689,143323381,616
"17944","chr5",148826512,148826919,148826715,407
"17945","chr17",76382767,76386432,76384599,3665
"17946","chr15",82709255,82710316,82709785,1061
"17947","chr8",119855545,119856106,119855825,561
"17948","chr6",168412997,168413362,168413179,365
"17949","chr1",145957606,145958063,145957834,457
"17950","chr1",35882900,35883201,35883050,301
"17951","chr17",7204985,7205335,7205160,350
"17952","chr1",211326589,211327294,211326941,705
"17953","chr1",65420173,65421021,65420597,848
"17954","chr1",22120027,22120450,22120238,423
"17955","chr9",129626065,129626469,129626267,404
"17956","chr16",997494,998070,997782,576
"17957","chr20",63658893,63659109,63659001,216
"17958","chr10",45224264,45224755,45224509,491
"17959","chr17",57987469,57988690,57988079,1221
"17960","chr10",27154101,27154476,27154288,375
"17961","chr4",138561374,138562101,138561737,727
"17962","chr1",3795834,3796668,3796251,834
"17963","chr16",53502589,53503773,53503181,1184
"17964","chr6",170584171,170584810,170584490,639
"17965","chr1",1218404,1219039,1218721,635
"17966","chr16",34135993,34136888,34136440,895
"17967","chr12",49345051,49347025,49346038,1974
"17968","chr16",66427439,66428310,66427874,871
"17969","chr21",46182517,46182826,46182671,309
"17970","chr11",31369540,31369951,31369745,411
"17971","chr6",7261085,7261385,7261235,300
"17972","chr1",212791524,212792005,212791764,481
"17973","chr4",4862729,4863107,4862918,378
"17974","chr8",142325885,142326687,142326286,802
"17975","chr1",15731802,15732010,15731906,208
"17976","chrX",107272468,107273138,107272803,670
"17977","chr15",24878210,24878561,24878385,351
"17978","chr9",124487266,124487717,124487491,451
"17979","chr11",67391699,67392500,67392099,801
"17980","chr1",108421127,108421669,108421398,542
"17981","chr8",27921564,27922250,27921907,686
"17982","chr15",34209500,34210298,34209899,798
"17983","chr22",41957655,41957926,41957790,271
"17984","chr16",89433617,89433818,89433717,201
"17985","chr3",119579437,119580136,119579786,699
"17986","chr1",185045237,185046088,185045662,851
"17987","chr5",177604164,177604583,177604373,419
"17988","chr4",80188733,80189306,80189019,573
"17989","chr1",235993573,235993971,235993772,398
"17990","chr7",27243789,27243995,27243892,206
"17991","chr4",189363823,189364380,189364101,557
"17992","chr2",222298227,222299193,222298710,966
"17993","chr5",3535516,3536241,3535878,725
"17994","chr22",29072651,29074245,29073448,1594
"17995","chr6",50850467,50850718,50850592,251
"17996","chr7",815671,817110,816390,1439
"17997","chr14",76775967,76776266,76776116,299
"17998","chr8",115669153,115669396,115669274,243
"17999","chr3",10164765,10165340,10165052,575
"18000","chr7",130486176,130486960,130486568,784
"18001","chr11",396685,398880,397782,2195
"18002","chr5",14581388,14582460,14581924,1072
"18003","chr14",36662568,36663580,36663074,1012
"18004","chr1",21936853,21937784,21937318,931
"18005","chr12",51424676,51425382,51425029,706
"18006","chr22",31104410,31105253,31104831,843
"18007","chr4",1806074,1806332,1806203,258
"18008","chr1",220272138,220272591,220272364,453
"18009","chr2",37324207,37325403,37324805,1196
"18010","chr14",94773038,94773342,94773190,304
"18011","chrX",145821447,145821649,145821548,202
"18012","chr8",60516615,60517614,60517114,999
"18013","chr1",18643054,18644245,18643649,1191
"18014","chr17",8376435,8376791,8376613,356
"18015","chr6",167735167,167735385,167735276,218
"18016","chr17",68196222,68199732,68197977,3510
"18017","chr20",6767405,6768899,6768152,1494
"18018","chr7",11831781,11832018,11831899,237
"18019","chr16",21757089,21757304,21757196,215
"18020","chr2",218781709,218782458,218782083,749
"18021","chr6",84033638,84034229,84033933,591
"18022","chrX",154463825,154464253,154464039,428
"18023","chr9",42288354,42288836,42288595,482
"18024","chr20",21395720,21397607,21396663,1887
"18025","chr17",82871657,82871995,82871826,338
"18026","chr3",36380210,36380718,36380464,508
"18027","chr6",21664276,21664947,21664611,671
"18028","chr17",4004084,4004409,4004246,325
"18029","chr19",708530,708742,708636,212
"18030","chr17",48726841,48727053,48726947,212
"18031","chr1",6470612,6470818,6470715,206
"18032","chr1",38859143,38860049,38859596,906
"18033","chr9",114611204,114611796,114611500,592
"18034","chr6",11043680,11044973,11044326,1293
"18035","chr19",2307567,2308445,2308006,878
"18036","chr17",20784256,20784600,20784428,344
"18037","chr1",149102912,149103904,149103408,992
"18038","chr5",177366958,177367840,177367399,882
"18039","chr5",114055374,114056308,114055841,934
"18040","chr17",15999186,16000374,15999780,1188
"18041","chr14",58297789,58298243,58298016,454
"18042","chr1",46532960,46533577,46533268,617
"18043","chr14",105300221,105301659,105300940,1438
"18044","chr14",54509593,54510277,54509935,684
"18045","chr16",1740292,1740707,1740499,415
"18046","chr14",39114254,39114497,39114375,243
"18047","chr9",131394269,131394865,131394567,596
"18048","chr4",1326310,1326513,1326411,203
"18049","chr3",42654036,42655083,42654559,1047
"18050","chr1",67053862,67054456,67054159,594
"18051","chr4",145481387,145482831,145482109,1444
"18052","chr7",75527258,75528194,75527726,936
"18053","chr18",63318270,63321053,63319661,2783
"18054","chr17",75514935,75517095,75516015,2160
"18055","chr11",64119883,64120128,64120005,245
"18056","chr19",1566678,1568835,1567756,2157
"18057","chr7",149224163,149224745,149224454,582
"18058","chr1",9264628,9264957,9264792,329
"18059","chr11",75429692,75430804,75430248,1112
"18060","chrX",103310386,103311106,103310746,720
"18061","chr6",27139359,27139615,27139487,256
"18062","chr17",32486159,32488221,32487190,2062
"18063","chr14",73886499,73887128,73886813,629
"18064","chr12",132559806,132560894,132560350,1088
"18065","chr17",42824141,42824404,42824272,263
"18066","chr5",177446348,177447736,177447042,1388
"18067","chr16",71441431,71442035,71441733,604
"18068","chr6",31652963,31653381,31653172,418
"18069","chr17",58517719,58518258,58517988,539
"18070","chr1",228486645,228487914,228487279,1269
"18071","chr7",44748424,44749520,44748972,1096
"18072","chr1",228463746,228464828,228464287,1082
"18073","chr11",7251526,7253004,7252265,1478
"18074","chr8",143295760,143297105,143296432,1345
"18075","chr11",66545698,66546351,66546024,653
"18076","chr4",3041291,3041820,3041555,529
"18077","chr17",40287563,40287900,40287731,337
"18078","chr7",151432035,151432255,151432145,220
"18079","chr11",15650143,15650368,15650255,225
"18080","chr6",10390655,10390865,10390760,210
"18081","chr5",55226474,55227705,55227089,1231
"18082","chr17",82248813,82249051,82248932,238
"18083","chr2",3518499,3519846,3519172,1347
"18084","chr6",138403480,138405078,138404279,1598
"18085","chr15",41493418,41496341,41494879,2923
"18086","chr1",183472490,183473120,183472805,630
"18087","chr5",127290361,127291209,127290785,848
"18088","chr5",16935446,16936539,16935992,1093
"18089","chr17",83039209,83039631,83039420,422
"18090","chr7",4747130,4747356,4747243,226
"18091","chr11",78079432,78080055,78079743,623
"18092","chr9",83979411,83981227,83980319,1816
"18093","chr13",23547064,23547326,23547195,262
"18094","chr11",121127677,121128177,121127927,500
"18095","chr12",104288823,104289215,104289019,392
"18096","chr1",67685230,67686587,67685908,1357
"18097","chr8",6707793,6709137,6708465,1344
"18098","chr11",119107168,119108075,119107621,907
"18099","chr4",189314418,189314876,189314647,458
"18100","chr2",239644415,239644950,239644682,535
"18101","chr12",132391426,132392618,132392022,1192
"18102","chr9",72364229,72365828,72365028,1599
"18103","chr12",124416518,124416895,124416706,377
"18104","chr9",136686517,136687425,136686971,908
"18105","chr4",6470448,6472807,6471627,2359
"18106","chr5",132556872,132557265,132557068,393
"18107","chr3",119240492,119241087,119240789,595
"18108","chrX",49598934,49599547,49599240,613
"18109","chrX",47561003,47561700,47561351,697
"18110","chr19",15174068,15174398,15174233,330
"18111","chr3",125766375,125767117,125766746,742
"18112","chr11",61339238,61339455,61339346,217
"18113","chr1",109984626,109985404,109985015,778
"18114","chr14",74084623,74085003,74084813,380
"18115","chr1",180631891,180632680,180632285,789
"18116","chr5",1725871,1726212,1726041,341
"18117","chr4",4864711,4865086,4864898,375
"18118","chr8",109644566,109645062,109644814,496
"18119","chr1",15727121,15727480,15727300,359
"18120","chr4",1050646,1051085,1050865,439
"18121","chr12",68746035,68746426,68746230,391
"18122","chr4",49161440,49161739,49161589,299
"18123","chr5",150132737,150132967,150132852,230
"18124","chr11",71639299,71639952,71639625,653
"18125","chrX",129953098,129953512,129953305,414
"18126","chr5",43037157,43037418,43037287,261
"18127","chr3",184314378,184315454,184314916,1076
"18128","chr3",183447450,183447879,183447664,429
"18129","chr17",48718872,48719930,48719401,1058
"18130","chr11",63974428,63975142,63974785,714
"18131","chr7",157701818,157702047,157701932,229
"18132","chr22",21933974,21934188,21934081,214
"18133","chr4",54657242,54659130,54658186,1888
"18134","chr3",57170141,57170389,57170265,248
"18135","chr1",150321386,150321691,150321538,305
"18136","chr13",78658687,78659282,78658984,595
"18137","chr10",32346289,32347727,32347008,1438
"18138","chr5",53560835,53561040,53560937,205
"18139","chr14",104178463,104178737,104178600,274
"18140","chr7",1458939,1459970,1459454,1031
"18141","chr8",1691725,1692446,1692085,721
"18142","chr17",20588961,20589382,20589171,421
"18143","chr11",1927685,1927958,1927821,273
"18144","chr2",172094539,172097326,172095932,2787
"18145","chr2",2185428,2186366,2185897,938
"18146","chr1",1889966,1891833,1890899,1867
"18147","chr17",7484212,7485007,7484609,795
"18148","chr20",324242,327679,325960,3437
"18149","chr11",64358958,64359488,64359223,530
"18150","chr20",61773042,61773372,61773207,330
"18151","chr11",68438457,68438658,68438557,201
"18152","chr9",111795007,111795296,111795151,289
"18153","chr17",47693741,47695627,47694684,1886
"18154","chr1",245590097,245590334,245590215,237
"18155","chr8",98117206,98117627,98117416,421
"18156","chr19",52856948,52857207,52857077,259
"18157","chr3",46898365,46898808,46898586,443
"18158","chr2",241843759,241844464,241844111,705
"18159","chr19",2578958,2579184,2579071,226
"18160","chr7",120272786,120273829,120273307,1043
"18161","chr7",975062,975603,975332,541
"18162","chr6",136822497,136823307,136822902,810
"18163","chr11",23730407,23730815,23730611,408
"18164","chrX",40623122,40623961,40623541,839
"18165","chr17",81453118,81453411,81453264,293
"18166","chr5",98928042,98929827,98928934,1785
"18167","chr5",138438890,138439353,138439121,463
"18168","chr10",133087694,133089115,133088404,1421
"18169","chr14",101587531,101587826,101587678,295
"18170","chr7",151248266,151249409,151248837,1143
"18171","chr17",7324110,7324379,7324244,269
"18172","chr9",96218211,96218477,96218344,266
"18173","chr3",147413279,147413546,147413412,267
"18174","chr2",130797523,130798356,130797939,833
"18175","chr20",49187816,49188623,49188219,807
"18176","chr12",41573463,41573673,41573568,210
"18177","chr16",85137413,85137717,85137565,304
"18178","chr17",36932088,36932323,36932205,235
"18179","chr1",223992560,223993122,223992841,562
"18180","chr7",100573525,100574663,100574094,1138
"18181","chr2",47569784,47572027,47570905,2243
"18182","chr2",225582000,225583015,225582507,1015
"18183","chr5",1746254,1746935,1746594,681
"18184","chr1",18482379,18483173,18482776,794
"18185","chr22",43142907,43143520,43143213,613
"18186","chr7",94509710,94510637,94510173,927
"18187","chrX",107716148,107716684,107716416,536
"18188","chr12",6824110,6824439,6824274,329
"18189","chr8",124371576,124373196,124372386,1620
"18190","chr5",50969251,50969903,50969577,652
"18191","chr4",82561479,82561938,82561708,459
"18192","chr12",131949605,131950696,131950150,1091
"18193","chr5",157858761,157859246,157859003,485
"18194","chr8",109973884,109974754,109974319,870
"18195","chr5",135038695,135041061,135039878,2366
"18196","chr3",158801720,158802540,158802130,820
"18197","chr17",1230202,1230459,1230330,257
"18198","chr12",131827894,131831194,131829544,3300
"18199","chr10",12068701,12069300,12069000,599
"18200","chr7",56051352,56052270,56051811,918
"18201","chr3",12993350,12995187,12994268,1837
"18202","chr5",88141278,88141688,88141483,410
"18203","chr14",34873639,34875320,34874479,1681
"18204","chr12",129699996,129700307,129700151,311
"18205","chr13",112774863,112775079,112774971,216
"18206","chr22",23913823,23914212,23914017,389
"18207","chrX",96684631,96685367,96684999,736
"18208","chr9",133332495,133332734,133332614,239
"18209","chr21",32771142,32771830,32771486,688
"18210","chrX",24024718,24025977,24025347,1259
"18211","chr7",155070087,155070364,155070225,277
"18212","chr3",4868278,4868853,4868565,575
"18213","chr1",35807898,35808860,35808379,962
"18214","chr12",2229996,2230449,2230222,453
"18215","chr1",28914256,28915457,28914856,1201
"18216","chr15",52678533,52679689,52679111,1156
"18217","chrX",16946480,16947349,16946914,869
"18218","chr12",57726126,57727768,57726947,1642
"18219","chr7",39566177,39566777,39566477,600
"18220","chr11",518682,520297,519489,1615
"18221","chr16",66801368,66801887,66801627,519
"18222","chr3",51967396,51968051,51967723,655
"18223","chr14",104700940,104701164,104701052,224
"18224","chr15",78540322,78540953,78540637,631
"18225","chr14",90573356,90573612,90573484,256
"18226","chr1",234356738,234356967,234356852,229
"18227","chr12",34338071,34338336,34338203,265
"18228","chr3",195270258,195271749,195271003,1491
"18229","chr19",12918980,12919541,12919260,561
"18230","chr17",39980403,39981237,39980820,834
"18231","chr2",232875958,232877169,232876563,1211
"18232","chr9",97307608,97308069,97307838,461
"18233","chr10",46556321,46557169,46556745,848
"18234","chr5",72107050,72109041,72108045,1991
"18235","chr16",153754,154867,154310,1113
"18236","chr5",139560999,139562207,139561603,1208
"18237","chr10",72273409,72274940,72274174,1531
"18238","chr17",4745761,4745983,4745872,222
"18239","chr13",45340482,45341521,45341001,1039
"18240","chr9",15422523,15423202,15422862,679
"18241","chr21",44285545,44286161,44285853,616
"18242","chr5",102754735,102755537,102755136,802
"18243","chr17",1006741,1007202,1006971,461
"18244","chr9",135786262,135786621,135786441,359
"18245","chr13",20301379,20302075,20301727,696
"18246","chr20",39049930,39050458,39050194,528
"18247","chr2",222305767,222306421,222306094,654
"18248","chr14",37197481,37198288,37197884,807
"18249","chr20",61023787,61024249,61024018,462
"18250","chr17",3985074,3985348,3985211,274
"18251","chr12",113056584,113057729,113057156,1145
"18252","chr14",106398893,106399241,106399067,348
"18253","chr7",987141,987514,987327,373
"18254","chr7",35537441,35537660,35537550,219
"18255","chr15",76337688,76343174,76340431,5486
"18256","chr14",61812750,61813301,61813025,551
"18257","chr12",132446090,132446327,132446208,237
"18258","chr22",50474121,50475428,50474774,1307
"18259","chr12",27022409,27022910,27022659,501
"18260","chr22",23145181,23145783,23145482,602
"18261","chr5",77844718,77845090,77844904,372
"18262","chr3",51955747,51956623,51956185,876
"18263","chr1",2911220,2911729,2911474,509
"18264","chr5",142356684,142357415,142357049,731
"18265","chr3",114152763,114152966,114152864,203
"18266","chr11",68038784,68039144,68038964,360
"18267","chr9",133969067,133969270,133969168,203
"18268","chr11",64267388,64267594,64267491,206
"18269","chr19",12828601,12828848,12828724,247
"18270","chr7",4836393,4836598,4836495,205
"18271","chr9",128907603,128908813,128908208,1210
"18272","chr9",113349383,113349909,113349646,526
"18273","chr20",62330841,62331387,62331114,546
"18274","chr22",19736768,19737001,19736884,233
"18275","chr21",45633140,45634490,45633815,1350
"18276","chr16",81006411,81007720,81007065,1309
"18277","chr11",110711116,110713160,110712138,2044
"18278","chr10",93496376,93496805,93496590,429
"18279","chr5",77775821,77776479,77776150,658
"18280","chr22",41301384,41302597,41301990,1213
"18281","chr3",127547894,127548239,127548066,345
"18282","chr15",78565383,78565927,78565655,544
"18283","chr4",8374979,8375256,8375117,277
"18284","chr11",115502856,115505163,115504009,2307
"18285","chr10",80408308,80409161,80408734,853
"18286","chr12",32896367,32897109,32896738,742
"18287","chr6",146543383,146544290,146543836,907
"18288","chr16",49407062,49407390,49407226,328
"18289","chr16",1450248,1450599,1450423,351
"18290","chr12",80716946,80717347,80717146,401
"18291","chr12",132203563,132203846,132203704,283
"18292","chrX",154468158,154468525,154468341,367
"18293","chr11",108497771,108498680,108498225,909
"18294","chr19",17294150,17294568,17294359,418
"18295","chr14",105167214,105169436,105168325,2222
"18296","chr4",955525,955904,955714,379
"18297","chr6",160931052,160931354,160931203,302
"18298","chr7",29649295,29649741,29649518,446
"18299","chr4",121823402,121824112,121823757,710
"18300","chr22",23882463,23882860,23882661,397
"18301","chr14",104677910,104678166,104678038,256
"18302","chr12",131799909,131800140,131800024,231
"18303","chr19",35154694,35155144,35154919,450
"18304","chr3",84959133,84959686,84959409,553
"18305","chr1",37752518,37753223,37752870,705
"18306","chr7",44962512,44963246,44962879,734
"18307","chr6",169667750,169668083,169667916,333
"18308","chr10",86262883,86263522,86263202,639
"18309","chr12",54279538,54279766,54279652,228
"18310","chr3",194269636,194269969,194269802,333
"18311","chr5",79069475,79069888,79069681,413
"18312","chr16",1342543,1342752,1342647,209
"18313","chr4",141636235,141637170,141636702,935
"18314","chr5",145936582,145936791,145936686,209
"18315","chr19",50162890,50163257,50163073,367
"18316","chr8",80171413,80171822,80171617,409
"18317","chr19",37594247,37594910,37594578,663
"18318","chr14",36666308,36667143,36666725,835
"18319","chr14",55579916,55581268,55580592,1352
"18320","chr15",40941635,40942193,40941914,558
"18321","chr11",77138021,77138519,77138270,498
"18322","chr5",139709227,139711428,139710327,2201
"18323","chr10",31928339,31929464,31928901,1125
"18324","chr4",7510141,7510701,7510421,560
"18325","chr5",95834913,95835151,95835032,238
"18326","chr8",144392060,144393786,144392923,1726
"18327","chr8",143892470,143892712,143892591,242
"18328","chr17",28661703,28662373,28662038,670
"18329","chr19",2272702,2273247,2272974,545
"18330","chrX",53224601,53225644,53225122,1043
"18331","chr4",1315416,1315629,1315522,213
"18332","chr7",158992570,158993080,158992825,510
"18333","chr9",130919034,130919274,130919154,240
"18334","chr19",15331450,15332479,15331964,1029
"18335","chr12",93441159,93442313,93441736,1154
"18336","chr15",74906298,74907153,74906725,855
"18337","chr19",290594,292249,291421,1655
"18338","chr7",104983890,104984401,104984145,511
"18339","chr16",4682829,4683183,4683006,354
"18340","chr6",13924697,13925279,13924988,582
"18341","chr19",12891603,12891842,12891722,239
"18342","chr11",62925901,62927300,62926600,1399
"18343","chr14",105486266,105487959,105487112,1693
"18344","chr14",70046075,70046277,70046176,202
"18345","chr3",56556911,56557195,56557053,284
"18346","chr17",81666226,81667200,81666713,974
"18347","chr17",30116728,30116993,30116860,265
"18348","chr14",102554994,102555653,102555323,659
"18349","chr5",1334962,1335165,1335063,203
"18350","chrX",8730816,8732459,8731637,1643
"18351","chr3",4983075,4983282,4983178,207
"18352","chr12",102917262,102917475,102917368,213
"18353","chr19",53906712,53906946,53906829,234
"18354","chr19",49107915,49108153,49108034,238
"18355","chr18",46333382,46333989,46333685,607
"18356","chr12",74537712,74538099,74537905,387
"18357","chr19",44647097,44647562,44647329,465
"18358","chr20",18507440,18508160,18507800,720
"18359","chr16",67561965,67563651,67562808,1686
"18360","chr16",3106248,3106888,3106568,640
"18361","chr5",55994507,55995561,55995034,1054
"18362","chr2",176085867,176086118,176085992,251
"18363","chr14",99659334,99660357,99659845,1023
"18364","chr13",112841006,112841424,112841215,418
"18365","chr22",38569728,38570723,38570225,995
"18366","chr8",132675327,132675752,132675539,425
"18367","chr14",93332363,93333458,93332910,1095
"18368","chr11",120564113,120565231,120564672,1118
"18369","chr1",247210433,247211002,247210717,569
"18370","chr4",1112581,1112782,1112681,201
"18371","chr3",182979961,182980943,182980452,982
"18372","chr6",125747576,125750174,125748875,2598
"18373","chr14",50396370,50397164,50396767,794
"18374","chr15",30222977,30226242,30224609,3265
"18375","chr7",100826802,100828004,100827403,1202
"18376","chr11",58905378,58905815,58905596,437
"18377","chr12",52965456,52965723,52965589,267
"18378","chr8",143334542,143335094,143334818,552
"18379","chr2",111897914,111899341,111898627,1427
"18380","chr2",88016714,88017340,88017027,626
"18381","chr20",543560,543859,543709,299
"18382","chr8",143804941,143805492,143805216,551
"18383","chr9",137213048,137213321,137213184,273
"18384","chr13",100674075,100675469,100674772,1394
"18385","chr19",45405804,45406866,45406335,1062
"18386","chr4",1532815,1533260,1533037,445
"18387","chr6",692464,693348,692906,884
"18388","chr5",32443647,32445008,32444327,1361
"18389","chr8",143927192,143927967,143927579,775
"18390","chr3",48446389,48447177,48446783,788
"18391","chr17",79796873,79804669,79800771,7796
"18392","chrX",77447469,77448181,77447825,712
"18393","chr4",41879160,41879401,41879280,241
"18394","chr19",12596882,12597300,12597091,418
"18395","chr7",128201275,128201787,128201531,512
"18396","chr12",31959227,31959899,31959563,672
"18397","chr7",6652317,6655611,6653964,3294
"18398","chr5",611829,612141,611985,312
"18399","chr9",128159938,128160866,128160402,928
"18400","chr12",132148672,132150756,132149714,2084
"18401","chr14",53963436,53963952,53963694,516
"18402","chr19",17577203,17577564,17577383,361
"18403","chr12",95943225,95943633,95943429,408
"18404","chr14",106287007,106287242,106287124,235
"18405","chr11",60647193,60647446,60647319,253
"18406","chr13",19177120,19177343,19177231,223
"18407","chr12",55926955,55927187,55927071,232
"18408","chr19",18762209,18762539,18762374,330
"18409","chr4",1212029,1212415,1212222,386
"18410","chr7",95324457,95324659,95324558,202
"18411","chr20",2663915,2664255,2664085,340
"18412","chr19",23070513,23070749,23070631,236
"18413","chr20",36793786,36794364,36794075,578
"18414","chr18",25349215,25350266,25349740,1051
"18415","chr22",28741878,28742572,28742225,694
"18416","chr3",184249516,184250013,184249764,497
"18417","chr5",177608350,177608659,177608504,309
"18418","chr12",104986198,104986667,104986432,469
"18419","chr20",25389699,25391187,25390443,1488
"18420","chr11",61007564,61008835,61008199,1271
"18421","chr11",117780501,117780714,117780607,213
"18422","chr16",2776760,2777794,2777277,1034
"18423","chr20",43513918,43514127,43514022,209
"18424","chr7",903070,903303,903186,233
"18425","chr15",55742364,55743114,55742739,750
"18426","chr1",248746583,248748276,248747429,1693
"18427","chr11",128521817,128522716,128522266,899
"18428","chr18",49487020,49487531,49487275,511
"18429","chr6",150014389,150015142,150014765,753
"18430","chr14",23953561,23953932,23953746,371
"18431","chr17",8222906,8223168,8223037,262
"18432","chr2",74418340,74418623,74418481,283
"18433","chr2",235597734,235598084,235597909,350
"18434","chr15",78619904,78621274,78620589,1370
"18435","chr19",50024919,50026229,50025574,1310
"18436","chr1",61053680,61054299,61053989,619
"18437","chr2",242006589,242010686,242008637,4097
"18438","chr19",56566996,56567932,56567464,936
"18439","chr3",141402141,141402836,141402488,695
"18440","chr17",43024653,43025576,43025114,923
"18441","chr16",88502152,88502376,88502264,224
"18442","chr19",43575430,43575753,43575591,323
"18443","chr2",74436188,74436572,74436380,384
"18444","chr5",146447013,146447867,146447440,854
"18445","chr4",185203511,185204287,185203899,776
"18446","chr16",88493412,88493681,88493546,269
"18447","chrX",153470326,153470971,153470648,645
"18448","chr2",169479371,169479946,169479658,575
"18449","chr7",66740258,66741578,66740918,1320
"18450","chr11",64165518,64166598,64166058,1080
"18451","chr5",172983775,172984158,172983966,383
"18452","chr17",45620474,45620970,45620722,496
"18453","chr17",48543005,48544011,48543508,1006
"18454","chr16",30429774,30430354,30430064,580
"18455","chr2",174025515,174026086,174025800,571
"18456","chr3",196659925,196660635,196660280,710
"18457","chr6",43275094,43276567,43275830,1473
"18458","chr1",233295403,233295794,233295598,391
"18459","chr20",63253292,63255035,63254163,1743
"18460","chr2",24919603,24920820,24920211,1217
"18461","chr14",74239485,74241489,74240487,2004
"18462","chr4",15681354,15681978,15681666,624
"18463","chrX",118974539,118976596,118975567,2057
"18464","chr17",1125209,1125486,1125347,277
"18465","chr14",63595081,63595325,63595203,244
"18466","chr22",21446123,21446763,21446443,640
"18467","chr21",45492467,45492714,45492590,247
"18468","chr15",29113748,29114011,29113879,263
"18469","chr2",104862142,104862730,104862436,588
"18470","chr9",78235917,78236518,78236217,601
"18471","chr17",80875601,80877133,80876367,1532
"18472","chr11",310728,311419,311073,691
"18473","chr2",81194080,81195408,81194744,1328
"18474","chr3",184569249,184569541,184569395,292
"18475","chr9",129383297,129384049,129383673,752
"18476","chr5",6712202,6714787,6713494,2585
"18477","chr11",47715187,47715554,47715370,367
"18478","chr9",95292413,95292634,95292523,221
"18479","chr15",58771109,58771887,58771498,778
"18480","chr5",135489708,135490806,135490257,1098
"18481","chr14",91272565,91272814,91272689,249
"18482","chr2",240464533,240464777,240464655,244
"18483","chr15",101398440,101398668,101398554,228
"18484","chr6",100228947,100229222,100229084,275
"18485","chr1",91021601,91022250,91021925,649
"18486","chr5",442705,443489,443097,784
"18487","chr17",33291327,33293447,33292387,2120
"18488","chr5",179530432,179530899,179530665,467
"18489","chr17",731963,733259,732611,1296
"18490","chr1",43936085,43936751,43936418,666
"18491","chr1",50415244,50415844,50415544,600
"18492","chr11",71447968,71448785,71448376,817
"18493","chr22",43089051,43089539,43089295,488
"18494","chr3",185498522,185499343,185498932,821
"18495","chr3",158571011,158571482,158571246,471
"18496","chr16",1089732,1089937,1089834,205
"18497","chr5",8457319,8458160,8457739,841
"18498","chr7",90595768,90597050,90596409,1282
"18499","chr7",148883403,148884969,148884186,1566
"18500","chr5",163437378,163437650,163437514,272
"18501","chr11",78022953,78023177,78023065,224
"18502","chr9",137543275,137543503,137543389,228
"18503","chr1",2189578,2190379,2189978,801
"18504","chrX",51617999,51618925,51618462,926
"18505","chr19",2555753,2556148,2555950,395
"18506","chr13",112053490,112054382,112053936,892
"18507","chr7",156105446,156105692,156105569,246
"18508","chr7",223970,225989,224979,2019
"18509","chr9",133609048,133609626,133609337,578
"18510","chr7",74480485,74480780,74480632,295
"18511","chr17",16690446,16690833,16690639,387
"18512","chr9",92807199,92809973,92808586,2774
"18513","chr4",74038236,74038872,74038554,636
"18514","chr15",58933073,58934101,58933587,1028
"18515","chr17",78358737,78360957,78359847,2220
"18516","chr12",128705190,128705442,128705316,252
"18517","chr8",143738499,143738739,143738619,240
"18518","chr17",43755266,43755827,43755546,561
"18519","chr5",370070,370307,370188,237
"18520","chr8",55772933,55773648,55773290,715
"18521","chr4",24912611,24913255,24912933,644
"18522","chr20",36461045,36461968,36461506,923
"18523","chr9",131036177,131036451,131036314,274
"18524","chr3",132659714,132659928,132659821,214
"18525","chr2",127701270,127702363,127701816,1093
"18526","chr16",33975179,33976672,33975925,1493
"18527","chr5",1483648,1483954,1483801,306
"18528","chr9",74887177,74887602,74887389,425
"18529","chr14",105369694,105370049,105369871,355
"18530","chr11",75351180,75352251,75351715,1071
"18531","chr5",128536265,128536570,128536417,305
"18532","chr20",36236365,36236700,36236532,335
"18533","chr16",88277100,88278947,88278023,1847
"18534","chr3",113745590,113746312,113745951,722
"18535","chr17",82713235,82713464,82713349,229
"18536","chr11",8730755,8731002,8730878,247
"18537","chr17",42117382,42117595,42117488,213
"18538","chr7",100837360,100837571,100837465,211
"18539","chr5",51389619,51390314,51389966,695
"18540","chr16",2103238,2103871,2103554,633
"18541","chr15",74842845,74843564,74843204,719
"18542","chr5",43483417,43484453,43483935,1036
"18543","chr6",109440192,109441401,109440796,1209
"18544","chr10",121927457,121928594,121928025,1137
"18545","chr17",81310063,81310331,81310197,268
"18546","chr15",40843521,40845012,40844266,1491
"18547","chr5",172748477,172748880,172748678,403
"18548","chr17",14345074,14345404,14345239,330
"18549","chr2",96335691,96336160,96335925,469
"18550","chr9",121201089,121202200,121201644,1111
"18551","chr2",74548829,74549770,74549299,941
"18552","chr8",144477655,144478519,144478087,864
"18553","chr12",48005385,48005589,48005487,204
"18554","chr19",49876139,49878308,49877223,2169
"18555","chr5",80407617,80408625,80408121,1008
"18556","chr20",46811445,46811708,46811576,263
"18557","chr17",75978890,75979650,75979270,760
"18558","chr19",4523680,4524008,4523844,328
"18559","chr1",2049812,2051773,2050792,1961
"18560","chr15",99059005,99059589,99059297,584
"18561","chr22",29479930,29481253,29480591,1323
"18562","chr14",103534550,103534801,103534675,251
"18563","chr6",37353863,37354866,37354364,1003
"18564","chr16",2004010,2004287,2004148,277
"18565","chr5",174721146,174721481,174721313,335
"18566","chr16",31073022,31073743,31073382,721
"18567","chr14",49862092,49862328,49862210,236
"18568","chr5",690965,691261,691113,296
"18569","chr3",52197926,52198525,52198225,599
"18570","chr7",5300513,5300723,5300618,210
"18571","chr2",60581670,60582083,60581876,413
"18572","chr9",136544589,136547080,136545834,2491
"18573","chr1",6260077,6260991,6260534,914
"18574","chr5",1663615,1664225,1663920,610
"18575","chr14",77966042,77966461,77966251,419
"18576","chr11",62545810,62546827,62546318,1017
"18577","chr6",36874532,36875069,36874800,537
"18578","chr5",141364394,141365075,141364734,681
"18579","chr22",37905947,37906864,37906405,917
"18580","chr8",669097,669607,669352,510
"18581","chr13",57167116,57167449,57167282,333
"18582","chr12",132727222,132727648,132727435,426
"18583","chr1",16237049,16237304,16237176,255
"18584","chr1",1076129,1078022,1077075,1893
"18585","chr1",119001198,119001716,119001457,518
"18586","chr6",1608314,1615631,1611972,7317
"18587","chr1",6440108,6441070,6440589,962
"18588","chrX",126551728,126552958,126552343,1230
"18589","chr15",26967755,26968249,26968002,494
"18590","chr17",16666624,16667221,16666922,597
"18591","chr1",44842871,44843487,44843179,616
"18592","chr16",88382881,88384081,88383481,1200
"18593","chr7",20776619,20776920,20776769,301
"18594","chr8",143760794,143761372,143761083,578
"18595","chr7",78019134,78020226,78019680,1092
"18596","chr22",50206186,50206450,50206318,264
"18597","chr5",113487559,113488607,113488083,1048
"18598","chr8",144373725,144374899,144374312,1174
"18599","chr20",63498757,63499931,63499344,1174
"18600","chr7",99419344,99419666,99419505,322
"18601","chr16",87391531,87393071,87392301,1540
"18602","chr12",132260825,132261094,132260959,269
"18603","chr8",6806556,6806835,6806695,279
"18604","chr3",49902666,49902998,49902832,332
"18605","chr9",99819509,99825279,99822394,5770
"18606","chr21",45637548,45637906,45637727,358
"18607","chr11",2791185,2792166,2791675,981
"18608","chr8",1188927,1189281,1189104,354
"18609","chr16",87218028,87218234,87218131,206
"18610","chr1",202341915,202342184,202342049,269
"18611","chr14",85531124,85532293,85531708,1169
"18612","chr6",149938435,149939135,149938785,700
"18613","chr14",50560154,50560852,50560503,698
"18614","chr11",66277740,66278735,66278237,995
"18615","chr9",109012761,109013654,109013207,893
"18616","chr21",46667288,46668194,46667741,906
"18617","chr1",117059766,117060648,117060207,882
"18618","chr3",169769357,169769734,169769545,377
"18619","chr7",136972762,136973079,136972920,317
"18620","chr22",18110347,18111431,18110889,1084
"18621","chr1",65309333,65310063,65309698,730
"18622","chr2",218959429,218961142,218960285,1713
"18623","chr7",116671770,116672432,116672101,662
"18624","chr5",1242329,1242549,1242439,220
"18625","chr4",39446564,39447434,39446999,870
"18626","chr16",75623007,75623462,75623234,455
"18627","chr14",104772926,104773254,104773090,328
"18628","chr2",169733590,169734367,169733978,777
"18629","chr7",56447892,56448171,56448031,279
"18630","chr1",150557179,150557428,150557303,249
"18631","chr11",19776991,19777403,19777197,412
"18632","chr7",62275524,62277094,62276309,1570
"18633","chr11",69892010,69892249,69892129,239
"18634","chr11",93330432,93330910,93330671,478
"18635","chrX",24362188,24362549,24362368,361
"18636","chr6",41806216,41806682,41806449,466
"18637","chr1",228107667,228107868,228107767,201
"18638","chrX",53683559,53684512,53684035,953
"18639","chr12",1690708,1691573,1691140,865
"18640","chr4",183758378,183758635,183758506,257
"18641","chr7",66556182,66557291,66556736,1109
"18642","chr4",5890254,5890638,5890446,384
"18643","chrX",154517199,154517411,154517305,212
"18644","chr1",23867764,23868500,23868132,736
"18645","chr1",33147375,33147720,33147547,345
"18646","chr4",190014770,190015844,190015307,1074
"18647","chr11",33828905,33829424,33829164,519
"18648","chr11",64562048,64562353,64562200,305
"18649","chr2",26970405,26970996,26970700,591
"18650","chr11",68782763,68783125,68782944,362
"18651","chr6",117263421,117263653,117263537,232
"18652","chr4",184472716,184475027,184473871,2311
"18653","chr12",96489508,96489959,96489733,451
"18654","chr15",96409317,96409871,96409594,554
"18655","chr4",153467122,153467463,153467292,341
"18656","chr2",237955673,237956528,237956100,855
"18657","chr1",27958509,27958793,27958651,284
"18658","chr12",50400766,50401137,50400951,371
"18659","chr22",41413464,41414259,41413861,795
"18660","chr1",35268622,35269254,35268938,632
"18661","chr14",54488670,54489113,54488891,443
"18662","chr9",87725800,87726627,87726213,827
"18663","chr11",122984222,122984874,122984548,652
"18664","chr1",3454341,3455119,3454730,778
"18665","chr11",69048873,69049483,69049178,610
"18666","chr19",51887588,51888115,51887851,527
"18667","chr17",81551790,81552938,81552364,1148
"18668","chr7",1503644,1504763,1504203,1119
"18669","chr12",990391,991136,990763,745
"18670","chr1",177181678,177182029,177181853,351
"18671","chr11",77637378,77637914,77637646,536
"18672","chr12",118060726,118061668,118061197,942
"18673","chr11",43547371,43548304,43547837,933
"18674","chr18",12657045,12658728,12657886,1683
"18675","chr12",29381157,29381375,29381266,218
"18676","chr1",116570338,116571261,116570799,923
"18677","chr7",129224479,129225814,129225146,1335
"18678","chr12",49094180,49094444,49094312,264
"18679","chr22",39399623,39400166,39399894,543
"18680","chr7",158457436,158457805,158457620,369
"18681","chr17",49556323,49556531,49556427,208
"18682","chr1",42887114,42887323,42887218,209
"18683","chr1",84574142,84574661,84574401,519
"18684","chr7",130140634,130141757,130141195,1123
"18685","chr16",857439,859737,858588,2298
"18686","chr1",8816953,8818004,8817478,1051
"18687","chr9",136101479,136101838,136101658,359
"18688","chr14",104650159,104650586,104650372,427
"18689","chr1",179954581,179955284,179954932,703
"18690","chr5",138542575,138543736,138543155,1161
"18691","chr1",211515119,211515762,211515440,643
"18692","chr7",27158563,27158895,27158729,332
"18693","chr19",646403,648623,647513,2220
"18694","chr14",100586768,100587715,100587241,947
"18695","chr22",49823509,49824015,49823762,506
"18696","chr9",127854340,127854579,127854459,239
"18697","chr1",179575585,179576172,179575878,587
"18698","chr1",108746396,108747200,108746798,804
"18699","chr16",18337308,18337512,18337410,204
"18700","chr9",126833078,126833305,126833191,227
"18701","chr16",85610483,85610717,85610600,234
"18702","chr5",128536870,128538947,128537908,2077
"18703","chr6",168861040,168861332,168861186,292
"18704","chr1",156054531,156054849,156054690,318
"18705","chr5",55712008,55712540,55712274,532
"18706","chr1",33255847,33257064,33256455,1217
"18707","chr1",226223306,226224179,226223742,873
"18708","chr22",37427207,37428084,37427645,877
"18709","chr2",190343580,190344274,190343927,694
"18710","chr17",5282212,5282847,5282529,635
"18711","chr11",117232057,117232736,117232396,679
"18712","chr17",59209994,59210431,59210212,437
"18713","chr14",105546623,105547221,105546922,598
"18714","chr6",98844873,98845449,98845161,576
"18715","chr11",78210067,78210334,78210200,267
"18716","chr1",3509797,3510006,3509901,209
"18717","chr1",200035346,200035805,200035575,459
"18718","chr8",143693839,143694564,143694201,725
"18719","chr9",91733084,91733481,91733282,397
"18720","chr4",153295440,153296063,153295751,623
"18721","chr9",129173990,129178742,129176366,4752
"18722","chr1",26921557,26922128,26921842,571
"18723","chr3",50616845,50617689,50617267,844
"18724","chr12",48716272,48717098,48716685,826
"18725","chr11",78676144,78676379,78676261,235
"18726","chr4",11399173,11400042,11399607,869
"18727","chr17",82228259,82232114,82230186,3855
"18728","chr9",132161326,132164591,132162958,3265
"18729","chr3",122230261,122230478,122230369,217
"18730","chr4",13546946,13547998,13547472,1052
"18731","chr12",54052092,54052329,54052210,237
"18732","chr1",71080803,71081100,71080951,297
"18733","chr9",20684027,20684637,20684332,610
"18734","chrX",16869619,16871127,16870373,1508
"18735","chr11",47426153,47426706,47426429,553
"18736","chr7",72829257,72829840,72829548,583
"18737","chr7",77415523,77416672,77416097,1149
"18738","chr1",200409771,200410237,200410004,466
"18739","chr19",941824,942490,942157,666
"18740","chr5",665072,665286,665179,214
"18741","chr9",97238181,97238538,97238359,357
"18742","chr4",110631923,110633054,110632488,1131
"18743","chr1",175079414,175079738,175079576,324
"18744","chr17",82054470,82054904,82054687,434
"18745","chr11",32433328,32435765,32434546,2437
"18746","chr9",135264864,135265137,135265000,273
"18747","chr3",44338040,44338818,44338429,778
"18748","chr15",40367770,40368698,40368234,928
"18749","chr14",75126590,75127308,75126949,718
"18750","chr9",136909552,136909885,136909718,333
"18751","chr11",121292535,121293243,121292889,708
"18752","chr7",44065147,44065517,44065332,370
"18753","chr4",1372674,1372900,1372787,226
"18754","chr4",41213854,41214796,41214325,942
"18755","chr10",73785506,73786151,73785828,645
"18756","chr14",90621131,90621452,90621291,321
"18757","chr19",55353648,55354962,55354305,1314
"18758","chr6",170306153,170307122,170306637,969
"18759","chr17",82030107,82032439,82031273,2332
"18760","chr17",42275933,42277018,42276475,1085
"18761","chr11",119056663,119057701,119057182,1038
"18762","chr19",9406792,9407310,9407051,518
"18763","chr16",85168784,85169025,85168904,241
"18764","chrX",153319491,153319820,153319655,329
"18765","chr3",138935995,138936521,138936258,526
"18766","chr22",39374335,39374552,39374443,217
"18767","chr6",107459031,107459252,107459141,221
"18768","chr1",109249323,109250101,109249712,778
"18769","chr6",99568193,99568899,99568546,706
"18770","chr15",99251123,99251837,99251480,714
"18771","chr18",27184987,27185543,27185265,556
"18772","chr19",33778158,33778384,33778271,226
"18773","chr12",80936829,80937735,80937282,906
"18774","chr1",20661023,20661745,20661384,722
"18775","chr22",37824582,37825612,37825097,1030
"18776","chr1",213015657,213015919,213015788,262
"18777","chr15",93065916,93066659,93066287,743
"18778","chr7",157901695,157901969,157901832,274
"18779","chr18",24271435,24272205,24271820,770
"18780","chr16",1457354,1457652,1457503,298
"18781","chrX",25016280,25016595,25016437,315
"18782","chr5",7301109,7301327,7301218,218
"18783","chr4",56435174,56436504,56435839,1330
"18784","chr12",38905446,38905827,38905636,381
"18785","chrX",140764481,140764790,140764635,309
"18786","chr2",227472036,227473159,227472597,1123
"18787","chr6",107068758,107070047,107069402,1289
"18788","chr19",852855,853495,853175,640
"18789","chr11",1056331,1056741,1056536,410
"18790","chr13",111326241,111326752,111326496,511
"18791","chr1",112501788,112502370,112502079,582
"18792","chr16",30874808,30875517,30875162,709
"18793","chr7",27106450,27106981,27106715,531
"18794","chr2",236236970,236237322,236237146,352
"18795","chr17",40062682,40063407,40063044,725
"18796","chr12",57590993,57591519,57591256,526
"18797","chr22",31753776,31754078,31753927,302
"18798","chr20",63940385,63941203,63940794,818
"18799","chr3",51974927,51975360,51975143,433
"18800","chr2",27085678,27086902,27086290,1224
"18801","chr19",58516985,58517572,58517278,587
"18802","chr4",663204,664373,663788,1169
"18803","chr17",75205231,75206027,75205629,796
"18804","chr1",10653781,10654146,10653963,365
"18805","chr6",137497030,137498235,137497632,1205
"18806","chr11",46593647,46594114,46593880,467
"18807","chr4",145179602,145180903,145180252,1301
"18808","chr5",662168,663287,662727,1119
"18809","chr19",45450807,45451246,45451026,439
"18810","chr19",6215136,6215555,6215345,419
"18811","chr11",69470956,69471711,69471333,755
"18812","chr10",42552136,42553024,42552580,888
"18813","chr13",108214759,108215016,108214887,257
"18814","chr17",38751854,38752257,38752055,403
"18815","chr17",29079735,29081041,29080388,1306
"18816","chr9",137458366,137459592,137458979,1226
"18817","chrX",50469430,50469667,50469548,237
"18818","chr19",4400120,4400785,4400452,665
"18819","chr1",219927790,219928805,219928297,1015
"18820","chr11",14971906,14972115,14972010,209
"18821","chr1",109258432,109259078,109258755,646
"18822","chr11",315739,316539,316139,800
"18823","chr19",2163633,2165604,2164618,1971
"18824","chr8",90000913,90002038,90001475,1125
"18825","chr1",201000495,201000810,201000652,315
"18826","chr5",25909233,25909542,25909387,309
"18827","chr9",137506800,137507004,137506902,204
"18828","chr11",45902429,45903176,45902802,747
"18829","chr6",137493218,137494065,137493641,847
"18830","chr16",67528672,67529487,67529079,815
"18831","chr2",119431446,119432189,119431817,743
"18832","chr20",64269795,64270561,64270178,766
"18833","chr7",112391420,112392126,112391773,706
"18834","chr11",128689791,128690642,128690216,851
"18835","chr19",49427946,49428837,49428391,891
"18836","chr9",93247562,93247819,93247690,257
"18837","chr7",149065591,149066000,149065795,409
"18838","chr2",239139630,239139906,239139768,276
"18839","chr16",11976400,11977013,11976706,613
"18840","chr17",6713103,6714152,6713627,1049
"18841","chr14",96797222,96797902,96797562,680
"18842","chr19",48061812,48062067,48061939,255
"18843","chr3",170908042,170909052,170908547,1010
"18844","chr19",55369209,55370223,55369716,1014
"18845","chr21",25639422,25640086,25639754,664
"18846","chr22",18997986,18998187,18998086,201
"18847","chr1",9264143,9264380,9264261,237
"18848","chr12",52301943,52302220,52302081,277
"18849","chr11",59102332,59102603,59102467,271
"18850","chr17",35242122,35243508,35242815,1386
"18851","chr8",38467573,38468856,38468214,1283
"18852","chr11",17013296,17014857,17014076,1561
"18853","chr16",88909442,88909761,88909601,319
"18854","chr4",41865368,41865569,41865468,201
"18855","chr6",100449204,100449745,100449474,541
"18856","chr8",144524471,144525026,144524748,555
"18857","chr4",877488,877842,877665,354
"18858","chr17",40443018,40443272,40443145,254
"18859","chr7",159143815,159145800,159144807,1985
"18860","chr14",23321003,23322112,23321557,1109
"18861","chr3",130517145,130517359,130517252,214
"18862","chr17",18363108,18363693,18363400,585
"18863","chr9",2047438,2047801,2047619,363
"18864","chr19",1173241,1174344,1173792,1103
"18865","chr19",18208335,18208553,18208444,218
"18866","chr11",66727466,66728916,66728191,1450
"18867","chr12",52023234,52023919,52023576,685
"18868","chr12",49110252,49110859,49110555,607
"18869","chr19",42423133,42424446,42423789,1313
"18870","chr11",65107662,65108771,65108216,1109
"18871","chr7",156892891,156893485,156893188,594
"18872","chr5",491205,492043,491624,838
"18873","chr14",100726036,100727400,100726718,1364
"18874","chr6",75201863,75202417,75202140,554
"18875","chr20",3888806,3889923,3889364,1117
"18876","chr9",69066997,69067395,69067196,398
"18877","chr17",82253770,82255266,82254518,1496
"18878","chr19",1675842,1676138,1675990,296
"18879","chr22",20116851,20118206,20117528,1355
"18880","chr4",154549981,154550530,154550255,549
"18881","chr19",8307713,8308418,8308065,705
"18882","chr15",22417495,22418952,22418223,1457
"18883","chr3",127628839,127630016,127629427,1177
"18884","chr19",12052511,12052745,12052628,234
"18885","chr19",35040876,35041087,35040981,211
"18886","chr7",158803753,158804560,158804156,807
"18887","chrX",52261788,52262329,52262058,541
"18888","chr10",99522968,99523177,99523072,209
"18889","chr9",129320592,129321303,129320947,711
"18890","chr19",50378161,50378407,50378284,246
"18891","chr16",88817760,88818115,88817937,355
"18892","chr3",50273014,50273966,50273490,952
"18893","chr11",68855254,68855784,68855519,530
"18894","chr3",182793078,182794494,182793786,1416
"18895","chr17",82408900,82409221,82409060,321
"18896","chr11",1236354,1236576,1236465,222
"18897","chr7",57404610,57405091,57404850,481
"18898","chr5",113513568,113514285,113513926,717
"18899","chr19",13010223,13013554,13011888,3331
"18900","chr19",35738073,35738603,35738338,530
"18901","chrX",36963494,36963932,36963713,438
"18902","chr10",8513695,8514139,8513917,444
"18903","chr5",33892086,33892298,33892192,212
"18904","chr6",168001546,168001757,168001651,211
"18905","chrX",134990908,134991277,134991092,369
"18906","chr3",42936338,42936598,42936468,260
"18907","chr11",126268464,126269271,126268867,807
"18908","chr14",100546304,100546763,100546533,459
"18909","chr5",154754579,154757449,154756014,2870
"18910","chrX",109624533,109625385,109624959,852
"18911","chr1",202810662,202811556,202811109,894
"18912","chr12",8018801,8019194,8018997,393
"18913","chr5",102865879,102866208,102866043,329
"18914","chr9",95045168,95045412,95045290,244
"18915","chr6",44219449,44219663,44219556,214
"18916","chr4",174283414,174284244,174283829,830
"18917","chr14",19026534,19027143,19026838,609
"18918","chr19",7074741,7075087,7074914,346
"18919","chr2",119011567,119011820,119011693,253
"18920","chr13",78607192,78607479,78607335,287
"18921","chr16",559772,560980,560376,1208
"18922","chr15",90717153,90717688,90717420,535
"18923","chr7",24573009,24574283,24573646,1274
"18924","chr19",53395015,53395666,53395340,651
"18925","chr19",16627504,16628868,16628186,1364
"18926","chr3",141738039,141738668,141738353,629
"18927","chr14",103628214,103630135,103629174,1921
"18928","chr14",105414975,105415410,105415192,435
"18929","chr20",63420588,63420933,63420760,345
"18930","chr14",103273241,103274555,103273898,1314
"18931","chr16",67980064,67980642,67980353,578
"18932","chr19",49182606,49182976,49182791,370
"18933","chr4",110587737,110588127,110587932,390
"18934","chrX",30652622,30653752,30653187,1130
"18935","chr7",19112343,19112724,19112533,381
"18936","chr11",82732393,82733934,82733163,1541
"18937","chr11",1338807,1339176,1338991,369
"18938","chr19",46428811,46429092,46428951,281
"18939","chr9",136885954,136887075,136886514,1121
"18940","chr4",82044017,82044743,82044380,726
"18941","chr3",75785103,75785610,75785356,507
"18942","chr14",34059914,34060753,34060333,839
"18943","chr19",941116,941528,941322,412
"18944","chr19",5338777,5339119,5338948,342
"18945","chr5",115262604,115262960,115262782,356
"18946","chr2",230712594,230713789,230713191,1195
"18947","chr7",100823673,100823893,100823783,220
"18948","chr11",19240365,19240609,19240487,244
"18949","chr4",80266340,80266759,80266549,419
"18950","chr19",17500536,17500855,17500695,319
"18951","chr5",123422964,123423636,123423300,672
"18952","chr10",38402496,38403234,38402865,738
"18953","chr3",119294387,119294877,119294632,490
"18954","chr19",53308367,53308758,53308562,391
"18955","chr12",55932003,55932439,55932221,436
"18956","chr7",149431455,149432803,149432129,1348
"18957","chr14",102939869,102940346,102940107,477
"18958","chr5",141136729,141137718,141137223,989
"18959","chr14",58426900,58427235,58427067,335
"18960","chr2",45008470,45010653,45009561,2183
"18961","chr5",140926127,140927608,140926867,1481
"18962","chr22",17841782,17842022,17841902,240
"18963","chr5",140828140,140828493,140828316,353
"18964","chr3",141311656,141311962,141311809,306
"18965","chr11",61792435,61793077,61792756,642
"18966","chr8",144078296,144079137,144078716,841
"18967","chr10",73730189,73730796,73730492,607
"18968","chr14",92039654,92040467,92040060,813
"18969","chr1",181413154,181413712,181413433,558
"18970","chr2",74507195,74508146,74507670,951
"18971","chr2",71785720,71785948,71785834,228
"18972","chr7",157688558,157694027,157691292,5469
"18973","chr3",107240562,107241078,107240820,516
"18974","chr10",132977945,132978157,132978051,212
"18975","chr2",132417587,132417871,132417729,284
"18976","chr12",56118077,56118625,56118351,548
"18977","chr3",130002525,130003288,130002906,763
"18978","chr19",2785213,2785841,2785527,628
"18979","chr3",129893077,129894041,129893559,964
"18980","chr14",28778118,28778418,28778268,300
"18981","chr9",127945375,127945577,127945476,202
"18982","chr6",128519013,128520981,128519997,1968
"18983","chr22",50216716,50217382,50217049,666
"18984","chr14",75985736,75986199,75985967,463
"18985","chr17",81518573,81519887,81519230,1314
"18986","chrX",108091190,108091909,108091549,719
"18987","chr11",66291750,66292464,66292107,714
"18988","chr4",56467295,56468029,56467662,734
"18989","chr19",2095396,2095728,2095562,332
"18990","chr8",143943700,143944276,143943988,576
"18991","chr9",123365917,123366478,123366197,561
"18992","chr19",1761984,1762849,1762416,865
"18993","chrY",9356859,9357167,9357013,308
"18994","chr19",13102636,13103007,13102821,371
"18995","chr12",114396106,114396405,114396255,299
"18996","chr19",12720979,12722760,12721869,1781
"18997","chr9",101028330,101029482,101028906,1152
"18998","chr4",186204182,186204458,186204320,276
"18999","chr12",132908072,132909153,132908612,1081
"19000","chr5",177939301,177939972,177939636,671
"19001","chr12",130686623,130687003,130686813,380
"19002","chr6",142147053,142147321,142147187,268
"19003","chr14",26204957,26205272,26205114,315
"19004","chrX",54043879,54044878,54044378,999
"19005","chr20",62396479,62396720,62396599,241
"19006","chr4",1022105,1022491,1022298,386
"19007","chr11",369451,370214,369832,763
"19008","chr12",53324848,53325994,53325421,1146
"19009","chr12",54060465,54060674,54060569,209
"19010","chr15",44536439,44537751,44537095,1312
"19011","chr5",3326214,3326531,3326372,317
"19012","chr16",67000567,67001018,67000792,451
"19013","chr9",129437077,129437705,129437391,628
"19014","chr10",27504120,27504835,27504477,715
"19015","chr16",748171,748510,748340,339
"19016","chr20",45100874,45101150,45101012,276
"19017","chr1",248837881,248839111,248838496,1230
"19018","chr15",28214231,28214615,28214423,384
"19019","chr19",48752521,48753238,48752879,717
"19020","chr14",102086384,102087731,102087057,1347
"19021","chr17",82050638,82052691,82051664,2053
"19022","chr21",41420366,41420777,41420571,411
"19023","chr12",54046858,54047759,54047308,901
"19024","chr14",77707711,77708207,77707959,496
"19025","chr19",58519290,58520059,58519674,769
"19026","chr16",88010690,88010896,88010793,206
"19027","chr15",79283717,79283928,79283822,211
"19028","chr5",535369,535699,535534,330
"19029","chr2",45000505,45001644,45001074,1139
"19030","chr15",96356913,96357415,96357164,502
"19031","chr19",531114,532809,531961,1695
"19032","chr19",6372711,6373620,6373165,909
"19033","chr5",892407,893317,892862,910
"19034","chr9",127927099,127927936,127927517,837
"19035","chr11",2581990,2582239,2582114,249
"19036","chr1",92080262,92080923,92080592,661
"19037","chr17",7855393,7855662,7855527,269
"19038","chr11",34051439,34053156,34052297,1717
"19039","chr5",87412479,87413061,87412770,582
"19040","chrX",25012344,25013936,25013140,1592
"19041","chr1",16699567,16701447,16700507,1880
"19042","chr19",47447612,47448309,47447960,697
"19043","chr15",75639611,75640441,75640026,830
"19044","chr12",51324062,51324372,51324217,310
"19045","chr11",60924313,60925060,60924686,747
"19046","chr2",240354424,240354991,240354707,567
"19047","chr17",39687859,39688228,39688043,369
"19048","chr16",1148521,1148803,1148662,282
"19049","chr3",51538579,51539257,51538918,678
"19050","chr11",77589315,77590346,77589830,1031
"19051","chr9",96618532,96619954,96619243,1422
"19052","chr11",66344780,66345332,66345056,552
"19053","chr17",28645149,28645463,28645306,314
"19054","chr17",78399325,78399536,78399430,211
"19055","chr11",2902071,2902587,2902329,516
"19056","chr16",22325827,22326255,22326041,428
"19057","chr5",150904823,150905073,150904948,250
"19058","chr17",81074298,81074740,81074519,442
"19059","chr11",22666739,22667071,22666905,332
"19060","chr19",49680665,49680915,49680790,250
"19061","chr4",55853538,55854062,55853800,524
"19062","chr19",46636080,46636290,46636185,210
"19063","chr5",141753244,141753771,141753507,527
"19064","chr12",131849832,131850241,131850036,409
"19065","chr19",58305161,58305652,58305406,491
"19066","chrX",64044024,64044441,64044232,417
"19067","chr5",176238133,176239024,176238578,891
"19068","chr11",92866775,92867179,92866977,404
"19069","chr11",62791627,62792083,62791855,456
"19070","chr19",19224962,19225342,19225152,380
"19071","chr15",73051438,73053028,73052233,1590
"19072","chr16",67159643,67160136,67159889,493
"19073","chr11",128686969,128687230,128687099,261
"19074","chr20",18287900,18288761,18288330,861
"19075","chr10",99532679,99533044,99532861,365
"19076","chr11",65817918,65818413,65818165,495
"19077","chr1",34784817,34785135,34784976,318
"19078","chr1",111346516,111346917,111346716,401
"19079","chr11",62786594,62787790,62787192,1196
"19080","chr21",14011209,14011492,14011350,283
"19081","chr17",49224183,49225002,49224592,819
"19082","chr22",36564286,36565007,36564646,721
"19083","chr8",144394307,144394537,144394422,230
"19084","chr16",47013888,47014239,47014063,351
"19085","chr7",605696,605979,605837,283
"19086","chr8",27772236,27772717,27772476,481
"19087","chrX",135344719,135345132,135344925,413
"19088","chr14",76439360,76439714,76439537,354
"19089","chr7",35454603,35455092,35454847,489
"19090","chr3",42979210,42979862,42979536,652
"19091","chr19",33080852,33081288,33081070,436
"19092","chr9",37026225,37028017,37027121,1792
"19093","chr13",111893144,111893816,111893480,672
"19094","chr14",77498228,77499327,77498777,1099
"19095","chr10",122953752,122954733,122954242,981
"19096","chr11",69810340,69810705,69810522,365
"19097","chrX",152958836,152959079,152958957,243
"19098","chr10",132388102,132388909,132388505,807
"19099","chr14",19132686,19132957,19132821,271
"19100","chr16",87989550,87989977,87989763,427
"19101","chr1",40257714,40258026,40257870,312
"19102","chr21",45541754,45543164,45542459,1410
"19103","chr18",59969437,59969895,59969666,458
"19104","chr14",23057272,23058151,23057711,879
"19105","chr3",45145534,45146454,45145994,920
"19106","chr16",622265,622507,622386,242
"19107","chr15",45166603,45167382,45166992,779
"19108","chr10",131980902,131981133,131981017,231
"19109","chr12",121016350,121016554,121016452,204
"19110","chr15",77614008,77615794,77614901,1786
"19111","chr14",74217738,74217973,74217855,235
"19112","chr10",117134016,117134921,117134468,905
"19113","chr3",196207341,196207614,196207477,273
"19114","chr15",65132954,65133895,65133424,941
"19115","chr22",50200218,50201960,50201089,1742
"19116","chr1",84298425,84299223,84298824,798
"19117","chr3",123026336,123028139,123027237,1803
"19118","chr10",120011469,120011911,120011690,442
"19119","chr22",39679072,39679436,39679254,364
"19120","chr12",40224553,40225111,40224832,558
"19121","chr2",118088092,118088594,118088343,502
"19122","chr13",49220250,49221406,49220828,1156
"19123","chr7",206451,207365,206908,914
"19124","chr16",31010457,31011052,31010754,595
"19125","chr11",9613422,9614518,9613970,1096
"19126","chr1",53238287,53238887,53238587,600
"19127","chr7",158317877,158318189,158318033,312
"19128","chr14",67241036,67241930,67241483,894
"19129","chr11",65615353,65616386,65615869,1033
"19130","chr19",48720576,48721019,48720797,443
"19131","chr10",45443178,45444231,45443704,1053
"19132","chr11",65569742,65571003,65570372,1261
"19133","chr3",32816702,32819014,32817858,2312
"19134","chr9",86281826,86282806,86282316,980
"19135","chr20",49936168,49936997,49936582,829
"19136","chr12",31589826,31591390,31590608,1564
"19137","chr7",2658300,2658570,2658435,270
"19138","chr5",72848205,72848995,72848600,790
"19139","chr17",80961243,80961507,80961375,264
"19140","chr5",1745419,1745736,1745577,317
"19141","chr17",51120161,51121113,51120637,952
"19142","chr6",53065252,53065960,53065606,708
"19143","chr18",36296764,36298681,36297722,1917
"19144","chr12",6753506,6753823,6753664,317
"19145","chr20",63657588,63658705,63658146,1117
"19146","chrX",118839353,118839743,118839548,390
"19147","chr11",118152637,118153479,118153058,842
"19148","chr5",179678168,179679411,179678789,1243
"19149","chr2",242046614,242047706,242047160,1092
"19150","chr13",109140145,109141351,109140748,1206
"19151","chr11",71607174,71608442,71607808,1268
"19152","chr9",14346019,14348150,14347084,2131
"19153","chr11",44095567,44096444,44096005,877
"19154","chr15",45116375,45117330,45116852,955
"19155","chr22",42575794,42576200,42575997,406
"19156","chr5",173233717,173234130,173233923,413
"19157","chr13",37000655,37001086,37000870,431
"19158","chr14",60327858,60328149,60328003,291
"19159","chr1",247530733,247531199,247530966,466
"19160","chr10",31603261,31603824,31603542,563
"19161","chr8",65644529,65645278,65644903,749
"19162","chr20",4822367,4823486,4822926,1119
"19163","chr6",118894290,118895293,118894791,1003
"19164","chr20",50730828,50732122,50731475,1294
"19165","chr1",22285721,22285925,22285823,204
"19166","chr22",42152161,42153197,42152679,1036
"19167","chr20",62550250,62550580,62550415,330
"19168","chr9",127714979,127715867,127715423,888
"19169","chr2",128901725,128901994,128901859,269
"19170","chr7",157855108,157855315,157855211,207
"19171","chr11",375663,377380,376521,1717
"19172","chrX",83510434,83510768,83510601,334
"19173","chrX",145630903,145631800,145631351,897
"19174","chr12",53675841,53677481,53676661,1640
"19175","chr16",33770694,33771505,33771099,811
"19176","chr7",63751154,63751563,63751358,409
"19177","chr7",98205331,98205881,98205606,550
"19178","chr10",300564,300888,300726,324
"19179","chr12",131894397,131895507,131894952,1110
"19180","chr16",67833755,67833995,67833875,240
"19181","chr4",904242,904744,904493,502
"19182","chr17",40121507,40123122,40122314,1615
"19183","chr1",228735063,228736550,228735806,1487
"19184","chr2",74958440,74959050,74958745,610
"19185","chr22",40819131,40819572,40819351,441
"19186","chr14",76138656,76139020,76138838,364
"19187","chr13",112061045,112061920,112061482,875
"19188","chr2",231926865,231927306,231927085,441
"19189","chr17",40417464,40417991,40417727,527
"19190","chr17",1896247,1896462,1896354,215
"19191","chr9",134360269,134360605,134360437,336
"19192","chr8",75407215,75408189,75407702,974
"19193","chr5",40755435,40756155,40755795,720
"19194","chr2",164621052,164621832,164621442,780
"19195","chr8",141426933,141427172,141427052,239
"19196","chr2",74715447,74715688,74715567,241
"19197","chr11",65635264,65635711,65635487,447
"19198","chr3",49939934,49940763,49940348,829
"19199","chr10",120979539,120979878,120979708,339
"19200","chr16",4883622,4884562,4884092,940
"19201","chr17",1485392,1488436,1486914,3044
"19202","chr1",91546779,91547099,91546939,320
"19203","chr2",232409370,232409815,232409592,445
"19204","chrX",34131147,34131369,34131258,222
"19205","chr14",75176161,75176673,75176417,512
"19206","chr12",98456912,98457224,98457068,312
"19207","chrX",47193704,47194206,47193955,502
"19208","chr3",33113735,33114513,33114124,778
"19209","chr19",52535824,52536667,52536245,843
"19210","chr5",178895712,178896537,178896124,825
"19211","chr2",218992960,218994195,218993577,1235
"19212","chr14",73713815,73714561,73714188,746
"19213","chr1",151198371,151199056,151198713,685
"19214","chr4",1027318,1027550,1027434,232
"19215","chr11",121157863,121158218,121158040,355
"19216","chr10",133288161,133288480,133288320,319
"19217","chr13",111018185,111018434,111018309,249
"19218","chr7",159112579,159112846,159112712,267
"19219","chr1",101025761,101026124,101025942,363
"19220","chr7",16753639,16754475,16754057,836
"19221","chr6",33620840,33622132,33621486,1292
"19222","chr2",113756135,113757039,113756587,904
"19223","chr5",141875999,141878403,141877201,2404
"19224","chr9",113900597,113901198,113900897,601
"19225","chr22",46621458,46621757,46621607,299
"19226","chr21",45404616,45404900,45404758,284
"19227","chr9",77018410,77021114,77019762,2704
"19228","chr17",81711906,81712731,81712318,825
"19229","chr13",27789606,27790132,27789869,526
"19230","chr5",133051408,133052677,133052042,1269
"19231","chr22",17368575,17370792,17369683,2217
"19232","chr3",169668480,169669399,169668939,919
"19233","chr1",156705066,156706862,156705964,1796
"19234","chr14",60980945,60981423,60981184,478
"19235","chr14",54440878,54441519,54441198,641
"19236","chr12",9447819,9448663,9448241,844
"19237","chr6",87472650,87473484,87473067,834
"19238","chr4",957823,958461,958142,638
"19239","chr2",107986368,107987011,107986689,643
"19240","chr4",185127387,185129066,185128226,1679
"19241","chr20",63980947,63981434,63981190,487
"19242","chr4",173516763,173517195,173516979,432
"19243","chr20",10217487,10218336,10217911,849
"19244","chr4",1410251,1410730,1410490,479
"19245","chr17",58755600,58756736,58756168,1136
"19246","chr3",9843828,9844096,9843962,268
"19247","chr12",53951779,53952132,53951955,353
"19248","chr10",101566419,101566955,101566687,536
"19249","chr14",104461104,104461521,104461312,417
"19250","chr14",76131305,76131568,76131436,263
"19251","chr1",3414476,3414715,3414595,239
"19252","chr5",865202,865527,865364,325
"19253","chr10",15212599,15212853,15212726,254
"19254","chr12",132758901,132759265,132759083,364
"19255","chr3",44729444,44729645,44729544,201
"19256","chr12",111368755,111369256,111369005,501
"19257","chr6",28225183,28225506,28225344,323
"19258","chr13",23159669,23160677,23160173,1008
"19259","chr7",75738744,75739760,75739252,1016
"19260","chr22",39231585,39231806,39231695,221
"19261","chr1",47314035,47314539,47314287,504
"19262","chr22",25028006,25028263,25028134,257
"19263","chr12",4031019,4031338,4031178,319
"19264","chr12",124993517,124994303,124993910,786
"19265","chr6",127515585,127516561,127516073,976
"19266","chr15",61227422,61227832,61227627,410
"19267","chr9",137436168,137436458,137436313,290
"19268","chr19",10870810,10872590,10871700,1780
"19269","chr20",63123516,63123731,63123623,215
"19270","chr1",32072604,32073451,32073027,847
"19271","chr17",80146523,80147744,80147133,1221
"19272","chr1",43597798,43598086,43597942,288
"19273","chr14",58637581,58638859,58638220,1278
"19274","chr2",105269438,105269671,105269554,233
"19275","chrX",49175985,49176218,49176101,233
"19276","chr21",46431534,46431769,46431651,235
"19277","chr2",167292523,167294287,167293405,1764
"19278","chr22",42769941,42770281,42770111,340
"19279","chr11",71251127,71253115,71252121,1988
"19280","chr5",123094981,123095748,123095364,767
"19281","chr5",93594823,93595124,93594973,301
"19282","chr3",147419116,147419541,147419328,425
"19283","chr19",847898,848129,848013,231
"19284","chr1",100037926,100038848,100038387,922
"19285","chr3",62371964,62374099,62373031,2135
"19286","chr11",13462726,13463743,13463234,1017
"19287","chr1",77811681,77811922,77811801,241
"19288","chr11",104163808,104164330,104164069,522
"19289","chr1",87151470,87151734,87151602,264
"19290","chr3",10249204,10249427,10249315,223
"19291","chr16",88811304,88812528,88811916,1224
"19292","chr12",109999332,109999846,109999589,514
"19293","chr19",6739872,6740147,6740009,275
"19294","chr7",44220070,44220324,44220197,254
"19295","chr1",12595876,12596235,12596055,359
"19296","chr19",804218,806663,805440,2445
"19297","chr5",77629751,77631050,77630400,1299
"19298","chr10",101840786,101841476,101841131,690
"19299","chr16",88885011,88885257,88885134,246
"19300","chr3",9362999,9363254,9363126,255
"19301","chr5",356455,359411,357933,2956
"19302","chr10",1541342,1541803,1541572,461
"19303","chr11",61720660,61720885,61720772,225
"19304","chr6",57961151,57961550,57961350,399
"19305","chr16",75463930,75464882,75464406,952
"19306","chr11",62646160,62646821,62646490,661
"19307","chr20",34825054,34825799,34825426,745
"19308","chr20",20052096,20052827,20052461,731
"19309","chr17",19648031,19649170,19648600,1139
"19310","chr10",86942558,86943565,86943061,1007
"19311","chr14",104689183,104690236,104689709,1053
"19312","chr6",96521635,96522224,96521929,589
"19313","chr6",13013680,13013977,13013828,297
"19314","chr4",86934721,86936052,86935386,1331
"19315","chr10",31927973,31928174,31928073,201
"19316","chr10",97736892,97737694,97737293,802
"19317","chr15",92393447,92395291,92394369,1844
"19318","chr10",101048017,101048514,101048265,497
"19319","chr17",82584036,82584243,82584139,207
"19320","chr10",131519765,131520061,131519913,296
"19321","chrX",153333910,153334618,153334264,708
"19322","chr2",26563013,26563233,26563123,220
"19323","chr9",131554479,131555093,131554786,614
"19324","chr6",149941567,149942541,149942054,974
"19325","chr8",1449769,1450355,1450062,586
"19326","chrX",139692098,139692514,139692306,416
"19327","chr17",41688581,41689698,41689139,1117
"19328","chr7",6729690,6730585,6730137,895
"19329","chr15",34969485,34969923,34969704,438
"19330","chr9",35161877,35162412,35162144,535
"19331","chr16",89854089,89854332,89854210,243
"19332","chr4",688935,689192,689063,257
"19333","chr13",28718533,28719192,28718862,659
"19334","chr1",112849520,112850174,112849847,654
"19335","chr11",2532873,2533101,2532987,228
"19336","chr19",13155575,13156216,13155895,641
"19337","chr17",36534639,36535632,36535135,993
"19338","chr17",64661291,64662740,64662015,1449
"19339","chr11",2012477,2012761,2012619,284
"19340","chr5",73451164,73451762,73451463,598
"19341","chr5",141914219,141914484,141914351,265
"19342","chr14",24332474,24332947,24332710,473
"19343","chr1",110337772,110338002,110337887,230
"19344","chr4",970016,970327,970171,311
"19345","chr22",45502414,45503477,45502945,1063
"19346","chr5",135031223,135031748,135031485,525
"19347","chr9",87659538,87659898,87659718,360
"19348","chr21",33022820,33027937,33025378,5117
"19349","chr19",28793406,28794103,28793754,697
"19350","chr7",97022651,97022934,97022792,283
"19351","chr1",11934692,11934912,11934802,220
"19352","chr7",149090329,149091509,149090919,1180
"19353","chr14",77376758,77377403,77377080,645
"19354","chr13",40172232,40172559,40172395,327
"19355","chr9",17134823,17135708,17135265,885
"19356","chr3",12004391,12005127,12004759,736
"19357","chr15",29674793,29675417,29675105,624
"19358","chr8",58552904,58553544,58553224,640
"19359","chr14",104179620,104180141,104179880,521
"19360","chr11",61580336,61581566,61580951,1230
"19361","chr4",6709221,6710066,6709643,845
"19362","chr18",14747517,14748232,14747874,715
"19363","chr17",2041562,2042327,2041944,765
"19364","chr2",238238951,238241259,238240105,2308
"19365","chr16",88019167,88019734,88019450,567
"19366","chr2",2769628,2769846,2769737,218
"19367","chr17",35407626,35407840,35407733,214
"19368","chr1",225652568,225654093,225653330,1525
"19369","chr1",1064298,1064531,1064414,233
"19370","chr9",91421125,91421712,91421418,587
"19371","chr16",795363,795867,795615,504
"19372","chr8",143705595,143705837,143705716,242
"19373","chr6",75284287,75285118,75284702,831
"19374","chr16",4537835,4538889,4538362,1054
"19375","chr15",22257334,22259340,22258337,2006
"19376","chr1",108963059,108963592,108963325,533
"19377","chr15",25736029,25736245,25736137,216
"19378","chr3",41961440,41962236,41961838,796
"19379","chr8",143221650,143221852,143221751,202
"19380","chr5",1725068,1725305,1725186,237
"19381","chr10",133459496,133460181,133459838,685
"19382","chr10",97771406,97772211,97771808,805
"19383","chr16",88491643,88491921,88491782,278
"19384","chr17",73952339,73953116,73952727,777
"19385","chr7",20777835,20778607,20778221,772
"19386","chr17",17164262,17164626,17164444,364
"19387","chr2",75199466,75200904,75200185,1438
"19388","chr17",28357139,28357852,28357495,713
"19389","chr2",30146445,30148055,30147250,1610
"19390","chr11",61777255,61778091,61777673,836
"19391","chr8",81522201,81522430,81522315,229
"19392","chr7",57008932,57009308,57009120,376
"19393","chr3",186567020,186567540,186567280,520
"19394","chr17",81119523,81122877,81121200,3354
"19395","chr18",79443269,79443732,79443500,463
"19396","chr20",18056220,18057989,18057104,1769
"19397","chr13",99200132,99201298,99200715,1166
"19398","chr10",12195833,12196378,12196105,545
"19399","chr10",133378090,133379803,133378946,1713
"19400","chr10",95560667,95561726,95561196,1059
"19401","chr2",24175544,24175800,24175672,256
"19402","chr7",27204911,27205678,27205294,767
"19403","chr17",1270241,1271439,1270840,1198
"19404","chr9",70418882,70420309,70419595,1427
"19405","chr5",178859873,178860941,178860407,1068
"19406","chr17",82587557,82587782,82587669,225
"19407","chr20",20363756,20365500,20364628,1744
"19408","chr5",10638883,10640132,10639507,1249
"19409","chr7",30284301,30286025,30285163,1724
"19410","chr17",81647824,81648529,81648176,705
"19411","chr4",73836703,73836910,73836806,207
"19412","chr7",5555913,5556679,5556296,766
"19413","chr7",2380173,2380705,2380439,532
"19414","chr3",157174765,157175247,157175006,482
"19415","chr21",44901482,44901729,44901605,247
"19416","chr19",45901279,45902043,45901661,764
"19417","chr9",129737689,129738274,129737981,585
"19418","chr8",142581414,142581694,142581554,280
"19419","chr8",1785101,1785763,1785432,662
"19420","chr8",11697590,11698094,11697842,504
"19421","chr2",113499198,113500466,113499832,1268
"19422","chr21",45589864,45591249,45590556,1385
"19423","chr11",72754839,72755164,72755001,325
"19424","chrX",50470659,50470984,50470821,325
"19425","chr11",76799242,76799606,76799424,364
"19426","chr11",22432754,22432972,22432863,218
"19427","chr20",62989820,62990189,62990004,369
"19428","chr17",32265575,32267014,32266294,1439
"19429","chr9",89000985,89001330,89001157,345
"19430","chr11",118925241,118926110,118925675,869
"19431","chr17",67993105,67994316,67993710,1211
"19432","chr5",171450628,171450863,171450745,235
"19433","chr10",17644098,17644336,17644217,238
"19434","chr12",21527474,21528048,21527761,574
"19435","chr4",47913844,47914863,47914353,1019
"19436","chr20",24918318,24918545,24918431,227
"19437","chr15",42548264,42548918,42548591,654
"19438","chr19",35295648,35296059,35295853,411
"19439","chr8",66775070,66775552,66775311,482
"19440","chr1",26959574,26960610,26960092,1036
"19441","chr8",12600895,12601623,12601259,728
"19442","chr12",48183578,48184791,48184184,1213
"19443","chr10",623130,623396,623263,266
"19444","chr11",993208,994006,993607,798
"19445","chr11",59142654,59143111,59142882,457
"19446","chr17",44176766,44177235,44177000,469
"19447","chr20",62063556,62063926,62063741,370
"19448","chrY",7273480,7275183,7274331,1703
"19449","chr8",22010221,22010693,22010457,472
"19450","chr20",31632591,31632859,31632725,268
"19451","chr14",105769151,105769456,105769303,305
"19452","chr11",66958032,66958902,66958467,870
"19453","chr17",7990012,7990384,7990198,372
"19454","chr5",179879108,179879346,179879227,238
"19455","chr16",29876467,29876995,29876731,528
"19456","chr17",15782904,15783160,15783032,256
"19457","chr3",115146589,115148277,115147433,1688
"19458","chr11",68423541,68423761,68423651,220
"19459","chr16",30021463,30021810,30021636,347
"19460","chr17",81238616,81239971,81239293,1355
"19461","chr7",10973644,10974261,10973952,617
"19462","chr2",10426763,10427022,10426892,259
"19463","chr1",153922993,153923445,153923219,452
"19464","chr6",108117794,108120004,108118899,2210
"19465","chr1",3718069,3718537,3718303,468
"19466","chr9",136011486,136012075,136011780,589
"19467","chr6",54846355,54847235,54846795,880
"19468","chr8",118951707,118951939,118951823,232
"19469","chr3",97764296,97764774,97764535,478
"19470","chr7",151057835,151058339,151058087,504
"19471","chr7",1817116,1817762,1817439,646
"19472","chr14",58298455,58299668,58299061,1213
"19473","chr7",123534418,123535208,123534813,790
"19474","chr18",26655625,26657297,26656461,1672
"19475","chr1",2109558,2109863,2109710,305
"19476","chr17",58279013,58279652,58279332,639
"19477","chr10",132306943,132308918,132307930,1975
"19478","chr6",111087223,111088281,111087752,1058
"19479","chr2",127025505,127025735,127025620,230
"19480","chr10",22252503,22253810,22253156,1307
"19481","chr12",110280587,110282257,110281422,1670
"19482","chr5",141365964,141366326,141366145,362
"19483","chr10",79446511,79446770,79446640,259
"19484","chr7",73667513,73668375,73667944,862
"19485","chr2",219522353,219523353,219522853,1000
"19486","chr20",63861496,63862896,63862196,1400
"19487","chr22",44786136,44786343,44786239,207
"19488","chr5",180207577,180207875,180207726,298
"19489","chr20",57351156,57351529,57351342,373
"19490","chr3",48685536,48686324,48685930,788
"19491","chr8",142404052,142404338,142404195,286
"19492","chr8",37762261,37763252,37762756,991
"19493","chr19",18788228,18791475,18789851,3247
"19494","chr17",19063633,19063883,19063758,250
"19495","chr19",821345,822463,821904,1118
"19496","chr16",90082075,90082385,90082230,310
"19497","chr19",4090202,4090690,4090446,488
"19498","chr10",18710215,18710461,18710338,246
"19499","chr7",151226794,151227450,151227122,656
"19500","chr7",32761872,32762360,32762116,488
"19501","chr7",157501609,157501823,157501716,214
"19502","chr12",6540511,6540731,6540621,220
"19503","chr4",118352150,118353303,118352726,1153
"19504","chr17",80181453,80181656,80181554,203
"19505","chr11",64185205,64186756,64185980,1551
"19506","chr3",123960938,123961634,123961286,696
"19507","chr11",76321883,76322203,76322043,320
"19508","chr12",56360077,56360539,56360308,462
"19509","chr15",41919221,41919503,41919362,282
"19510","chr22",46762170,46763083,46762626,913
"19511","chr11",1281542,1281752,1281647,210
"19512","chr1",222814994,222815219,222815106,225
"19513","chr5",93579064,93581631,93580347,2567
"19514","chr1",42658306,42658751,42658528,445
"19515","chr20",31514483,31515053,31514768,570
"19516","chr8",79783595,79784223,79783909,628
"19517","chr9",37029935,37030298,37030116,363
"19518","chr6",423846,424827,424336,981
"19519","chr6",133895781,133896142,133895961,361
"19520","chrX",37545105,37545362,37545233,257
"19521","chr3",194296691,194297400,194297045,709
"19522","chr6",43629053,43629953,43629503,900
"19523","chr15",90265342,90266019,90265680,677
"19524","chr20",21709120,21709410,21709265,290
"19525","chr12",6943986,6944764,6944375,778
"19526","chrX",135985348,135986150,135985749,802
"19527","chr5",1025215,1025514,1025364,299
"19528","chr1",46466624,46467220,46466922,596
"19529","chr17",38561491,38562357,38561924,866
"19530","chr5",134465815,134466051,134465933,236
"19531","chr9",97852952,97855228,97854090,2276
"19532","chr14",35533392,35535807,35534599,2415
"19533","chr18",50559468,50561219,50560343,1751
"19534","chr7",151085989,151087953,151086971,1964
"19535","chr12",132558707,132559136,132558921,429
"19536","chr16",2765574,2766794,2766184,1220
"19537","chr12",124294883,124295760,124295321,877
"19538","chr19",1718803,1719155,1718979,352
"19539","chr17",35596569,35597125,35596847,556
"19540","chr14",105033465,105033684,105033574,219
"19541","chr2",47905145,47906141,47905643,996
"19542","chr5",211563,212374,211968,811
"19543","chr17",80065492,80065748,80065620,256
"19544","chr22",49615310,49616064,49615687,754
"19545","chr11",2991569,2992951,2992260,1382
"19546","chr19",1856726,1857444,1857085,718
"19547","chr14",56811991,56812398,56812194,407
"19548","chr2",218322930,218323454,218323192,524
"19549","chr14",101229937,101230167,101230052,230
"19550","chr13",100588435,100588972,100588703,537
"19551","chr5",5886949,5887415,5887182,466
"19552","chr16",67162889,67166085,67164487,3196
"19553","chr1",77219311,77219567,77219439,256
"19554","chr2",241872904,241873706,241873305,802
"19555","chr22",45645488,45646030,45645759,542
"19556","chr17",978493,980141,979317,1648
"19557","chr6",27757325,27757720,27757522,395
"19558","chr5",172641015,172642171,172641593,1156
"19559","chr11",46389371,46393137,46391254,3766
"19560","chr11",124673488,124674150,124673819,662
"19561","chr5",70924957,70925412,70925184,455
"19562","chr22",37051649,37052198,37051923,549
"19563","chr1",228556409,228556706,228556557,297
"19564","chr17",18857960,18858540,18858250,580
"19565","chr10",101140065,101140506,101140285,441
"19566","chr17",37512620,37512924,37512772,304
"19567","chr10",103452193,103452549,103452371,356
"19568","chr7",27225539,27225874,27225706,335
"19569","chr7",102248385,102249354,102248869,969
"19570","chr9",19934353,19934829,19934591,476
"19571","chr2",110212275,110212645,110212460,370
"19572","chr19",50480596,50480818,50480707,222
"19573","chr11",76194673,76194874,76194773,201
"19574","chr3",183884644,183885086,183884865,442
"19575","chr1",203327149,203327801,203327475,652
"19576","chr14",69850130,69850523,69850326,393
"19577","chr11",68121047,68122301,68121674,1254
"19578","chr17",1684493,1685106,1684799,613
"19579","chr1",10647753,10648083,10647918,330
"19580","chr8",41828302,41828560,41828431,258
"19581","chr10",132779731,132780073,132779902,342
"19582","chr7",4816359,4816581,4816470,222
"19583","chr2",120344224,120346958,120345591,2734
"19584","chr11",134068955,134069786,134069370,831
"19585","chr6",43687534,43687881,43687707,347
"19586","chr6",24666310,24667167,24666738,857
"19587","chr11",73660755,73661587,73661171,832
"19588","chr4",56314059,56315981,56315020,1922
"19589","chr1",18637686,18637907,18637796,221
"19590","chr20",21703106,21703782,21703444,676
"19591","chr19",19192045,19192339,19192192,294
"19592","chr5",10353288,10354400,10353844,1112
"19593","chr11",70155647,70155882,70155764,235
"19594","chr22",45970846,45972846,45971846,2000
"19595","chr10",130045252,130045955,130045603,703
"19596","chr11",10304501,10305043,10304772,542
"19597","chr6",168319001,168319962,168319481,961
"19598","chr6",10409876,10410457,10410166,581
"19599","chr11",47578577,47579375,47578976,798
"19600","chr4",112514742,112516846,112515794,2104
"19601","chr19",7477218,7477469,7477343,251
"19602","chr17",81128948,81129170,81129059,222
"19603","chr14",77641827,77642319,77642073,492
"19604","chr4",13483898,13484909,13484403,1011
"19605","chr8",37700409,37701369,37700889,960
"19606","chr19",49451506,49451928,49451717,422
"19607","chr18",48921348,48921713,48921530,365
"19608","chrX",119399200,119399824,119399512,624
"19609","chr17",74212335,74212763,74212549,428
"19610","chr11",65333638,65334372,65334005,734
"19611","chr2",63588066,63588976,63588521,910
"19612","chr17",75128820,75129059,75128939,239
"19613","chr15",33310615,33311802,33311208,1187
"19614","chr2",70904070,70905126,70904598,1056
"19615","chr20",3082359,3083500,3082929,1141
"19616","chr4",139083564,139084652,139084108,1088
"19617","chr11",14381054,14381540,14381297,486
"19618","chrX",71578172,71578503,71578337,331
"19619","chr14",21103676,21104361,21104018,685
"19620","chr19",10513799,10515100,10514449,1301
"19621","chr14",89955798,89956249,89956023,451
"19622","chr1",150561599,150561825,150561712,226
"19623","chr17",63699530,63701373,63700451,1843
"19624","chr10",5666017,5666835,5666426,818
"19625","chr14",52267489,52268768,52268128,1279
"19626","chr16",90003354,90004475,90003914,1121
"19627","chr16",88881305,88881607,88881456,302
"19628","chr6",26273062,26273329,26273195,267
"19629","chr19",50230727,50231031,50230879,304
"19630","chr10",122818610,122818927,122818768,317
"19631","chr16",89100795,89101074,89100934,279
"19632","chr10",23693453,23693660,23693556,207
"19633","chr22",50030025,50030924,50030474,899
"19634","chr7",55004573,55004929,55004751,356
"19635","chr18",78991939,78995549,78993744,3610
"19636","chr16",15129866,15130405,15130135,539
"19637","chr19",426321,427819,427070,1498
"19638","chr7",92179017,92179318,92179167,301
"19639","chr10",44310697,44311281,44310989,584
"19640","chr20",22586815,22587242,22587028,427
"19641","chr14",104461704,104462316,104462010,612
"19642","chr2",219539434,219540561,219539997,1127
"19643","chr19",39031624,39032587,39032105,963
"19644","chr4",88378838,88379108,88378973,270
"19645","chr16",88446865,88447106,88446985,241
"19646","chr17",67366227,67366721,67366474,494
"19647","chr15",55993062,55994097,55993579,1035
"19648","chr11",134712402,134712687,134712544,285
"19649","chr14",104985023,104985225,104985124,202
"19650","chr2",201071301,201071653,201071477,352
"19651","chr16",3017520,3018357,3017938,837
"19652","chr7",29563924,29565177,29564550,1253
"19653","chr10",132749062,132749702,132749382,640
"19654","chr19",53868600,53869736,53869168,1136
"19655","chr18",12702185,12703243,12702714,1058
"19656","chr11",66001926,66002831,66002378,905
"19657","chr2",97741330,97741576,97741453,246
"19658","chr10",133226433,133226692,133226562,259
"19659","chr9",19788217,19789290,19788753,1073
"19660","chr9",97501393,97502326,97501859,933
"19661","chr16",22436879,22437707,22437293,828
"19662","chr11",62726522,62727655,62727088,1133
"19663","chr5",140821855,140822072,140821963,217
"19664","chr16",89107296,89107497,89107396,201
"19665","chr17",80414637,80415922,80415279,1285
"19666","chr15",89411372,89411951,89411661,579
"19667","chr9",129665178,129665400,129665289,222
"19668","chr15",93052010,93052461,93052235,451
"19669","chr1",230867885,230868909,230868397,1024
"19670","chr17",19344472,19344756,19344614,284
"19671","chr7",90211499,90212177,90211838,678
"19672","chr11",108121277,108122004,108121640,727
"19673","chr1",9588674,9589459,9589066,785
"19674","chr7",1980128,1980465,1980296,337
"19675","chr17",11240170,11242099,11241134,1929
"19676","chr19",55117120,55117737,55117428,617
"19677","chr11",76860636,76861247,76860941,611
"19678","chr11",66011840,66012383,66012111,543
"19679","chr14",63045289,63046278,63045783,989
"19680","chr10",108911966,108912568,108912267,602
"19681","chr11",2385481,2385697,2385589,216
"19682","chrX",115968702,115969064,115968883,362
"19683","chrX",51495854,51497252,51496553,1398
"19684","chr17",3571288,3571603,3571445,315
"19685","chr7",151381376,151382450,151381913,1074
"19686","chr16",3484833,3485066,3484949,233
"19687","chr7",4788713,4788918,4788815,205
"19688","chr14",89162541,89162855,89162698,314
"19689","chr8",6406061,6406801,6406431,740
"19690","chr9",126223120,126223326,126223223,206
"19691","chrX",71253962,71254437,71254199,475
"19692","chr4",169774838,169775123,169774980,285
"19693","chr4",893402,894376,893889,974
"19694","chr4",88457072,88457797,88457434,725
"19695","chr6",41734271,41735743,41735007,1472
"19696","chr4",144645090,144646120,144645605,1030
"19697","chr3",50568914,50569541,50569227,627
"19698","chr10",15370420,15371463,15370941,1043
"19699","chr3",12815150,12815364,12815257,214
"19700","chr22",50505925,50506177,50506051,252
"19701","chr22",50697242,50697698,50697470,456
"19702","chr14",51093398,51095769,51094583,2371
"19703","chr12",53299657,53300244,53299950,587
"19704","chr2",172083115,172083472,172083293,357
"19705","chr11",6240110,6240505,6240307,395
"19706","chr9",137278161,137281653,137279907,3492
"19707","chr3",155805951,155806385,155806168,434
"19708","chr2",127415899,127416217,127416058,318
"19709","chr11",3422015,3423201,3422608,1186
"19710","chr4",171812583,171813967,171813275,1384
"19711","chr14",52695120,52696062,52695591,942
"19712","chr4",577330,577979,577654,649
"19713","chr17",5486070,5486963,5486516,893
"19714","chr2",207711277,207712382,207711829,1105
"19715","chr3",142149120,142149771,142149445,651
"19716","chr5",692566,694262,693414,1696
"19717","chr16",30524520,30525215,30524867,695
"19718","chrX",20116085,20117232,20116658,1147
"19719","chr12",57487967,57488252,57488109,285
"19720","chr11",33735930,33736576,33736253,646
"19721","chr1",1231621,1233605,1232613,1984
"19722","chr10",45672229,45673194,45672711,965
"19723","chr17",2755391,2756108,2755749,717
"19724","chrX",154750563,154751375,154750969,812
"19725","chr11",64827049,64827794,64827421,745
"19726","chr2",223944206,223945502,223944854,1296
"19727","chr5",141157315,141158185,141157750,870
"19728","chr22",23141810,23142122,23141966,312
"19729","chr17",17494934,17497032,17495983,2098
"19730","chrX",9944545,9944928,9944736,383
"19731","chr20",46028824,46029799,46029311,975
"19732","chr7",157470257,157470764,157470510,507
"19733","chr17",30291352,30292255,30291803,903
"19734","chr3",12868729,12869021,12868875,292
"19735","chr9",33750521,33751162,33750841,641
"19736","chr19",29673861,29674649,29674255,788
"19737","chr2",170711812,170712357,170712084,545
"19738","chr12",8389959,8390738,8390348,779
"19739","chr6",31197635,31198146,31197890,511
"19740","chr7",76318076,76318593,76318334,517
"19741","chr15",31391781,31393086,31392433,1305
"19742","chr13",35478416,35478982,35478699,566
"19743","chr7",75559751,75559985,75559868,234
"19744","chr1",166165021,166167211,166166116,2190
"19745","chr17",996602,997523,997062,921
"19746","chr8",12193587,12195098,12194342,1511
"19747","chr8",47188540,47189291,47188915,751
"19748","chr11",75399449,75399880,75399664,431
"19749","chr8",41876025,41876393,41876209,368
"19750","chr17",77246789,77247531,77247160,742
"19751","chr2",230864858,230866106,230865482,1248
"19752","chr10",73839502,73839730,73839616,228
"19753","chr17",38419112,38419539,38419325,427
"19754","chr20",18504617,18504936,18504776,319
"19755","chr7",186352,186673,186512,321
"19756","chr10",26211678,26212197,26211937,519
"19757","chr1",32179553,32180213,32179883,660
"19758","chrY",14523859,14524167,14524013,308
"19759","chr14",39170160,39170431,39170295,271
"19760","chr18",12376539,12377738,12377138,1199
"19761","chr13",36154825,36155130,36154977,305
"19762","chr3",44021822,44022345,44022083,523
"19763","chr11",65083830,65084356,65084093,526
"19764","chr15",72289369,72289976,72289672,607
"19765","chr14",56797920,56798843,56798381,923
"19766","chr6",34757286,34757529,34757407,243
"19767","chr1",205241567,205242036,205241801,469
"19768","chr22",37182192,37182620,37182406,428
"19769","chr21",41801455,41801682,41801568,227
"19770","chr10",130129040,130129255,130129147,215
"19771","chr1",31772226,31773060,31772643,834
"19772","chr11",110429850,110430610,110430230,760
"19773","chr11",33773846,33774773,33774309,927
"19774","chr3",33218427,33219271,33218849,844
"19775","chr15",52795014,52795291,52795152,277
"19776","chr3",48640096,48640444,48640270,348
"19777","chr2",219245262,219245766,219245514,504
"19778","chr7",151245218,151245947,151245582,729
"19779","chr22",29310510,29310720,29310615,210
"19780","chr19",15010778,15011331,15011054,553
"19781","chr4",98995224,98996418,98995821,1194
"19782","chr2",85413846,85414136,85413991,290
"19783","chr1",26863421,26863637,26863529,216
"19784","chr8",12115765,12116170,12115967,405
"19785","chr17",80883830,80884066,80883948,236
"19786","chr2",3282553,3282759,3282656,206
"19787","chr5",623052,623440,623246,388
"19788","chr18",2913061,2913309,2913185,248
"19789","chr2",108719312,108720214,108719763,902
"19790","chr2",32063297,32064397,32063847,1100
"19791","chr1",145823593,145824433,145824013,840
"19792","chr11",734674,736521,735597,1847
"19793","chr19",5292760,5294200,5293480,1440
"19794","chr17",8210314,8210648,8210481,334
"19795","chr17",59106267,59107080,59106673,813
"19796","chr19",38402840,38403743,38403291,903
"19797","chr17",30831860,30832405,30832132,545
"19798","chr15",41501364,41503107,41502235,1743
"19799","chr19",43475207,43475532,43475369,325
"19800","chr22",50544141,50544565,50544353,424
"19801","chr14",103520726,103523459,103522092,2733
"19802","chr16",84116307,84117505,84116906,1198
"19803","chr14",32203330,32203709,32203519,379
"19804","chr16",2186711,2186938,2186824,227
"19805","chr6",99515077,99515602,99515339,525
"19806","chr9",96877307,96877772,96877539,465
"19807","chr2",62505623,62506362,62505992,739
"19808","chr12",1593472,1595066,1594269,1594
"19809","chr5",141491497,141492768,141492132,1271
"19810","chr2",176117379,176117674,176117526,295
"19811","chr6",105179531,105180195,105179863,664
"19812","chr10",100065204,100065429,100065316,225
"19813","chr7",27235436,27236007,27235721,571
"19814","chr5",141618510,141619308,141618909,798
"19815","chr15",90184647,90185338,90184992,691
"19816","chr19",23075155,23075716,23075435,561
"19817","chr15",51621970,51623199,51622584,1229
"19818","chr16",67013702,67014567,67014134,865
"19819","chr8",24999994,25000912,25000453,918
"19820","chr3",49429045,49429410,49429227,365
"19821","chr1",28247190,28247511,28247350,321
"19822","chr19",2150991,2151964,2151477,973
"19823","chr19",1046250,1047702,1046976,1452
"19824","chr10",37857574,37858176,37857875,602
"19825","chr18",48029273,48029842,48029557,569
"19826","chr1",31155253,31155646,31155449,393
"19827","chr7",64037734,64037936,64037835,202
"19828","chr17",80948097,80948433,80948265,336
"19829","chr3",42880727,42881380,42881053,653
"19830","chr14",19097382,19099647,19098514,2265
"19831","chr19",44812120,44812465,44812292,345
"19832","chr13",19818290,19818567,19818428,277
"19833","chr19",2799495,2799976,2799735,481
"19834","chr2",117836063,117836658,117836360,595
"19835","chr20",31739110,31739627,31739368,517
"19836","chr10",38010562,38011171,38010866,609
"19837","chr11",65918816,65920083,65919449,1267
"19838","chr6",148746816,148748639,148747727,1823
"19839","chr3",119402000,119402291,119402145,291
"19840","chr14",100177895,100178250,100178072,355
"19841","chr16",23408112,23408388,23408250,276
"19842","chr19",38485612,38486155,38485883,543
"19843","chr19",53329118,53329325,53329221,207
"19844","chr12",52874075,52874506,52874290,431
"19845","chr3",105366618,105366821,105366719,203
"19846","chr3",58491759,58492547,58492153,788
"19847","chr14",58199849,58200480,58200164,631
"19848","chr15",91296718,91297110,91296914,392
"19849","chr20",3732512,3732868,3732690,356
"19850","chr19",4566445,4566666,4566555,221
"19851","chr5",1653865,1654153,1654009,288
"19852","chr21",43362368,43362721,43362544,353
"19853","chr12",103965628,103966245,103965936,617
"19854","chr12",123458092,123458454,123458273,362
"19855","chr19",51713406,51714136,51713771,730
"19856","chr10",69572170,69573636,69572903,1466
"19857","chr19",52942091,52942680,52942385,589
"19858","chr19",8333074,8335866,8334470,2792
"19859","chr18",14393228,14394012,14393620,784
"19860","chrX",85243766,85244878,85244322,1112
"19861","chr20",51492257,51492918,51492587,661
"19862","chr14",94773746,94774004,94773875,258
"19863","chr12",120710436,120711050,120710743,614
"19864","chr16",537651,538172,537911,521
"19865","chr12",57631878,57633273,57632575,1395
"19866","chr5",88602670,88602918,88602794,248
"19867","chr12",64451819,64452534,64452176,715
"19868","chrX",100820243,100820570,100820406,327
"19869","chr11",83193436,83194618,83194027,1182
"19870","chr16",88506877,88507081,88506979,204
"19871","chr12",12999885,13001932,13000908,2047
"19872","chr5",63960721,63962059,63961390,1338
"19873","chr19",17511508,17512507,17512007,999
"19874","chr9",69035730,69036260,69035995,530
"19875","chr13",23903287,23903914,23903600,627
"19876","chr14",101442444,101442685,101442564,241
"19877","chr10",15167825,15168715,15168270,890
"19878","chr1",228280263,228280796,228280529,533
"19879","chr19",22261639,22261913,22261776,274
"19880","chr2",40451935,40452487,40452211,552
"19881","chr12",104286959,104287318,104287138,359
"19882","chr21",46458157,46459663,46458910,1506
"19883","chr5",176536497,176538115,176537306,1618
"19884","chr2",64609072,64609631,64609351,559
"19885","chr11",980023,980568,980295,545
"19886","chr6",10381325,10382121,10381723,796
"19887","chr6",136791538,136793228,136792383,1690
"19888","chr6",157981040,157982412,157981726,1372
"19889","chr18",12067176,12067433,12067304,257
"19890","chr6",42452337,42453437,42452887,1100
"19891","chr17",76882163,76882373,76882268,210
"19892","chr19",33387876,33388079,33387977,203
"19893","chr19",15170341,15170756,15170548,415
"19894","chr11",6320106,6320679,6320392,573
"19895","chr2",209145369,209145643,209145506,274
"19896","chr1",24642536,24643705,24643120,1169
"19897","chr7",130668230,130669139,130668684,909
"19898","chr1",32712270,32712490,32712380,220
"19899","chr14",28774197,28774557,28774377,360
"19900","chr17",50547054,50547362,50547208,308
"19901","chr7",12570539,12571209,12570874,670
"19902","chr17",80105769,80106034,80105901,265
"19903","chr11",67420616,67421408,67421012,792
"19904","chr1",109100041,109100762,109100401,721
"19905","chr11",134735188,134735969,134735578,781
"19906","chr13",80342827,80343086,80342956,259
"19907","chr5",150302139,150303038,150302588,899
"19908","chr1",32394169,32394747,32394458,578
"19909","chr16",57903732,57903961,57903846,229
"19910","chr1",161177271,161177661,161177466,390
"19911","chr1",3643388,3644445,3643916,1057
"19912","chr7",4958774,4959427,4959100,653
"19913","chr15",28111557,28111880,28111718,323
"19914","chr17",82801415,82802060,82801737,645
"19915","chr1",27603071,27603749,27603410,678
"19916","chr17",35741024,35741649,35741336,625
"19917","chr18",61333450,61334459,61333954,1009
"19918","chr2",110383034,110384706,110383870,1672
"19919","chr2",118013283,118014292,118013787,1009
"19920","chr7",139359139,139360732,139359935,1593
"19921","chr17",18672396,18673164,18672780,768
"19922","chrX",153780886,153781313,153781099,427
"19923","chr19",55062770,55063366,55063068,596
"19924","chr5",95646625,95646990,95646807,365
"19925","chr1",1246376,1247090,1246733,714
"19926","chr9",91361511,91362057,91361784,546
"19927","chr2",91974481,91975324,91974902,843
"19928","chr17",82008978,82009262,82009120,284
"19929","chr2",118835026,118836269,118835647,1243
"19930","chr19",45340612,45341160,45340886,548
"19931","chr6",150004875,150005666,150005270,791
"19932","chr19",57888577,57888908,57888742,331
"19933","chr17",9575690,9575908,9575799,218
"19934","chr1",228274184,228274438,228274311,254
"19935","chr2",238893635,238893887,238893761,252
"19936","chr2",216081601,216082011,216081806,410
"19937","chr6",144149932,144150880,144150406,948
"19938","chr7",149281671,149282299,149281985,628
"19939","chr2",240245719,240245957,240245838,238
"19940","chr11",65134055,65134636,65134345,581
"19941","chr11",66282279,66282758,66282518,479
"19942","chr13",110638319,110638623,110638471,304
"19943","chr2",161414377,161414902,161414639,525
"19944","chr17",83017770,83018374,83018072,604
"19945","chr11",575464,577093,576278,1629
"19946","chr20",34876353,34876842,34876597,489
"19947","chr14",49862852,49863184,49863018,332
"19948","chr19",6516415,6516995,6516705,580
"19949","chr22",35299650,35300117,35299883,467
"19950","chr17",4710813,4711128,4710970,315
"19951","chr17",43126117,43126443,43126280,326
"19952","chr16",1505056,1505258,1505157,202
"19953","chr21",41821881,41822112,41821996,231
"19954","chr5",1245786,1246505,1246145,719
"19955","chr4",174829179,174829433,174829306,254
"19956","chr22",45880485,45881184,45880834,699
"19957","chr5",138274416,138274708,138274562,292
"19958","chr19",49431059,49431611,49431335,552
"19959","chr19",45553525,45553891,45553708,366
"19960","chr20",35226545,35227328,35226936,783
"19961","chrY",12420316,12421801,12421058,1485
"19962","chr1",1032586,1034858,1033722,2272
"19963","chr17",82083777,82084151,82083964,374
"19964","chr1",154772110,154772388,154772249,278
"19965","chr10",74176459,74177230,74176844,771
"19966","chr11",133919377,133921373,133920375,1996
"19967","chr5",7289620,7290040,7289830,420
"19968","chr1",48776519,48777138,48776828,619
"19969","chr22",50076712,50077045,50076878,333
"19970","chr14",104905234,104906993,104906113,1759
"19971","chrX",47650193,47651109,47650651,916
"19972","chr10",11301342,11301557,11301449,215
"19973","chr6",17102078,17102308,17102193,230
"19974","chr22",23838304,23839479,23838891,1175
"19975","chr19",1961002,1961326,1961164,324
"19976","chr16",71230457,71230756,71230606,299
"19977","chr19",19627763,19629012,19628387,1249
"19978","chr11",64234153,64235240,64234696,1087
"19979","chr9",112717802,112718201,112718001,399
"19980","chr9",34809593,34810232,34809912,639
"19981","chr5",76402934,76404335,76403634,1401
"19982","chr11",49102417,49102626,49102521,209
"19983","chr16",77722519,77722784,77722651,265
"19984","chr16",30395010,30395969,30395489,959
"19985","chr17",50161411,50161712,50161561,301
"19986","chr4",882667,882952,882809,285
"19987","chr1",1210188,1210498,1210343,310
"19988","chr19",1140838,1141120,1140979,282
"19989","chr4",17614552,17614883,17614717,331
"19990","chr1",218284677,218285342,218285009,665
"19991","chr21",45868541,45868808,45868674,267
"19992","chr3",55481124,55481440,55481282,316
"19993","chr19",2840866,2842215,2841540,1349
"19994","chr16",75494726,75495539,75495132,813
"19995","chr8",80893720,80894092,80893906,372
"19996","chr9",117744949,117745364,117745156,415
"19997","chr19",33521365,33521812,33521588,447
"19998","chr22",48901961,48902186,48902073,225
"19999","chr19",1496347,1496682,1496514,335
"20000","chr12",26938225,26938924,26938574,699
"20001","chrX",107628391,107628597,107628494,206
"20002","chr14",77760711,77761232,77760971,521
"20003","chr5",1728958,1729167,1729062,209
"20004","chr17",46193066,46194208,46193637,1142
"20005","chr19",4986171,4986394,4986282,223
"20006","chr12",125085282,125085594,125085438,312
"20007","chr8",22047950,22048246,22048098,296
"20008","chr20",51009526,51010306,51009916,780
"20009","chr10",133308487,133309605,133309046,1118
"20010","chr1",179229028,179230065,179229546,1037
"20011","chr4",87219690,87220793,87220241,1103
"20012","chr12",43835802,43836361,43836081,559
"20013","chr2",126972096,126972329,126972212,233
"20014","chr5",139746317,139748126,139747221,1809
"20015","chr1",210232598,210233905,210233251,1307
"20016","chr16",89925727,89926552,89926139,825
"20017","chr19",1795923,1796904,1796413,981
"20018","chr19",16067586,16067799,16067692,213
"20019","chr19",5997020,5997424,5997222,404
"20020","chr11",126282827,126283505,126283166,678
"20021","chr19",12933377,12933851,12933614,474
"20022","chr20",16729862,16730470,16730166,608
"20023","chr19",17292230,17292761,17292495,531
"20024","chr16",1537682,1537898,1537790,216
"20025","chr10",100830365,100830645,100830505,280
"20026","chr19",1070986,1071813,1071399,827
"20027","chr13",43969646,43969882,43969764,236
"20028","chr10",809686,809945,809815,259
"20029","chr19",6024723,6024977,6024850,254
"20030","chr19",2588377,2588592,2588484,215
"20031","chr19",35247887,35249647,35248767,1760
"20032","chrX",48737119,48737590,48737354,471
"20033","chr5",177875422,177875954,177875688,532
"20034","chr20",63406576,63407324,63406950,748
"20035","chr17",75261099,75262020,75261559,921
"20036","chr2",43595789,43596231,43596010,442
"20037","chr22",50089852,50090656,50090254,804
"20038","chr5",79612403,79612868,79612635,465
"20039","chr19",1584446,1585248,1584847,802
"20040","chr10",123972704,123973327,123973015,623
"20041","chr19",35716370,35718789,35717579,2419
"20042","chr10",89251568,89252107,89251837,539
"20043","chr13",24328154,24328558,24328356,404
"20044","chr10",42638075,42638702,42638388,627
"20045","chr2",9630060,9631433,9630746,1373
"20046","chr12",124914012,124915353,124914682,1341
"20047","chr17",1829591,1830273,1829932,682
"20048","chr19",10062022,10062224,10062123,202
"20049","chr12",121797200,121797404,121797302,204
"20050","chr13",43968332,43968757,43968544,425
"20051","chr1",68050553,68050790,68050671,237
"20052","chr5",83473932,83474780,83474356,848
"20053","chr17",76725949,76727338,76726643,1389
"20054","chr11",64971538,64972278,64971908,740
"20055","chr14",35808572,35809414,35808993,842
"20056","chr16",29785040,29785436,29785238,396
"20057","chr13",98752228,98752849,98752538,621
"20058","chr9",134337880,134338085,134337982,205
"20059","chr19",15238917,15239178,15239047,261
"20060","chr19",10352950,10353702,10353326,752
"20061","chr19",8505751,8506330,8506040,579
"20062","chr2",9374594,9374866,9374730,272
"20063","chr5",95619926,95621540,95620733,1614
"20064","chr16",28367809,28368653,28368231,844
"20065","chr8",41528929,41529406,41529167,477
"20066","chr5",146379006,146379319,146379162,313
"20067","chr10",117167510,117168621,117168065,1111
"20068","chr17",81846383,81846612,81846497,229
"20069","chr19",10921257,10921961,10921609,704
"20070","chr19",3648528,3648768,3648648,240
"20071","chr12",52245411,52245632,52245521,221
"20072","chr2",219206583,219207078,219206830,495
"20073","chr12",128795711,128795941,128795826,230
"20074","chr11",130002227,130003528,130002877,1301
"20075","chr11",113314610,113314941,113314775,331
"20076","chr19",1079683,1083431,1081557,3748
"20077","chr15",80152415,80153166,80152790,751
"20078","chr2",171687391,171688180,171687785,789
"20079","chr19",50476172,50476951,50476561,779
"20080","chr13",22915491,22915919,22915705,428
"20081","chr4",13541938,13544870,13543404,2932
"20082","chr19",2078163,2078512,2078337,349
"20083","chr5",159106549,159106992,159106770,443
"20084","chr22",25282609,25283306,25282957,697
"20085","chr7",100493557,100493975,100493766,418
"20086","chr5",1218372,1218589,1218480,217
"20087","chr19",6476671,6477116,6476893,445
"20088","chr15",35121881,35122239,35122060,358
"20089","chr5",150778661,150779092,150778876,431
"20090","chr19",4371732,4371955,4371843,223
"20091","chr22",18077792,18078644,18078218,852
"20092","chr2",69829467,69830451,69829959,984
"20093","chr12",104957795,104958502,104958148,707
"20094","chrX",154515887,154516507,154516197,620
"20095","chr17",7014250,7015220,7014735,970
"20096","chr9",95553059,95553277,95553168,218
"20097","chr5",77210204,77211364,77210784,1160
"20098","chr15",21174863,21175357,21175110,494
"20099","chr20",63371397,63371681,63371539,284
"20100","chr14",105713480,105713681,105713580,201
"20101","chr8",143934740,143935239,143934989,499
"20102","chr5",141417595,141418134,141417864,539
"20103","chrX",37008275,37008633,37008454,358
"20104","chr9",112379574,112380358,112379966,784
"20105","chr5",1077729,1077941,1077835,212
"20106","chr14",34629488,34630272,34629880,784
"20107","chr11",34915781,34916833,34916307,1052
"20108","chr17",59565359,59565933,59565646,574
"20109","chr11",44319715,44320207,44319961,492
"20110","chr1",1255142,1255419,1255280,277
"20111","chr22",38181671,38182064,38181867,393
"20112","chr16",700398,701451,700924,1053
"20113","chr17",42184273,42184591,42184432,318
"20114","chr17",37745343,37745592,37745467,249
"20115","chr8",1492495,1492769,1492632,274
"20116","chr17",47188885,47189608,47189246,723
"20117","chr10",84139302,84139884,84139593,582
"20118","chr5",141389372,141389916,141389644,544
"20119","chr10",49613441,49613642,49613541,201
"20120","chr9",103999349,103999747,103999548,398
"20121","chr17",40100382,40100829,40100605,447
"20122","chr19",3162843,3163163,3163003,320
"20123","chr1",109667959,109668334,109668146,375
"20124","chr8",143379802,143380091,143379946,289
"20125","chr9",129482122,129483453,129482787,1331
"20126","chr19",47679846,47681144,47680495,1298
"20127","chr12",123270699,123272108,123271403,1409
"20128","chr11",132943667,132944500,132944083,833
"20129","chr20",63929222,63929740,63929481,518
"20130","chr19",52189567,52190428,52189997,861
"20131","chr12",123232820,123233841,123233330,1021
"20132","chr4",139453288,139454538,139453913,1250
"20133","chr1",182029790,182030206,182029998,416
"20134","chr2",73070501,73072026,73071263,1525
"20135","chr22",24188210,24188416,24188313,206
"20136","chr11",119148933,119149971,119149452,1038
"20137","chr12",124346587,124346884,124346735,297
"20138","chr12",47963412,47963724,47963568,312
"20139","chr9",37592201,37592737,37592469,536
"20140","chr7",130070252,130070846,130070549,594
"20141","chr19",12681481,12681989,12681735,508
"20142","chr7",39609654,39609911,39609782,257
"20143","chr7",128854005,128854255,128854130,250
"20144","chr2",3528294,3528768,3528531,474
"20145","chr19",36837994,36838616,36838305,622
"20146","chr16",3564315,3564600,3564457,285
"20147","chr5",140631897,140633154,140632525,1257
"20148","chr1",23558351,23558596,23558473,245
"20149","chr19",57786104,57786750,57786427,646
"20150","chr5",176198963,176199703,176199333,740
"20151","chr10",132993672,132993941,132993806,269
"20152","chr11",93661554,93662107,93661830,553
"20153","chr19",58033747,58034529,58034138,782
"20154","chr19",39200336,39200749,39200542,413
"20155","chr2",73202155,73203519,73202837,1364
"20156","chr12",54008898,54009563,54009230,665
"20157","chr5",1008600,1009924,1009262,1324
"20158","chr18",37274284,37275200,37274742,916
"20159","chr3",122577765,122577981,122577873,216
"20160","chr19",7670195,7670570,7670382,375
"20161","chr17",6120333,6120764,6120548,431
"20162","chr12",113478628,113478912,113478770,284
"20163","chr19",45428429,45429037,45428733,608
"20164","chr19",58117942,58118874,58118408,932
"20165","chr19",11339340,11339738,11339539,398
"20166","chr19",37790450,37790784,37790617,334
"20167","chr15",41585243,41585673,41585458,430
"20168","chr19",47349043,47349721,47349382,678
"20169","chr5",115815651,115817016,115816333,1365
"20170","chr19",49850533,49852226,49851379,1693
"20171","chr15",89814170,89815341,89814755,1171
"20172","chr19",43533145,43534134,43533639,989
"20173","chr22",31098672,31099189,31098930,517
"20174","chr4",1798417,1798624,1798520,207
"20175","chr4",187613533,187613759,187613646,226
"20176","chr22",21703790,21704015,21703902,225
"20177","chr17",22517443,22517863,22517653,420
"20178","chr17",52157815,52158874,52158344,1059
"20179","chr10",124791523,124792241,124791882,718
"20180","chr5",179634208,179634671,179634439,463
"20181","chr20",37598215,37598439,37598327,224
"20182","chrY",21404685,21404978,21404831,293
"20183","chr5",136132660,136133473,136133066,813
"20184","chr19",58154656,58155466,58155061,810
"20185","chr15",23303343,23303814,23303578,471
"20186","chr19",11558974,11559429,11559201,455
"20187","chr8",102411817,102412926,102412371,1109
"20188","chr3",148697655,148698145,148697900,490
"20189","chr9",33166702,33167936,33167319,1234
"20190","chr17",38256758,38257412,38257085,654
"20191","chr5",343334,344347,343840,1013
"20192","chr1",243101638,243101894,243101766,256
"20193","chr19",55302699,55302910,55302804,211
"20194","chr22",19717987,19724583,19721285,6596
"20195","chr10",70232658,70233711,70233184,1053
"20196","chr2",135875793,135876659,135876226,866
"20197","chr1",44724033,44724886,44724459,853
"20198","chr12",124344607,124344944,124344775,337
"20199","chr4",41256742,41257850,41257296,1108
"20200","chr5",77972526,77972963,77972744,437
"20201","chr19",45804219,45804708,45804463,489
"20202","chrX",106611798,106612067,106611932,269
"20203","chr11",62753898,62754490,62754194,592
"20204","chr18",22176886,22177119,22177002,233
"20205","chr4",25913730,25914374,25914052,644
"20206","chr17",44123153,44124175,44123664,1022
"20207","chr7",150977649,150978330,150977989,681
"20208","chr7",79452249,79452563,79452406,314
"20209","chr19",796506,798936,797721,2430
"20210","chr11",46295324,46295934,46295629,610
"20211","chr12",57611199,57611681,57611440,482
"20212","chr15",74100000,74100462,74100231,462
"20213","chr5",115544416,115545075,115544745,659
"20214","chr19",38082008,38083112,38082560,1104
"20215","chr10",131979922,131980143,131980032,221
"20216","chr4",139859852,139860279,139860065,427
"20217","chr17",83092946,83093241,83093093,295
"20218","chr7",129126281,129127928,129127104,1647
"20219","chr16",85272084,85272286,85272185,202
"20220","chr19",33176536,33177759,33177147,1223
"20221","chr11",121427233,121427451,121427342,218
"20222","chr16",88899794,88900184,88899989,390
"20223","chr16",2672922,2673673,2673297,751
"20224","chr9",138220919,138221140,138221029,221
"20225","chr16",31033032,31034174,31033603,1142
"20226","chr15",36888381,36888712,36888546,331
"20227","chr2",132254039,132254335,132254187,296
"20228","chr17",68101387,68102490,68101938,1103
"20229","chr1",45803427,45804148,45803787,721
"20230","chr1",1943276,1943576,1943426,300
"20231","chr16",68239642,68240181,68239911,539
"20232","chr11",95230589,95231409,95230999,820
"20233","chr2",130198046,130198701,130198373,655
"20234","chr7",63749460,63749740,63749600,280
"20235","chr19",1368815,1369027,1368921,212
"20236","chr1",40654182,40654464,40654323,282
"20237","chr15",90352240,90352758,90352499,518
"20238","chr9",134591989,134592198,134592093,209
"20239","chr19",50383924,50384676,50384300,752
"20240","chr16",83995851,83996105,83995978,254
"20241","chr20",3228399,3228742,3228570,343
"20242","chr7",19106249,19106633,19106441,384
"20243","chr19",8832032,8832444,8832238,412
"20244","chr12",122203253,122204559,122203906,1306
"20245","chr15",73318832,73319188,73319010,356
"20246","chr7",102433158,102433887,102433522,729
"20247","chr5",115841537,115842559,115842048,1022
"20248","chr12",57674690,57674991,57674840,301
"20249","chr19",49055965,49057240,49056602,1275
"20250","chr12",53966590,53966876,53966733,286
"20251","chr2",120442147,120442417,120442282,270
"20252","chr4",56387302,56387579,56387440,277
"20253","chr10",70600499,70600825,70600662,326
"20254","chr19",19668666,19669337,19669001,671
"20255","chr11",725596,726870,726233,1274
"20256","chr12",6851841,6852709,6852275,868
"20257","chr11",62671575,62672331,62671953,756
"20258","chr19",1969439,1970137,1969788,698
"20259","chr17",40317945,40318728,40318336,783
"20260","chr6",10411161,10413624,10412392,2463
"20261","chr19",6361431,6362003,6361717,572
"20262","chr5",72307989,72308574,72308281,585
"20263","chr10",71217366,71218017,71217691,651
"20264","chr11",1252839,1253040,1252939,201
"20265","chr11",130189648,130189855,130189751,207
"20266","chrX",73079542,73080064,73079803,522
"20267","chr19",17747562,17748082,17747822,520
"20268","chr20",16574873,16575134,16575003,261
"20269","chr20",63028897,63029529,63029213,632
"20270","chr9",78030930,78032587,78031758,1657
"20271","chr19",16283639,16283851,16283745,212
"20272","chr19",51464055,51464381,51464218,326
"20273","chr5",132822850,132823511,132823180,661
"20274","chr4",54099996,54101896,54100946,1900
"20275","chr7",73607156,73607390,73607273,234
"20276","chr19",7620266,7621296,7620781,1030
"20277","chr19",3035640,3035874,3035757,234
"20278","chr7",90346471,90346713,90346592,242
"20279","chr12",116882015,116882248,116882131,233
"20280","chr19",58367019,58369228,58368123,2209
"20281","chr11",60934210,60934747,60934478,537
"20282","chr17",7767816,7768085,7767950,269
"20283","chr19",13104430,13104729,13104579,299
"20284","chr11",65116643,65117976,65117309,1333
"20285","chr9",130929617,130930066,130929841,449
"20286","chr13",111402078,111402297,111402187,219
"20287","chr19",37468950,37469713,37469331,763
"20288","chr19",38869276,38870520,38869898,1244
"20289","chr7",22549691,22549894,22549792,203
"20290","chr17",81056738,81056964,81056851,226
"20291","chr6",1388904,1391158,1390031,2254
"20292","chr1",1267786,1268084,1267935,298
"20293","chr1",155193643,155194027,155193835,384
"20294","chr13",111153291,111154184,111153737,893
"20295","chr1",45303541,45304245,45303893,704
"20296","chr3",179652654,179653761,179653207,1107
"20297","chr9",120876224,120877658,120876941,1434
"20298","chr10",131981394,131983094,131982244,1700
"20299","chrX",65034528,65035411,65034969,883
"20300","chr9",27528359,27528727,27528543,368
"20301","chr1",26411091,26411657,26411374,566
"20302","chr10",86970797,86971875,86971336,1078
"20303","chr17",65055775,65057237,65056506,1462
"20304","chr7",26376126,26377271,26376698,1145
"20305","chr8",143695839,143696290,143696064,451
"20306","chr8",144185501,144185967,144185734,466
"20307","chr5",1201328,1202023,1201675,695
"20308","chr5",38845400,38846374,38845887,974
"20309","chr17",81901932,81903087,81902509,1155
"20310","chr12",132269172,132269770,132269471,598
"20311","chr10",104315207,104315610,104315408,403
"20312","chr9",37575921,37576448,37576184,527
"20313","chr19",37403441,37403963,37403702,522
"20314","chr3",27723705,27724184,27723944,479
"20315","chr11",73342603,73343257,73342930,654
"20316","chr6",104953002,104953274,104953138,272
"20317","chr19",56146839,56147184,56147011,345
"20318","chr17",29588700,29589661,29589180,961
"20319","chr12",51863960,51864452,51864206,492
"20320","chr13",79480931,79481578,79481254,647
"20321","chr16",88879209,88879453,88879331,244
"20322","chr8",85438536,85438967,85438751,431
"20323","chr17",42536015,42536753,42536384,738
"20324","chr19",55461330,55462075,55461702,745
"20325","chr7",157553919,157554375,157554147,456
"20326","chr9",93058462,93059183,93058822,721
"20327","chr19",42283597,42284919,42284258,1322
"20328","chr3",53044940,53047085,53046012,2145
"20329","chr12",107843660,107844944,107844302,1284
"20330","chr1",241356639,241357490,241357064,851
"20331","chr20",46153294,46153554,46153424,260
"20332","chr6",107028072,107028516,107028294,444
"20333","chr12",117360271,117361643,117360957,1372
"20334","chr19",39172960,39173175,39173067,215
"20335","chr18",48135943,48137149,48136546,1206
"20336","chr11",85663828,85665190,85664509,1362
"20337","chr20",62824066,62824395,62824230,329
"20338","chr19",44754446,44754661,44754553,215
"20339","chr12",50085103,50085546,50085324,443
"20340","chr9",22008658,22009472,22009065,814
"20341","chr17",50105893,50106114,50106003,221
"20342","chr6",19804623,19805140,19804881,517
"20343","chr11",93850121,93850551,93850336,430
"20344","chr19",33905566,33907174,33906370,1608
"20345","chr13",110648969,110649246,110649107,277
"20346","chr19",40750412,40751329,40750870,917
"20347","chr20",10172120,10172545,10172332,425
"20348","chr13",20435635,20436199,20435917,564
"20349","chr16",1201565,1202155,1201860,590
"20350","chr19",17305495,17306444,17305969,949
"20351","chr11",30322989,30323399,30323194,410
"20352","chr5",141151576,141152436,141152006,860
"20353","chr17",8249196,8249515,8249355,319
"20354","chr16",24539297,24540379,24539838,1082
"20355","chr2",48440420,48441216,48440818,796
"20356","chr11",59106416,59107013,59106714,597
"20357","chr9",5042797,5043270,5043033,473
"20358","chr19",7920180,7921090,7920635,910
"20359","chr4",931792,932700,932246,908
"20360","chr13",111254394,111255232,111254813,838
"20361","chr4",991138,991907,991522,769
"20362","chr9",136504588,136505936,136505262,1348
"20363","chr4",39770059,39770324,39770191,265
"20364","chr6",10421181,10421494,10421337,313
"20365","chr10",1373781,1374054,1373917,273
"20366","chr12",47812938,47813343,47813140,405
"20367","chr12",132244046,132244834,132244440,788
"20368","chr19",16075979,16077465,16076722,1486
"20369","chr10",133012626,133013339,133012982,713
"20370","chr19",6495264,6496214,6495739,950
"20371","chr11",13668041,13669177,13668609,1136
"20372","chr6",36027468,36028595,36028031,1127
"20373","chr5",1729659,1729892,1729775,233
"20374","chr8",21919331,21920431,21919881,1100
"20375","chr7",1647080,1647372,1647226,292
"20376","chr2",231604436,231605061,231604748,625
"20377","chr7",5562171,5562498,5562334,327
"20378","chr7",156948778,156949205,156948991,427
"20379","chr4",76740296,76741931,76741113,1635
"20380","chr16",30555368,30555957,30555662,589
"20381","chr1",156212793,156213306,156213049,513
"20382","chr5",150190029,150190382,150190205,353
"20383","chr10",42866104,42866902,42866503,798
"20384","chr19",3481784,3482050,3481917,266
"20385","chr1",1054894,1055314,1055104,420
"20386","chr22",18048449,18048738,18048593,289
"20387","chr12",112184378,112185011,112184694,633
"20388","chr7",45157582,45158208,45157895,626
"20389","chr3",52245585,52246124,52245854,539
"20390","chr22",38038798,38039197,38038997,399
"20391","chr15",41332164,41333142,41332653,978
"20392","chr19",53132372,53132977,53132674,605
"20393","chr10",102854243,102854569,102854406,326
"20394","chr10",132736119,132736372,132736245,253
"20395","chr11",130040410,130041055,130040732,645
"20396","chr4",7050590,7050886,7050738,296
"20397","chr11",406491,407871,407181,1380
"20398","chr12",51820395,51822354,51821374,1959
"20399","chr5",181100368,181101782,181101075,1414
"20400","chr19",38255998,38256739,38256368,741
"20401","chr9",37036480,37038344,37037412,1864
"20402","chr19",12858386,12858707,12858546,321
"20403","chr7",66044087,66044495,66044291,408
"20404","chr5",210849,211213,211031,364
"20405","chr2",33727355,33727617,33727486,262
"20406","chr11",67435848,67436191,67436019,343
"20407","chr17",4997062,4998503,4997782,1441
"20408","chr6",106510357,106510843,106510600,486
"20409","chr1",120340912,120342284,120341598,1372
"20410","chr18",79635323,79635575,79635449,252
"20411","chr7",1225475,1225743,1225609,268
"20412","chr6",160133629,160134472,160134050,843
"20413","chr16",30814207,30814657,30814432,450
"20414","chr3",170181158,170181838,170181498,680
"20415","chr19",10502370,10503604,10502987,1234
"20416","chr15",48811072,48811499,48811285,427
"20417","chr9",135258556,135259383,135258969,827
"20418","chr17",58083282,58084133,58083707,851
"20419","chr19",12064645,12065242,12064943,597
"20420","chr19",18168704,18169368,18169036,664
"20421","chr12",26122197,26122945,26122571,748
"20422","chr19",47514460,47515525,47514992,1065
"20423","chr17",49890510,49891046,49890778,536
"20424","chr11",67507596,67508960,67508278,1364
"20425","chr15",45129038,45130196,45129617,1158
"20426","chr13",20414868,20415475,20415171,607
"20427","chr11",124758471,124759694,124759082,1223
"20428","chr9",128067256,128068670,128067963,1414
"20429","chrY",5002703,5003184,5002943,481
"20430","chr7",102464676,102465335,102465005,659
"20431","chr22",17007384,17008304,17007844,920
"20432","chrX",150547701,150548013,150547857,312
"20433","chr10",101031063,101031292,101031177,229
"20434","chr4",574724,576699,575711,1975
"20435","chr17",37742043,37744775,37743409,2732
"20436","chr1",94247350,94247961,94247655,611
"20437","chr11",63813049,63814268,63813658,1219
"20438","chr5",77030295,77031046,77030670,751
"20439","chr10",87659589,87660270,87659929,681
"20440","chr8",144900703,144902670,144901686,1967
"20441","chr19",39341858,39342363,39342110,505
"20442","chr4",6782145,6783541,6782843,1396
"20443","chr5",154475630,154476568,154476099,938
"20444","chr16",4609347,4609612,4609479,265
"20445","chr19",22286565,22286885,22286725,320
"20446","chr17",32876433,32877270,32876851,837
"20447","chr10",70440309,70441612,70440960,1303
"20448","chr7",27110411,27110799,27110605,388
"20449","chr6",38715173,38715489,38715331,316
"20450","chr7",136973361,136973573,136973467,212
"20451","chr19",55401442,55401730,55401586,288
"20452","chr17",79747447,79748698,79748072,1251
"20453","chr7",103445897,103446393,103446145,496
"20454","chr19",5243858,5244382,5244120,524
"20455","chr17",44689638,44689885,44689761,247
"20456","chr22",50719958,50721632,50720795,1674
"20457","chr17",42784427,42784650,42784538,223
"20458","chr2",44928631,44929910,44929270,1279
"20459","chr22",46576564,46577712,46577138,1148
"20460","chr9",130444477,130445423,130444950,946
"20461","chrX",133984054,133984467,133984260,413
"20462","chr11",60914080,60914796,60914438,716
"20463","chr11",279072,281700,280386,2628
"20464","chr17",82575885,82576301,82576093,416
"20465","chr1",61050254,61051159,61050706,905
"20466","chr10",93600632,93601630,93601131,998
"20467","chr6",148559880,148560305,148560092,425
"20468","chr19",4636195,4636555,4636375,360
"20469","chr19",39915152,39915864,39915508,712
"20470","chr10",9407175,9408246,9407710,1071
"20471","chr17",43315291,43315733,43315512,442
"20472","chr10",101570095,101570408,101570251,313
"20473","chr19",48670343,48670549,48670446,206
"20474","chr2",237798365,237799284,237798824,919
"20475","chr1",28592479,28592942,28592710,463
"20476","chr19",860517,862123,861320,1606
"20477","chr17",81419541,81419942,81419741,401
"20478","chr9",36739537,36739785,36739661,248
"20479","chr10",101060731,101063117,101061924,2386
"20480","chr7",144195481,144196016,144195748,535
"20481","chr1",236686172,236687023,236686597,851
"20482","chr8",42843287,42843580,42843433,293
"20483","chr16",67149305,67151065,67150185,1760
"20484","chr7",158268202,158268408,158268305,206
"20485","chr19",38564859,38565739,38565299,880
"20486","chr5",151223652,151224192,151223922,540
"20487","chr19",38499623,38499833,38499728,210
"20488","chr19",17725946,17728007,17726976,2061
"20489","chr19",49453022,49453580,49453301,558
"20490","chr15",68559487,68559869,68559678,382
"20491","chr15",68431028,68432352,68431690,1324
"20492","chr19",49861578,49863029,49862303,1451
"20493","chr18",79022657,79022896,79022776,239
"20494","chr1",220882150,220882458,220882304,308
"20495","chr6",136360612,136361135,136360873,523
"20496","chr5",77851174,77851550,77851362,376
"20497","chr19",17301227,17301608,17301417,381
"20498","chr19",9621058,9621318,9621188,260
"20499","chr5",1466675,1466885,1466780,210
"20500","chrX",118345602,118346525,118346063,923
"20501","chr14",37583440,37584961,37584200,1521
"20502","chr19",42313260,42313886,42313573,626
"20503","chr16",89522408,89522650,89522529,242
"20504","chr5",121961809,121962200,121962004,391
"20505","chr9",135778762,135778991,135778876,229
"20506","chr6",26811804,26812093,26811948,289
"20507","chr17",48552191,48552454,48552322,263
"20508","chr16",1971738,1972589,1972163,851
"20509","chr1",32741533,32742273,32741903,740
"20510","chrX",151174675,151175797,151175236,1122
"20511","chr2",27118699,27119291,27118995,592
"20512","chr2",127025037,127025253,127025145,216
"20513","chr10",13099778,13100493,13100135,715
"20514","chr4",80197941,80198237,80198089,296
"20515","chr5",129903860,129905919,129904889,2059
"20516","chr1",21864856,21865099,21864977,243
"20517","chr17",4004699,4005083,4004891,384
"20518","chr19",53254566,53255313,53254939,747
"20519","chr1",165698307,165698580,165698443,273
"20520","chr11",797640,798544,798092,904
"20521","chr12",62260084,62260896,62260490,812
"20522","chr12",133181360,133181602,133181481,242
"20523","chr17",74859498,74861742,74860620,2244
"20524","chr11",597465,597700,597582,235
"20525","chr19",55032849,55033554,55033201,705
"20526","chr5",141123308,141124222,141123765,914
"20527","chr4",88523256,88523904,88523580,648
"20528","chr19",54200716,54201336,54201026,620
"20529","chr10",11344303,11344876,11344589,573
"20530","chr18",79365676,79365885,79365780,209
"20531","chr22",24554830,24556106,24555468,1276
"20532","chr16",30820965,30821239,30821102,274
"20533","chr2",236159427,236160190,236159808,763
"20534","chr3",98657472,98657698,98657585,226
"20535","chr17",57084812,57086547,57085679,1735
"20536","chr16",3150383,3150618,3150500,235
"20537","chr19",35748771,35748983,35748877,212
"20538","chr19",611291,611579,611435,288
"20539","chr2",96208113,96209086,96208599,973
"20540","chr7",25124929,25125617,25125273,688
"20541","chr11",73760230,73761438,73760834,1208
"20542","chr12",47904862,47905754,47905308,892
"20543","chr12",131710489,131711909,131711199,1420
"20544","chr21",34614324,34615499,34614911,1175
"20545","chr13",45391113,45391424,45391268,311
"20546","chr15",59371664,59372882,59372273,1218
"20547","chr19",58059025,58060411,58059718,1386
"20548","chr22",21651790,21652759,21652274,969
"20549","chr19",15372815,15373096,15372955,281
"20550","chr7",1870761,1871620,1871190,859
"20551","chr19",18940210,18941311,18940760,1101
"20552","chr7",155533116,155533662,155533389,546
"20553","chr11",976949,977193,977071,244
"20554","chr11",3232538,3232836,3232687,298
"20555","chr8",11071474,11071701,11071587,227
"20556","chr20",380762,382161,381461,1399
"20557","chr10",13586789,13587266,13587027,477
"20558","chr19",5686794,5687951,5687372,1157
"20559","chr3",27632718,27633148,27632933,430
"20560","chr19",51689332,51689583,51689457,251
"20561","chr3",77098016,77098248,77098132,232
"20562","chr21",44349904,44351065,44350484,1161
"20563","chr19",16829318,16829595,16829456,277
"20564","chr14",19687977,19688252,19688114,275
"20565","chr6",26597880,26598088,26597984,208
"20566","chr15",23039156,23039785,23039470,629
"20567","chr7",73312828,73313444,73313136,616
"20568","chr8",85826621,85828448,85827534,1827
"20569","chr22",18846273,18846559,18846416,286
"20570","chr19",11361229,11361623,11361426,394
"20571","chr4",1855338,1857160,1856249,1822
"20572","chr17",63523049,63523438,63523243,389
"20573","chr2",101307902,101308895,101308398,993
"20574","chr1",9731100,9731428,9731264,328
"20575","chr5",140363314,140363563,140363438,249
"20576","chr17",6444145,6444791,6444468,646
"20577","chr1",181088367,181090040,181089203,1673
"20578","chr17",44210324,44211024,44210674,700
"20579","chr1",1059056,1059923,1059489,867
"20580","chr11",1382984,1383481,1383232,497
"20581","chr19",535919,536783,536351,864
"20582","chr1",83860584,83861155,83860869,571
"20583","chr9",138046856,138047074,138046965,218
"20584","chr9",64772856,64775302,64774079,2446
"20585","chr19",12666516,12666824,12666670,308
"20586","chr11",130448339,130450303,130449321,1964
"20587","chr3",129003440,129004193,129003816,753
"20588","chr4",121696307,121697468,121696887,1161
"20589","chr1",236348053,236348477,236348265,424
"20590","chr16",2234625,2235597,2235111,972
"20591","chr1",22563102,22563603,22563352,501
"20592","chr19",14085432,14085894,14085663,462
"20593","chr22",36386920,36388447,36387683,1527
"20594","chr19",56864474,56865054,56864764,580
"20595","chr11",69868590,69868852,69868721,262
"20596","chr8",130015936,130016849,130016392,913
"20597","chr22",18935957,18936327,18936142,370
"20598","chr15",41543947,41544414,41544180,467
"20599","chr1",147078742,147079711,147079226,969
"20600","chr19",855526,856146,855836,620
"20601","chr16",3003829,3004928,3004378,1099
"20602","chr5",142325826,142326123,142325974,297
"20603","chr1",229594594,229594870,229594732,276
"20604","chr11",1546710,1547677,1547193,967
"20605","chr5",177403274,177404638,177403956,1364
"20606","chr1",156456757,156457570,156457163,813
"20607","chr2",104863739,104864302,104864020,563
"20608","chr2",156319739,156320834,156320286,1095
"20609","chr3",45388524,45388745,45388634,221
"20610","chr2",196799488,196799848,196799668,360
"20611","chr18",10414357,10414595,10414476,238
"20612","chr9",133585890,133586154,133586022,264
"20613","chr2",148875113,148876313,148875713,1200
"20614","chr6",160258345,160258669,160258507,324
"20615","chr1",1625400,1625675,1625537,275
"20616","chrX",137549917,137551160,137550538,1243
"20617","chr8",102810386,102811035,102810710,649
"20618","chr1",101236229,101236512,101236370,283
"20619","chr2",24971271,24972345,24971808,1074
"20620","chr4",2040388,2042854,2041621,2466
"20621","chr2",85584217,85584732,85584474,515
"20622","chr1",151540185,151540723,151540454,538
"20623","chr9",136049928,136052175,136051051,2247
"20624","chr1",1047794,1048232,1048013,438
"20625","chrX",3310327,3310568,3310447,241
"20626","chr17",75874641,75874876,75874758,235
"20627","chr2",50346903,50347679,50347291,776
"20628","chr12",131734782,131734994,131734888,212
"20629","chr7",989829,990689,990259,860
"20630","chr3",134029557,134030165,134029861,608
"20631","chr17",48530442,48531028,48530735,586
"20632","chr17",75904445,75905272,75904858,827
"20633","chr19",10269611,10271289,10270450,1678
"20634","chr10",100826368,100829867,100828117,3499
"20635","chr4",26359550,26359789,26359669,239
"20636","chr21",13665874,13666494,13666184,620
"20637","chr11",73307407,73309518,73308462,2111
"20638","chr2",69914227,69915807,69915017,1580
"20639","chr7",99616601,99617262,99616931,661
"20640","chr20",62336919,62337473,62337196,554
"20641","chrX",154136752,154137199,154136975,447
"20642","chr17",50931259,50931794,50931526,535
"20643","chr5",140883500,140884569,140884034,1069
"20644","chr9",101533635,101533950,101533792,315
"20645","chr17",68511649,68513077,68512363,1428
"20646","chr17",27892912,27893449,27893180,537
"20647","chr9",132240934,132242542,132241738,1608
"20648","chr8",79891453,79892089,79891771,636
"20649","chr21",46323771,46325437,46324604,1666
"20650","chr13",113215687,113215889,113215788,202
"20651","chr17",7380904,7381368,7381136,464
"20652","chr8",143568631,143570118,143569374,1487
"20653","chr1",213051269,213051525,213051397,256
"20654","chr7",66493483,66494134,66493808,651
"20655","chr10",132202539,132202840,132202689,301
"20656","chr3",52409661,52410118,52409889,457
"20657","chr5",140647241,140647919,140647580,678
"20658","chr11",44308992,44310123,44309557,1131
"20659","chr11",70463591,70464016,70463803,425
"20660","chr6",170394433,170394678,170394555,245
"20661","chr7",493825,494472,494148,647
"20662","chr17",35766552,35766817,35766684,265
"20663","chr5",69414980,69415693,69415336,713
"20664","chr8",57994391,57995263,57994827,872
"20665","chr12",121839395,121839633,121839514,238
"20666","chr2",219055449,219055859,219055654,410
"20667","chr8",72251383,72251956,72251669,573
"20668","chr8",141205592,141206200,141205896,608
"20669","chr11",9460562,9461605,9461083,1043
"20670","chr10",79444696,79446055,79445375,1359
"20671","chr7",157008724,157008938,157008831,214
"20672","chr10",131260075,131260346,131260210,271
"20673","chr21",46635287,46636148,46635717,861
"20674","chr7",158549968,158550272,158550120,304
"20675","chr17",27456073,27457332,27456702,1259
"20676","chr10",23172371,23172681,23172526,310
"20677","chr16",68510022,68510400,68510211,378
"20678","chr19",17448108,17448721,17448414,613
"20679","chrX",149631156,149632023,149631589,867
"20680","chr9",72149325,72149987,72149656,662
"20681","chr10",671083,672390,671736,1307
"20682","chr7",12403537,12404079,12403808,542
"20683","chr2",232927073,232929212,232928142,2139
"20684","chr5",172255491,172255724,172255607,233
"20685","chr9",70043920,70044616,70044268,696
"20686","chr16",58197361,58198414,58197887,1053
"20687","chr9",136370739,136371438,136371088,699
"20688","chr17",50425695,50426526,50426110,831
"20689","chr14",101705666,101706368,101706017,702
"20690","chr12",132154915,132155404,132155159,489
"20691","chr5",258686,262286,260486,3600
"20692","chr7",6104416,6105688,6105052,1272
"20693","chr19",4182262,4182806,4182534,544
"20694","chr17",41548793,41549080,41548936,287
"20695","chr5",15936532,15937207,15936869,675
"20696","chr12",121823423,121823687,121823555,264
"20697","chr22",20146939,20147182,20147060,243
"20698","chr9",136746188,136746433,136746310,245
"20699","chr22",20701970,20704505,20703237,2535
"20700","chr16",35173265,35173548,35173406,283
"20701","chr9",128504559,128504998,128504778,439
"20702","chr11",45899836,45900616,45900226,780
"20703","chr20",26009755,26010105,26009930,350
"20704","chr4",25504959,25506454,25505706,1495
"20705","chr10",129840300,129840576,129840438,276
"20706","chr3",41891117,41891336,41891226,219
"20707","chr5",309590,310021,309805,431
"20708","chr17",44141785,44142248,44142016,463
"20709","chr2",219552141,219553147,219552644,1006
"20710","chr7",73234619,73235915,73235267,1296
"20711","chr1",243487688,243488227,243487957,539
"20712","chr12",116749998,116750220,116750109,222
"20713","chr4",82890805,82891555,82891180,750
"20714","chr2",219513021,219513224,219513122,203
"20715","chr10",101018847,101019165,101019006,318
"20716","chr17",28717150,28718031,28717590,881
"20717","chr2",241846629,241848969,241847799,2340
"20718","chr8",143289276,143289906,143289591,630
"20719","chr16",31569238,31569702,31569470,464
"20720","chr11",6473545,6473829,6473687,284
"20721","chr10",118594180,118596309,118595244,2129
"20722","chr17",21551125,21551675,21551400,550
"20723","chr12",6914097,6914925,6914511,828
"20724","chr2",241035489,241036901,241036195,1412
"20725","chr15",91022224,91022690,91022457,466
"20726","chr11",111977203,111977676,111977439,473
"20727","chr11",111540207,111541474,111540840,1267
"20728","chr11",65576034,65576378,65576206,344
"20729","chr21",17612217,17613379,17612798,1162
"20730","chr17",18625063,18625668,18625365,605
"20731","chr7",150340370,150341672,150341021,1302
"20732","chr7",27192186,27193478,27192832,1292
"20733","chr19",862930,863227,863078,297
"20734","chrX",131072939,131073481,131073210,542
"20735","chr6",125986386,125986785,125986585,399
"20736","chr20",53593051,53594821,53593936,1770
"20737","chr13",44437015,44437259,44437137,244
"20738","chr18",79807283,79810039,79808661,2756
"20739","chr11",78196194,78197042,78196618,848
"20740","chr20",63065856,63066058,63065957,202
"20741","chr12",3873080,3873542,3873311,462
"20742","chr7",74890144,74891068,74890606,924
"20743","chr5",55220521,55221091,55220806,570
"20744","chr15",75625262,75625871,75625566,609
"20745","chr6",33317438,33317840,33317639,402
"20746","chr19",2199922,2200127,2200024,205
"20747","chr5",43515031,43515247,43515139,216
"20748","chr17",21316679,21317100,21316889,421
"20749","chr11",67583457,67584482,67583969,1025
"20750","chr6",87151808,87152795,87152301,987
"20751","chr10",73246871,73247426,73247148,555
"20752","chr2",44954751,44955972,44955361,1221
"20753","chrX",49532091,49532704,49532397,613
"20754","chr4",152976300,152976597,152976448,297
"20755","chrX",104075722,104076295,104076008,573
"20756","chr12",27779818,27780805,27780311,987
"20757","chr11",33375946,33376948,33376447,1002
"20758","chr20",58461247,58461549,58461398,302
"20759","chr2",238150778,238151009,238150893,231
"20760","chr8",94474702,94475133,94474917,431
"20761","chr5",2866585,2866891,2866738,306
"20762","chr22",39502095,39502784,39502439,689
"20763","chr11",17779479,17779730,17779604,251
"20764","chr11",66860059,66860261,66860160,202
"20765","chr17",75034581,75035065,75034823,484
"20766","chrX",8783244,8783567,8783405,323
"20767","chr20",33862694,33862959,33862826,265
"20768","chr22",24270612,24271507,24271059,895
"20769","chr12",132143321,132144924,132144122,1603
"20770","chr8",1187207,1188672,1187939,1465
"20771","chr4",834360,834572,834466,212
"20772","chrX",132489116,132490087,132489601,971
"20773","chr19",48661498,48662036,48661767,538
"20774","chr7",151114517,151115735,151115126,1218
"20775","chr2",177618505,177619055,177618780,550
"20776","chr22",21567647,21568426,21568036,779
"20777","chr4",3073756,3074831,3074293,1075
"20778","chr17",7351303,7352489,7351896,1186
"20779","chr22",30968578,30969589,30969083,1011
"20780","chr4",1228049,1228262,1228155,213
"20781","chr2",181457034,181458302,181457668,1268
"20782","chr2",132585541,132585809,132585675,268
"20783","chr2",95402555,95403092,95402823,537
"20784","chr22",49168124,49168686,49168405,562
"20785","chr12",48001585,48002150,48001867,565
"20786","chr6",28137003,28137462,28137232,459
"20787","chr21",36704462,36705385,36704923,923
"20788","chr11",789871,790208,790039,337
"20789","chr7",122303813,122306181,122304997,2368
"20790","chr2",238163550,238164468,238164009,918
"20791","chr16",1028688,1029008,1028848,320
"20792","chr16",75516715,75517519,75517117,804
"20793","chr21",34072787,34074105,34073446,1318
"20794","chr11",1926301,1926728,1926514,427
"20795","chr16",32811133,32812264,32811698,1131
"20796","chr3",160225129,160226644,160225886,1515
"20797","chr5",131796236,131797610,131796923,1374
"20798","chr11",129618064,129618408,129618236,344
"20799","chr11",107457715,107457965,107457840,250
"20800","chr2",72862617,72862887,72862752,270
"20801","chr9",94165838,94167179,94166508,1341
"20802","chr11",73779499,73779744,73779621,245
"20803","chr2",72143992,72150046,72147019,6054
"20804","chr4",153249216,153249448,153249332,232
"20805","chr11",3580621,3581386,3581003,765
"20806","chr10",61001268,61001837,61001552,569
"20807","chr19",14333531,14333772,14333651,241
"20808","chr2",4108499,4108853,4108676,354
"20809","chr5",150527903,150528125,150528014,222
"20810","chr1",53078432,53079011,53078721,579
"20811","chr16",85641237,85641586,85641411,349
"20812","chr1",919385,919593,919489,208
"20813","chr9",95874963,95876163,95875563,1200
"20814","chr12",132569931,132571539,132570735,1608
"20815","chr2",172106317,172106659,172106488,342
"20816","chr1",202193880,202194262,202194071,382
"20817","chr10",73772212,73773059,73772635,847
"20818","chr6",52419951,52420455,52420203,504
"20819","chr20",63284582,63284938,63284760,356
"20820","chr5",180161400,180161773,180161586,373
"20821","chr8",70607445,70608622,70608033,1177
"20822","chr11",818974,820271,819622,1297
"20823","chr3",141486697,141486902,141486799,205
"20824","chr17",2362198,2362582,2362390,384
"20825","chr12",49322847,49323235,49323041,388
"20826","chr17",41665962,41666183,41666072,221
"20827","chr17",44199321,44200775,44200048,1454
"20828","chr8",143290761,143291669,143291215,908
"20829","chr12",123533046,123534447,123533746,1401
"20830","chr13",95552437,95553242,95552839,805
"20831","chr17",8176172,8176807,8176489,635
"20832","chr1",161530638,161530962,161530800,324
"20833","chr5",141370483,141370697,141370590,214
"20834","chr9",94332344,94332776,94332560,432
"20835","chr1",36083953,36084420,36084186,467
"20836","chr8",144449968,144450759,144450363,791
"20837","chr1",2959980,2960243,2960111,263
"20838","chr10",101123220,101123794,101123507,574
"20839","chr14",55271222,55272281,55271751,1059
"20840","chr9",134049340,134049554,134049447,214
"20841","chr19",5039845,5040051,5039948,206
"20842","chr7",1289745,1290572,1290158,827
"20843","chr2",660666,660909,660787,243
"20844","chr6",26250208,26250599,26250403,391
"20845","chr7",1989481,1989691,1989586,210
"20846","chr12",132154401,132154607,132154504,206
"20847","chr12",131087956,131088400,131088178,444
"20848","chr6",125956646,125957355,125957000,709
"20849","chr21",44988010,44988228,44988119,218
"20850","chr3",10026214,10026581,10026397,367
"20851","chr17",43378774,43379005,43378889,231
"20852","chr5",1216524,1216966,1216745,442
"20853","chr19",9735681,9735938,9735809,257
"20854","chrX",47232883,47233907,47233395,1024
"20855","chr4",158722996,158723513,158723254,517
"20856","chrX",135343658,135344074,135343866,416
"20857","chr20",58388942,58389748,58389345,806
"20858","chr1",119140251,119140788,119140519,537
"20859","chrY",11954969,11955454,11955211,485
"20860","chr3",105367146,105367379,105367262,233
"20861","chr20",63789737,63791031,63790384,1294
"20862","chr2",181683146,181684450,181683798,1304
"20863","chr8",144412581,144413798,144413189,1217
"20864","chr1",21828807,21829072,21828939,265
"20865","chr15",26082348,26082749,26082548,401
"20866","chr22",19760491,19761666,19761078,1175
"20867","chr19",15199708,15201216,15200462,1508
"20868","chr19",1861712,1861915,1861813,203
"20869","chr20",63969300,63970323,63969811,1023
"20870","chr6",27146443,27147402,27146922,959
"20871","chr5",179657874,179658337,179658105,463
"20872","chr1",44986350,44986772,44986561,422
"20873","chr21",46382550,46384845,46383697,2295
"20874","chr19",36605055,36605639,36605347,584
"20875","chr11",123430341,123431121,123430731,780
"20876","chr13",114020859,114021061,114020960,202
"20877","chr4",187064062,187064319,187064190,257
"20878","chr1",28668659,28669321,28668990,662
"20879","chr12",12891108,12891733,12891420,625
"20880","chr1",53220224,53220719,53220471,495
"20881","chr4",112145314,112146223,112145768,909
"20882","chr19",18932094,18932577,18932335,483
"20883","chr10",35089906,35090704,35090305,798
"20884","chr19",4535057,4535327,4535192,270
"20885","chr2",153871393,153871936,153871664,543
"20886","chr19",35267133,35269962,35268547,2829
"20887","chr11",74467130,74467756,74467443,626
"20888","chr6",139373082,139373339,139373210,257
"20889","chr19",19110387,19110766,19110576,379
"20890","chr1",90723582,90723843,90723712,261
"20891","chr19",19501129,19501498,19501313,369
"20892","chr6",108175511,108176116,108175813,605
"20893","chr22",24685883,24686145,24686014,262
"20894","chr4",3871365,3872284,3871824,919
"20895","chrX",107205799,107206510,107206154,711
"20896","chr11",17771729,17772412,17772070,683
"20897","chr11",1881848,1882104,1881976,256
"20898","chr5",76082073,76082364,76082218,291
"20899","chr10",70918549,70918813,70918681,264
"20900","chr10",78033736,78034194,78033965,458
"20901","chr5",69093850,69094507,69094178,657
"20902","chr2",487884,488610,488247,726
"20903","chr1",156641847,156642655,156642251,808
"20904","chr9",97633058,97634132,97633595,1074
"20905","chr1",26035102,26036217,26035659,1115
"20906","chr19",6475240,6475987,6475613,747
"20907","chr19",2950361,2950964,2950662,603
"20908","chr9",86098790,86099993,86099391,1203
"20909","chr7",63789596,63790570,63790083,974
"20910","chr5",178729128,178729554,178729341,426
"20911","chr8",21782649,21782853,21782751,204
"20912","chr11",888684,888981,888832,297
"20913","chr5",1273134,1273386,1273260,252
"20914","chr22",43110494,43111604,43111049,1110
"20915","chr2",27150145,27150346,27150245,201
"20916","chr7",986531,986759,986645,228
"20917","chrX",49171743,49172764,49172253,1021
"20918","chr17",385188,386371,385779,1183
"20919","chr9",83537438,83538862,83538150,1424
"20920","chr20",63086415,63086654,63086534,239
"20921","chr9",32955653,32956280,32955966,627
"20922","chr10",133182814,133183497,133183155,683
"20923","chr3",52055636,52056829,52056232,1193
"20924","chr7",151448148,151448889,151448518,741
"20925","chr19",10430588,10431044,10430816,456
"20926","chr20",62366563,62367628,62367095,1065
"20927","chr9",137882679,137882955,137882817,276
"20928","chr16",30474061,30474400,30474230,339
"20929","chr19",5047440,5047819,5047629,379
"20930","chrY",9377875,9378396,9378135,521
"20931","chr8",141217838,141219061,141218449,1223
"20932","chr7",100894596,100897321,100895958,2725
"20933","chr15",45187311,45187940,45187625,629
"20934","chr2",25673033,25673987,25673510,954
"20935","chr9",90801493,90802264,90801878,771
"20936","chr11",30016125,30016397,30016261,272
"20937","chr15",90101766,90102932,90102349,1166
"20938","chr2",66433986,66434525,66434255,539
"20939","chr17",81977261,81978175,81977718,914
"20940","chr8",48130966,48131189,48131077,223
"20941","chr19",7636775,7637450,7637112,675
"20942","chr16",5097249,5098643,5097946,1394
"20943","chr16",88783796,88784129,88783962,333
"20944","chr9",128275312,128276416,128275864,1104
"20945","chr19",48170072,48170878,48170475,806
"20946","chr8",2023748,2024245,2023996,497
"20947","chr16",964739,964976,964857,237
"20948","chr19",3984964,3985724,3985344,760
"20949","chr22",23849360,23849798,23849579,438
"20950","chr2",32165608,32165879,32165743,271
"20951","chr10",100115064,100115382,100115223,318
"20952","chr7",2523976,2524422,2524199,446
"20953","chr10",97570203,97570447,97570325,244
"20954","chr10",133445920,133446688,133446304,768
"20955","chr11",45885455,45886258,45885856,803
"20956","chr20",37406582,37406800,37406691,218
"20957","chr19",9834829,9835713,9835271,884
"20958","chr7",43444791,43445524,43445157,733
"20959","chr4",153222882,153223311,153223096,429
"20960","chr9",19408500,19409287,19408893,787
"20961","chr11",64271492,64271834,64271663,342
"20962","chr5",140564250,140564892,140564571,642
"20963","chr17",81445444,81445763,81445603,319
"20964","chr17",49512780,49513053,49512916,273
"20965","chr17",42669917,42671555,42670736,1638
"20966","chrX",13688936,13689319,13689127,383
"20967","chr5",111073006,111073341,111073173,335
"20968","chr16",690007,690578,690292,571
"20969","chr4",139295573,139295924,139295748,351
"20970","chr8",144103564,144105165,144104364,1601
"20971","chr19",42196534,42196823,42196678,289
"20972","chr16",1011196,1011481,1011338,285
"20973","chr1",227506086,227506808,227506447,722
"20974","chr12",132552722,132553006,132552864,284
"20975","chr10",119080080,119080968,119080524,888
"20976","chr1",2467386,2467616,2467501,230
"20977","chr19",49433561,49434031,49433796,470
"20978","chr19",40605062,40605861,40605461,799
"20979","chrY",10199274,10199570,10199422,296
"20980","chr9",123373128,123373914,123373521,786
"20981","chr3",51392953,51393306,51393129,353
"20982","chr19",41376602,41376868,41376735,266
"20983","chr1",1327285,1328040,1327662,755
"20984","chr19",1975220,1975571,1975395,351
"20985","chr1",220878624,220880331,220879477,1707
"20986","chr19",13842408,13843041,13842724,633
"20987","chr17",82345570,82345839,82345704,269
"20988","chr20",1266049,1266841,1266445,792
"20989","chr19",52369831,52370319,52370075,488
"20990","chr10",124997982,124998323,124998152,341
"20991","chr7",54833043,54833568,54833305,525
"20992","chr16",89584009,89584289,89584149,280
"20993","chr17",2372231,2372459,2372345,228
"20994","chr2",219542976,219544326,219543651,1350
"20995","chr17",83058168,83058419,83058293,251
"20996","chr19",49615966,49616219,49616092,253
"20997","chr17",48492612,48493143,48492877,531
"20998","chr3",11901963,11902459,11902211,496
"20999","chr19",50686567,50686837,50686702,270
"21000","chr1",45521491,45522131,45521811,640
"21001","chr2",120988241,120989275,120988758,1034
"21002","chr16",1354832,1355235,1355033,403
"21003","chr1",1028415,1029127,1028771,712
"21004","chr1",155000774,155001882,155001328,1108
"21005","chr17",74213545,74214151,74213848,606
"21006","chr11",119421979,119422181,119422080,202
"21007","chr15",26838845,26839075,26838960,230
"21008","chr19",5048414,5048804,5048609,390
"21009","chr12",132597918,132598674,132598296,756
"21010","chr6",166998109,166999934,166999021,1825
"21011","chr7",129502330,129503197,129502763,867
"21012","chr20",3159649,3159924,3159786,275
"21013","chr20",64106029,64106718,64106373,689
"21014","chr17",56510593,56511138,56510865,545
"21015","chr5",177396422,177396669,177396545,247
"21016","chr20",58309310,58310166,58309738,856
"21017","chr5",140829168,140830372,140829770,1204
"21018","chr19",12806565,12806862,12806713,297
"21019","chr19",46623525,46624221,46623873,696
"21020","chr17",1324226,1324467,1324346,241
"21021","chrX",3842622,3844169,3843395,1547
"21022","chr11",79069687,79070003,79069845,316
"21023","chr19",12117629,12117875,12117752,246
"21024","chr10",13474165,13474747,13474456,582
"21025","chr7",5360980,5361979,5361479,999
"21026","chrX",71053159,71053405,71053282,246
"21027","chr4",77075268,77076418,77075843,1150
"21028","chr19",1387528,1387847,1387687,319
"21029","chr2",190880560,190881873,190881216,1313
"21030","chr5",173887928,173888231,173888079,303
"21031","chr5",157743497,157744313,157743905,816
"21032","chr17",74919473,74920415,74919944,942
"21033","chr11",31813904,31814268,31814086,364
"21034","chr22",50461532,50461850,50461691,318
"21035","chr17",39952711,39953408,39953059,697
"21036","chr2",55282097,55282584,55282340,487
"21037","chr11",95232193,95232424,95232308,231
"21038","chr10",122879227,122880277,122879752,1050
"21039","chr8",1548565,1549718,1549141,1153
"21040","chr12",132789012,132789343,132789177,331
"21041","chr16",16232601,16232999,16232800,398
"21042","chr12",52308178,52308776,52308477,598
"21043","chr9",137717989,137718229,137718109,240
"21044","chr7",102671500,102671885,102671692,385
"21045","chr7",100271380,100272462,100271921,1082
"21046","chr11",65096226,65096508,65096367,282
"21047","chr19",42401571,42402198,42401884,627
"21048","chr8",143229538,143229815,143229676,277
"21049","chr19",1698699,1699254,1698976,555
"21050","chr13",114111024,114111626,114111325,602
"21051","chr9",29212173,29212821,29212497,648
"21052","chrX",120250514,120251203,120250858,689
"21053","chr10",43322626,43323156,43322891,530
"21054","chr11",107017597,107019477,107018537,1880
"21055","chr21",46001221,46001484,46001352,263
"21056","chr17",28719838,28720255,28720046,417
"21057","chr10",101213743,101213957,101213850,214
"21058","chr4",1228503,1228709,1228606,206
"21059","chr10",27155204,27155565,27155384,361
"21060","chr9",120793121,120793575,120793348,454
"21061","chr11",459088,459345,459216,257
"21062","chr3",49093244,49094412,49093828,1168
"21063","chr2",240434993,240436903,240435948,1910
"21064","chr19",49867122,49867736,49867429,614
"21065","chr10",58334971,58335546,58335258,575
"21066","chr20",44159576,44160528,44160052,952
"21067","chr11",14643507,14644657,14644082,1150
"21068","chr16",27268565,27268922,27268743,357
"21069","chr9",137007502,137007753,137007627,251
"21070","chr10",49679519,49679816,49679667,297
"21071","chr2",44928056,44928272,44928164,216
"21072","chr17",34626134,34626896,34626515,762
"21073","chr11",1969669,1969981,1969825,312
"21074","chr19",5032450,5033088,5032769,638
"21075","chr11",2909059,2909863,2909461,804
"21076","chr19",42244757,42245123,42244940,366
"21077","chr17",335284,335505,335394,221
"21078","chr9",137011366,137011964,137011665,598
"21079","chr22",16697629,16697915,16697772,286
"21080","chr7",571227,571440,571333,213
"21081","chr17",46579124,46580128,46579626,1004
"21082","chr20",63521713,63521917,63521815,204
"21083","chr19",49719550,49720122,49719836,572
"21084","chr5",154493279,154493668,154493473,389
"21085","chr19",40226168,40226758,40226463,590
"21086","chr17",805079,805358,805218,279
"21087","chr19",897374,897624,897499,250
"21088","chr20",2206886,2207930,2207408,1044
"21089","chr19",16324391,16327088,16325739,2697
"21090","chr8",103021110,103021336,103021223,226
"21091","chr19",12782455,12783282,12782868,827
"21092","chr15",69032999,69033277,69033138,278
"21093","chr1",16352079,16352697,16352388,618
"21094","chr9",34701221,34701837,34701529,616
"21095","chr1",119896390,119896597,119896493,207
"21096","chr19",9362913,9363325,9363119,412
"21097","chr5",56909135,56910517,56909826,1382
"21098","chr3",136818717,136820362,136819539,1645
"21099","chr1",151473395,151473666,151473530,271
"21100","chr6",26521719,26522351,26522035,632
"21101","chr1",193105044,193105434,193105239,390
"21102","chr1",211675299,211675834,211675566,535
"21103","chr11",61508353,61509857,61509105,1504
"21104","chr11",62831207,62832592,62831899,1385
"21105","chr19",49858470,49858724,49858597,254
"21106","chr18",79448691,79449035,79448863,344
"21107","chr19",40489973,40490212,40490092,239
"21108","chr11",65225809,65226013,65225911,204
"21109","chr1",24848069,24848876,24848472,807
"21110","chr17",7349979,7350445,7350212,466
"21111","chr5",134411675,134412108,134411891,433
"21112","chr6",52403183,52403401,52403292,218
"21113","chr9",126338092,126338295,126338193,203
"21114","chr19",5151321,5151719,5151520,398
"21115","chr2",28869862,28870573,28870217,711
"21116","chr9",137030791,137031544,137031167,753
"21117","chr4",4871535,4871886,4871710,351
"21118","chr9",137841076,137842295,137841685,1219
"21119","chr5",73436538,73437905,73437221,1367
"21120","chr8",80578025,80579101,80578563,1076
"21121","chr2",127713594,127713821,127713707,227
"21122","chr19",55577908,55579493,55578700,1585
"21123","chr6",156631022,156631312,156631167,290
"21124","chr17",45247322,45248362,45247842,1040
"21125","chr11",94493506,94494246,94493876,740
"21126","chr19",45792298,45793089,45792693,791
"21127","chr2",24009810,24010390,24010100,580
"21128","chr1",2334568,2334993,2334780,425
"21129","chr10",31133780,31134387,31134083,607
"21130","chr17",8162591,8163176,8162883,585
"21131","chr1",23554526,23555264,23554895,738
"21132","chr10",25016389,25017095,25016742,706
"21133","chr18",14430639,14431568,14431103,929
"21134","chr17",29292473,29293081,29292777,608
"21135","chr16",86563968,86564197,86564082,229
"21136","chr6",44275348,44276744,44276046,1396
"21137","chr19",55339127,55339893,55339510,766
"21138","chr4",13522438,13522996,13522717,558
"21139","chr17",8121440,8123544,8122492,2104
"21140","chrX",40083503,40084166,40083834,663
"21141","chr8",95024790,95025372,95025081,582
"21142","chr3",130111128,130112583,130111855,1455
"21143","chr1",205631365,205632304,205631834,939
"21144","chr20",62771955,62772241,62772098,286
"21145","chr3",33441108,33441372,33441240,264
"21146","chr20",3470644,3471210,3470927,566
"21147","chr5",177311447,177312561,177312004,1114
"21148","chr18",80147414,80147683,80147548,269
"21149","chr18",9136090,9137596,9136843,1506
"21150","chr8",26190288,26190581,26190434,293
"21151","chr19",1444919,1447215,1446067,2296
"21152","chr16",1200277,1200687,1200482,410
"21153","chr17",36166412,36166696,36166554,284
"21154","chr19",932598,932845,932721,247
"21155","chr17",82250320,82250563,82250441,243
"21156","chr20",62836233,62836772,62836502,539
"21157","chr15",74959126,74959617,74959371,491
"21158","chr7",50159175,50159390,50159282,215
"21159","chr20",841031,841857,841444,826
"21160","chr1",151131209,151133624,151132416,2415
"21161","chr2",131034664,131035616,131035140,952
"21162","chr7",149147162,149148464,149147813,1302
"21163","chr2",9002998,9004501,9003749,1503
"21164","chr12",120468875,120470091,120469483,1216
"21165","chr11",66700901,66701104,66701002,203
"21166","chr17",75087771,75088400,75088085,629
"21167","chr10",45594423,45595014,45594718,591
"21168","chr13",99477033,99477327,99477180,294
"21169","chr9",91159914,91160397,91160155,483
"21170","chr3",9552384,9552644,9552514,260
"21171","chr6",168128926,168129627,168129276,701
"21172","chr15",57706506,57707187,57706846,681
"21173","chr19",45681541,45681878,45681709,337
"21174","chr1",88891280,88891708,88891494,428
"21175","chr22",24156014,24156728,24156371,714
"21176","chr20",17227905,17228111,17228008,206
"21177","chr11",65204714,65204933,65204823,219
"21178","chr19",632697,633678,633187,981
"21179","chr5",141419190,141419792,141419491,602
"21180","chr3",39809269,39810329,39809799,1060
"21181","chr9",127608389,127608699,127608544,310
"21182","chr19",17486535,17487191,17486863,656
"21183","chr19",36775692,36776125,36775908,433
"21184","chr6",36660809,36661220,36661014,411
"21185","chr10",116669919,116670342,116670130,423
"21186","chr8",33566421,33567377,33566899,956
"21187","chr20",62980932,62981149,62981040,217
"21188","chrX",154374352,154374901,154374626,549
"21189","chr11",65455019,65455279,65455149,260
"21190","chr12",131908090,131910001,131909045,1911
"21191","chr19",37506888,37507223,37507055,335
"21192","chr7",150955719,150955992,150955855,273
"21193","chr17",16491519,16492529,16492024,1010
"21194","chrX",52995420,52995787,52995603,367
"21195","chr19",5142131,5142381,5142256,250
"21196","chr2",161507673,161507889,161507781,216
"21197","chr19",1766145,1766365,1766255,220
"21198","chr2",239190538,239190739,239190638,201
"21199","chr18",79441938,79442732,79442335,794
"21200","chr15",89575538,89576132,89575835,594
"21201","chrX",69615804,69617219,69616511,1415
"21202","chr19",15760254,15760508,15760381,254
"21203","chr3",42600352,42601113,42600732,761
"21204","chr19",4542926,4544566,4543746,1640
"21205","chr12",132472826,132475636,132474231,2810
"21206","chr4",190037889,190038856,190038372,967
"21207","chr2",25161070,25161894,25161482,824
"21208","chr19",3178743,3179988,3179365,1245
"21209","chr12",48350535,48351316,48350925,781
"21210","chr7",148783037,148783412,148783224,375
"21211","chr13",20394712,20395081,20394896,369
"21212","chr16",88842025,88842290,88842157,265
"21213","chr11",6481193,6481697,6481445,504
"21214","chr19",47725815,47726250,47726032,435
"21215","chr3",62873942,62875515,62874728,1573
"21216","chr11",304079,304379,304229,300
"21217","chr10",3331927,3332191,3332059,264
"21218","chr4",189846049,189847177,189846613,1128
"21219","chr19",3358497,3361250,3359873,2753
"21220","chr7",5307924,5308325,5308124,401
"21221","chr17",48747423,48748010,48747716,587
"21222","chr10",119818017,119818873,119818445,856
"21223","chr5",141382834,141383201,141383017,367
"21224","chr22",19431718,19432714,19432216,996
"21225","chr11",27506316,27506970,27506643,654
"21226","chr15",52794432,52794661,52794546,229
"21227","chr10",133160026,133160807,133160416,781
"21228","chr5",157575166,157576174,157575670,1008
"21229","chr16",670682,671166,670924,484
"21230","chr22",49856512,49856865,49856688,353
"21231","chr4",83484543,83485368,83484955,825
"21232","chr12",120200785,120201313,120201049,528
"21233","chr8",978310,978527,978418,217
"21234","chr21",41878501,41879792,41879146,1291
"21235","chr19",53333542,53334242,53333892,700
"21236","chr19",45001254,45002041,45001647,787
"21237","chr16",70250989,70252053,70251521,1064
"21238","chr9",34623515,34624084,34623799,569
"21239","chr5",79990761,79991311,79991036,550
"21240","chr8",33472646,33473360,33473003,714
"21241","chr19",52048578,52048961,52048769,383
"21242","chr8",900103,900405,900254,302
"21243","chr18",6413960,6415120,6414540,1160
"21244","chr10",51073779,51074992,51074385,1213
"21245","chr7",1288889,1289393,1289141,504
"21246","chr17",47733223,47734022,47733622,799
"21247","chr20",63537079,63537331,63537205,252
"21248","chr18",14474588,14475009,14474798,421
"21249","chr7",530175,530405,530290,230
"21250","chr9",132406665,132406928,132406796,263
"21251","chr1",37595827,37596139,37595983,312
"21252","chr18",79454959,79455492,79455225,533
"21253","chr1",227560722,227561159,227560940,437
"21254","chr2",287353,290099,288726,2746
"21255","chr22",42074031,42074665,42074348,634
"21256","chr1",197774801,197775658,197775229,857
"21257","chr20",3795971,3796727,3796349,756
"21258","chr10",44974574,44974843,44974708,269
"21259","chr4",170025615,170026774,170026194,1159
"21260","chr20",64098403,64098806,64098604,403
"21261","chr9",17578723,17579806,17579264,1083
"21262","chr1",7953933,7954591,7954262,658
"21263","chr15",43370407,43371468,43370937,1061
"21264","chr3",185253853,185254214,185254033,361
"21265","chr15",101723987,101724547,101724267,560
"21266","chr2",118841882,118843390,118842636,1508
"21267","chr11",67990683,67991974,67991328,1291
"21268","chr16",11851208,11851660,11851434,452
"21269","chr5",41509681,41510064,41509872,383
"21270","chr15",30572426,30573383,30572904,957
"21271","chr17",75784765,75785227,75784996,462
"21272","chr5",52988885,52989659,52989272,774
"21273","chr17",82100789,82101008,82100898,219
"21274","chr17",48037207,48037771,48037489,564
"21275","chr13",20525429,20526304,20525866,875
"21276","chr10",74151078,74151722,74151400,644
"21277","chr6",110814312,110815710,110815011,1398
"21278","chrX",149471020,149471224,149471122,204
"21279","chr2",241053073,241053296,241053184,223
"21280","chr18",79458227,79458866,79458546,639
"21281","chr11",18705773,18706180,18705976,407
"21282","chr11",2414065,2415421,2414743,1356
"21283","chr19",46755552,46756967,46756259,1415
"21284","chr12",21501709,21502022,21501865,313
"21285","chr17",82237167,82237990,82237578,823
"21286","chr6",160005232,160006470,160005851,1238
"21287","chr4",3511721,3512120,3511920,399
"21288","chr7",4754486,4754894,4754690,408
"21289","chr19",14265876,14266149,14266012,273
"21290","chr4",913865,914179,914022,314
"21291","chr7",98953177,98953470,98953323,293
"21292","chr18",811648,812708,812178,1060
"21293","chr2",241541029,241542403,241541716,1374
"21294","chr16",2062867,2063170,2063018,303
"21295","chr7",157500761,157501372,157501066,611
"21296","chr3",50235836,50236469,50236152,633
"21297","chr18",78792775,78793014,78792894,239
"21298","chr22",19725081,19725300,19725190,219
"21299","chr18",75204152,75205278,75204715,1126
"21300","chr5",145835086,145835576,145835331,490
"21301","chr17",42687470,42687995,42687732,525
"21302","chr20",60967452,60967683,60967567,231
"21303","chr3",142724003,142725136,142724569,1133
"21304","chr17",48830939,48831482,48831210,543
"21305","chr19",1074727,1075072,1074899,345
"21306","chr15",94844772,94845407,94845089,635
"21307","chr19",38452741,38453095,38452918,354
"21308","chr6",82247282,82247790,82247536,508
"21309","chr16",89815984,89817050,89816517,1066
"21310","chr15",22757639,22758053,22757846,414
"21311","chrX",49321951,49322562,49322256,611
"21312","chr20",18567246,18567654,18567450,408
"21313","chr10",76162,76680,76421,518
"21314","chrX",54639348,54639841,54639594,493
"21315","chr9",129874507,129874942,129874724,435
"21316","chr19",19653822,19654064,19653943,242
"21317","chr19",40690374,40691202,40690788,828
"21318","chr6",24774818,24775501,24775159,683
"21319","chr19",53037482,53037980,53037731,498
"21320","chr17",45371688,45371920,45371804,232
"21321","chr4",99949220,99950837,99950028,1617
"21322","chr5",1193608,1193868,1193738,260
"21323","chr19",57814487,57814962,57814724,475
"21324","chr5",88884049,88884441,88884245,392
"21325","chr19",4483034,4483649,4483341,615
"21326","chr18",79747538,79747817,79747677,279
"21327","chr16",35543503,35543773,35543638,270
"21328","chr3",184327228,184327448,184327338,220
"21329","chr17",42780311,42781281,42780796,970
"21330","chr19",4916548,4916772,4916660,224
"21331","chr11",3203294,3203847,3203570,553
"21332","chr1",181318164,181318737,181318450,573
"21333","chr7",149719571,149719883,149719727,312
"21334","chrX",135295704,135295928,135295816,224
"21335","chr12",119804117,119804429,119804273,312
"21336","chr17",44186577,44187436,44187006,859
"21337","chr3",124584682,124585245,124584963,563
"21338","chr15",43791946,43793074,43792510,1128
"21339","chr9",68779877,68780576,68780226,699
"21340","chr2",126976827,126977101,126976964,274
"21341","chr10",100741943,100742475,100742209,532
"21342","chr2",219442093,219442374,219442233,281
"21343","chr2",161416783,161417214,161416998,431
"21344","chr21",14027616,14027873,14027744,257
"21345","chr10",22325346,22326005,22325675,659
"21346","chr19",12642423,12642769,12642596,346
"21347","chr1",3185976,3186788,3186382,812
"21348","chr19",42396864,42397223,42397043,359
"21349","chr11",65976424,65976795,65976609,371
"21350","chr17",27605471,27605686,27605578,215
"21351","chr7",97938582,97938817,97938699,235
"21352","chr12",8914350,8914884,8914617,534
"21353","chr22",28679112,28680231,28679671,1119
"21354","chr12",57203185,57203526,57203355,341
"21355","chr6",168101222,168102110,168101666,888
"21356","chr19",795360,795561,795460,201
"21357","chr19",28727094,28727826,28727460,732
"21358","chr2",96864821,96865064,96864942,243
"21359","chr18",79146114,79146380,79146247,266
"21360","chr16",1027527,1027772,1027649,245
"21361","chr6",3068296,3069120,3068708,824
"21362","chr1",17825883,17826347,17826115,464
"21363","chr3",125990223,125990609,125990416,386
"21364","chrX",135521177,135521825,135521501,648
"21365","chr9",107465686,107466375,107466030,689
"21366","chr11",94401060,94401682,94401371,622
"21367","chr12",131070205,131070624,131070414,419
"21368","chr13",42040042,42041514,42040778,1472
"21369","chr20",63809061,63809296,63809178,235
"21370","chr19",57171850,57172482,57172166,632
"21371","chr13",113060470,113060846,113060658,376
"21372","chr22",49321580,49321996,49321788,416
"21373","chr19",643092,643720,643406,628
"21374","chr19",50658666,50659257,50658961,591
"21375","chr19",35309815,35310128,35309971,313
"21376","chr19",12867545,12867971,12867758,426
"21377","chr19",2213861,2214143,2214002,282
"21378","chr19",4555924,4556131,4556027,207
"21379","chr7",103989078,103990267,103989672,1189
"21380","chr6",71588571,71588825,71588698,254
"21381","chr2",87075399,87077448,87076423,2049
"21382","chr7",1006307,1006805,1006556,498
"21383","chr20",63406105,63406366,63406235,261
"21384","chr18",45063740,45063972,45063856,232
"21385","chr1",28552890,28553192,28553041,302
"21386","chr20",36064532,36065578,36065055,1046
"21387","chr19",55166152,55166399,55166275,247
"21388","chrX",129522874,129523429,129523151,555
"21389","chr17",41930498,41930845,41930671,347
"21390","chr10",68331298,68332816,68332057,1518
"21391","chr17",39573458,39574062,39573760,604
"21392","chr19",18386253,18386459,18386356,206
"21393","chr2",112432538,112433697,112433117,1159
"21394","chr4",70838947,70840019,70839483,1072
"21395","chr3",197658130,197658376,197658253,246
"21396","chr19",496158,496481,496319,323
"21397","chr8",141391433,141392394,141391913,961
"21398","chr5",173283762,173284059,173283910,297
"21399","chr19",48493039,48494091,48493565,1052
"21400","chr1",28811989,28812836,28812412,847
"21401","chr17",63998292,63999101,63998696,809
"21402","chr1",9627067,9627309,9627188,242
"21403","chr10",132906430,132906794,132906612,364
"21404","chr19",39532312,39533027,39532669,715
"21405","chr8",1763068,1763285,1763176,217
"21406","chr19",1523706,1524566,1524136,860
"21407","chr4",1792715,1795454,1794084,2739
"21408","chr17",61416631,61417025,61416828,394
"21409","chr5",129094310,129095369,129094839,1059
"21410","chr21",44506648,44506871,44506759,223
"21411","chrX",153970620,153973029,153971824,2409
"21412","chr10",99521424,99522359,99521891,935
"21413","chr13",20703094,20704277,20703685,1183
"21414","chr11",64284580,64284875,64284727,295
"21415","chr19",1434614,1434937,1434775,323
"21416","chr11",74988770,74989141,74988955,371
"21417","chr11",68312337,68313463,68312900,1126
"21418","chr8",60651645,60652662,60652153,1017
"21419","chr19",37466824,37467488,37467156,664
"21420","chr15",23179880,23180381,23180130,501
"21421","chr4",2339468,2339842,2339655,374
"21422","chr11",119121176,119122041,119121608,865
"21423","chr10",14878321,14879689,14879005,1368
"21424","chr19",885746,886200,885973,454
"21425","chr20",3744896,3745250,3745073,354
"21426","chr8",60714121,60714515,60714318,394
"21427","chr19",10712942,10713202,10713072,260
"21428","chr10",38729963,38730957,38730460,994
"21429","chr16",3193303,3193583,3193443,280
"21430","chr11",62761431,62761956,62761693,525
"21431","chr19",38596238,38596664,38596451,426
"21432","chr2",19868667,19869146,19868906,479
"21433","chr1",27201393,27201594,27201493,201
"21434","chrX",47523422,47524185,47523803,763
"21435","chr21",44455580,44457443,44456511,1863
"21436","chr19",13955846,13956224,13956035,378
"21437","chr18",46756220,46757147,46756683,927
"21438","chr12",113475810,113476852,113476331,1042
"21439","chr9",129834940,129836042,129835491,1102
"21440","chrY",9376266,9376529,9376397,263
"21441","chr2",96325119,96325545,96325332,426
"21442","chr10",26438132,26439063,26438597,931
"21443","chr22",30635775,30636072,30635923,297
"21444","chr2",27082444,27082744,27082594,300
"21445","chr12",49091137,49091395,49091266,258
"21446","chr17",7012505,7012882,7012693,377
"21447","chr6",36442656,36443362,36443009,706
"21448","chr2",232633116,232634677,232633896,1561
"21449","chr19",1911924,1913407,1912665,1483
"21450","chr5",64165621,64166279,64165950,658
"21451","chr11",720561,721369,720965,808
"21452","chr18",35497581,35498099,35497840,518
"21453","chr11",65557931,65558738,65558334,807
"21454","chr16",1768551,1768915,1768733,364
"21455","chr19",36331493,36331788,36331640,295
"21456","chr18",46946903,46947174,46947038,271
"21457","chr20",3209365,3209916,3209640,551
"21458","chr4",17810331,17811604,17810967,1273
"21459","chr7",57868076,57869442,57868759,1366
"21460","chr20",38835859,38836204,38836031,345
"21461","chr19",13864854,13866104,13865479,1250
"21462","chr10",64170856,64171129,64170992,273
"21463","chr19",18123900,18124102,18124001,202
"21464","chr13",114001234,114001747,114001490,513
"21465","chr14",104802148,104802426,104802287,278
"21466","chr18",7011268,7011489,7011378,221
"21467","chr11",67372416,67373675,67373045,1259
"21468","chr1",111270789,111271231,111271010,442
"21469","chr16",30948444,30949544,30948994,1100
"21470","chr19",55703863,55704210,55704036,347
"21471","chr7",44200819,44201130,44200974,311
"21472","chr7",20790948,20791238,20791093,290
"21473","chr15",28589073,28589686,28589379,613
"21474","chr2",236214372,236214929,236214650,557
"21475","chr16",89077436,89078103,89077769,667
"21476","chr19",16659825,16661821,16660823,1996
"21477","chr10",103602027,103602431,103602229,404
"21478","chr11",66638271,66639220,66638745,949
"21479","chr2",11465617,11466259,11465938,642
"21480","chr19",32719547,32720064,32719805,517
"21481","chr13",112696164,112697197,112696680,1033
"21482","chr19",7098869,7099663,7099266,794
"21483","chr19",8149059,8149815,8149437,756
"21484","chr19",48629346,48631034,48630190,1688
"21485","chr4",1826861,1827075,1826968,214
"21486","chr19",5133921,5134157,5134039,236
"21487","chr17",63538031,63538674,63538352,643
"21488","chr19",3224397,3225009,3224703,612
"21489","chr19",7623734,7623946,7623840,212
"21490","chr3",47513315,47513914,47513614,599
"21491","chr15",78507204,78507985,78507594,781
"21492","chr9",5450409,5450629,5450519,220
"21493","chr7",4725053,4725621,4725337,568
"21494","chr18",6729603,6730038,6729820,435
"21495","chr19",939595,939816,939705,221
"21496","chr17",835628,836137,835882,509
"21497","chr19",15722923,15723173,15723048,250
"21498","chr4",5892344,5893389,5892866,1045
"21499","chr14",104752609,104753753,104753181,1144
"21500","chr9",34589123,34591980,34590551,2857
"21501","chr22",49183866,49184124,49183995,258
"21502","chr19",8596196,8596403,8596299,207
"21503","chr19",8413028,8413612,8413320,584
"21504","chr12",12696133,12696336,12696234,203
"21505","chr19",18919115,18919844,18919479,729
"21506","chr1",118984159,118984569,118984364,410
"21507","chr5",140856152,140856448,140856300,296
"21508","chrX",153642141,153644615,153643378,2474
"21509","chr1",77978619,77978921,77978770,302
"21510","chrX",125205055,125206091,125205573,1036
"21511","chr12",49026248,49026509,49026378,261
"21512","chr19",41522008,41522341,41522174,333
"21513","chr15",76336657,76336866,76336761,209
"21514","chr12",4649011,4649265,4649138,254
"21515","chr18",77899962,77900186,77900074,224
"21516","chr18",26226319,26227129,26226724,810
"21517","chr8",2098861,2099133,2098997,272
"21518","chr1",43946401,43947132,43946766,731
"21519","chr2",28751346,28752522,28751934,1176
"21520","chr3",53347318,53347909,53347613,591
"21521","chr17",82080995,82081374,82081184,379
"21522","chr10",23191768,23193526,23192647,1758
"21523","chr11",541896,542227,542061,331
"21524","chr6",101401930,101402184,101402057,254
"21525","chr19",34832627,34833048,34832837,421
"21526","chr3",73383588,73384922,73384255,1334
"21527","chr20",43657321,43657895,43657608,574
"21528","chr6",170110558,170110889,170110723,331
"21529","chr19",1026312,1026909,1026610,597
"21530","chr9",114098040,114099311,114098675,1271
"21531","chr18",10471659,10471870,10471764,211
"21532","chr11",66048933,66049194,66049063,261
"21533","chr20",57329612,57329920,57329766,308
"21534","chr19",51103950,51104583,51104266,633
"21535","chrX",119999890,120000412,120000151,522
"21536","chr9",1045541,1046394,1045967,853
"21537","chr19",29811388,29812774,29812081,1386
"21538","chr6",168365134,168365361,168365247,227
"21539","chr18",79802287,79802501,79802394,214
"21540","chr6",26021729,26021965,26021847,236
"21541","chr8",144409006,144409838,144409422,832
"21542","chr3",49929688,49930039,49929863,351
"21543","chr19",5147843,5148165,5148004,322
"21544","chr9",137294851,137296614,137295732,1763
"21545","chr6",10881613,10881818,10881715,205
"21546","chr19",55352762,55353011,55352886,249
"21547","chr17",18671823,18672040,18671931,217
"21548","chr4",3524901,3525139,3525020,238
"21549","chr19",811904,815288,813596,3384
"21550","chr10",48450181,48451158,48450669,977
"21551","chr15",40160804,40161495,40161149,691
"21552","chr11",47594158,47594503,47594330,345
"21553","chr1",246251446,246252267,246251856,821
"21554","chr9",137876848,137879061,137877954,2213
"21555","chr19",53898450,53899218,53898834,768
"21556","chr19",15453058,15453412,15453235,354
"21557","chr19",2607727,2607969,2607848,242
"21558","chr12",132602022,132602271,132602146,249
"21559","chr7",63761901,63762310,63762105,409
"21560","chr13",46386549,46387535,46387042,986
"21561","chr8",143812748,143812999,143812873,251
"21562","chr9",96026212,96026461,96026336,249
"21563","chr13",87671314,87672716,87672015,1402
"21564","chr19",51601165,51601745,51601455,580
"21565","chr11",46700429,46700878,46700653,449
"21566","chr15",41881886,41882657,41882271,771
"21567","chr4",6673964,6674680,6674322,716
"21568","chr7",12111594,12111933,12111763,339
"21569","chr4",93834823,93835159,93834991,336
"21570","chr15",25596711,25597001,25596856,290
"21571","chr16",30609679,30610505,30610092,826
"21572","chr14",101526385,101526595,101526490,210
"21573","chr19",1376555,1377569,1377062,1014
"21574","chr12",8221356,8221593,8221474,237
"21575","chr11",119356386,119357048,119356717,662
"21576","chr19",50328197,50328813,50328505,616
"21577","chr1",148952011,148953149,148952580,1138
"21578","chrX",154506658,154506874,154506766,216
"21579","chr21",26846248,26846482,26846365,234
"21580","chr1",18646534,18647239,18646886,705
"21581","chr17",50602975,50603194,50603084,219
"21582","chr4",110196306,110197234,110196770,928
"21583","chr19",7394893,7395490,7395191,597
"21584","chr1",38817937,38818904,38818420,967
"21585","chr19",18667675,18669231,18668453,1556
"21586","chr10",117004717,117005635,117005176,918
"21587","chr1",75131038,75131262,75131150,224
"21588","chr13",113067206,113067893,113067549,687
"21589","chr19",6459224,6460640,6459932,1416
"21590","chr6",165940449,165940745,165940597,296
"21591","chr19",5587674,5587928,5587801,254
"21592","chr14",96741440,96741948,96741694,508
"21593","chr2",85418220,85418756,85418488,536
"21594","chr7",4784734,4785049,4784891,315
"21595","chr12",109712242,109712457,109712349,215
"21596","chr18",22933156,22933894,22933525,738
"21597","chr19",44845690,44846787,44846238,1097
"21598","chr15",90871081,90871290,90871185,209
"21599","chr7",150219997,150221175,150220586,1178
"21600","chr11",31826940,31827282,31827111,342
"21601","chr17",49902009,49902376,49902192,367
"21602","chr7",54544631,54544865,54544748,234
"21603","chr17",1905278,1905479,1905378,201
"21604","chr12",70365657,70367272,70366464,1615
"21605","chr18",75207959,75212227,75210093,4268
"21606","chr21",36130147,36130528,36130337,381
"21607","chr7",158828314,158830056,158829185,1742
"21608","chrX",137052351,137053110,137052730,759
"21609","chr3",155854569,155854815,155854692,246
"21610","chr10",133041465,133041886,133041675,421
"21611","chr9",95349082,95350080,95349581,998
"21612","chr13",27953618,27954859,27954238,1241
"21613","chr11",65780028,65781790,65780909,1762
"21614","chr19",34734015,34734411,34734213,396
"21615","chr19",55490773,55491088,55490930,315
"21616","chr18",79529018,79529464,79529241,446
"21617","chr19",32405069,32406327,32405698,1258
"21618","chr10",5512379,5512644,5512511,265
"21619","chr18",23586194,23587102,23586648,908
"21620","chr19",1525207,1525855,1525531,648
"21621","chr20",37403134,37403407,37403270,273
"21622","chr12",24948673,24949139,24948906,466
"21623","chr7",73831104,73831715,73831409,611
"21624","chr5",181273393,181273686,181273539,293
"21625","chr13",57140837,57141170,57141003,333
"21626","chr4",186144604,186145306,186144955,702
"21627","chr9",5303860,5304476,5304168,616
"21628","chr18",79486356,79487889,79487122,1533
"21629","chr9",41663527,41663762,41663644,235
"21630","chr16",89834086,89835264,89834675,1178
"21631","chr19",46493070,46495180,46494125,2110
"21632","chr11",660454,660681,660567,227
"21633","chr16",231089,231317,231203,228
"21634","chr19",52897207,52897952,52897579,745
"21635","chr14",66013615,66013924,66013769,309
"21636","chr11",20159654,20160779,20160216,1125
"21637","chr14",104701326,104701792,104701559,466
"21638","chr11",17353381,17353875,17353628,494
"21639","chr1",222711984,222712888,222712436,904
"21640","chr3",129161384,129161604,129161494,220
"21641","chr16",3443098,3443569,3443333,471
"21642","chrX",45850839,45851872,45851355,1033
"21643","chr9",35111426,35111738,35111582,312
"21644","chr19",49432494,49433018,49432756,524
"21645","chr17",81209573,81210167,81209870,594
"21646","chr11",119584442,119585391,119584916,949
"21647","chr15",72272101,72272824,72272462,723
"21648","chr22",19566491,19566890,19566690,399
"21649","chr10",133142004,133142296,133142150,292
"21650","chr9",95752117,95752447,95752282,330
"21651","chr9",129202758,129203357,129203057,599
"21652","chr22",46685853,46686148,46686000,295
"21653","chr17",47696085,47696329,47696207,244
"21654","chr19",675671,675881,675776,210
"21655","chr19",19385143,19385904,19385523,761
"21656","chr8",144533101,144533308,144533204,207
"21657","chr22",19755279,19757206,19756242,1927
"21658","chr1",148280753,148281059,148280906,306
"21659","chr14",32938910,32940029,32939469,1119
"21660","chr15",50686146,50687002,50686574,856
"21661","chr20",64029608,64029999,64029803,391
"21662","chr11",107928418,107929254,107928836,836
"21663","chr18",79467273,79467727,79467500,454
"21664","chr17",73435482,73435739,73435610,257
"21665","chr16",3029535,3029953,3029744,418
"21666","chr11",68347849,68348258,68348053,409
"21667","chr5",180313710,180314121,180313915,411
"21668","chr18",9333898,9335361,9334629,1463
"21669","chr19",58475486,58476682,58476084,1196
"21670","chr18",3498943,3499360,3499151,417
"21671","chr9",134163595,134165605,134164600,2010
"21672","chr1",40508384,40509114,40508749,730
"21673","chr19",53432301,53432570,53432435,269
"21674","chr13",49996239,49997507,49996873,1268
"21675","chr22",47162629,47162870,47162749,241
"21676","chrX",153926015,153926373,153926194,358
"21677","chr19",53057962,53058559,53058260,597
"21678","chr11",47552359,47552981,47552670,622
"21679","chr1",2331745,2332031,2331888,286
"21680","chr2",239179807,239180068,239179937,261
"21681","chr19",18000757,18001672,18001214,915
"21682","chr1",154220367,154221312,154220839,945
"21683","chr14",101928435,101928786,101928610,351
"21684","chr14",24195234,24196301,24195767,1067
"21685","chr19",50147916,50148278,50148097,362
"21686","chr20",33674138,33674604,33674371,466
"21687","chr1",162023232,162024341,162023786,1109
"21688","chr8",74315106,74315699,74315402,593
"21689","chr20",59042375,59043167,59042771,792
"21690","chr10",363261,363583,363422,322
"21691","chr6",18263908,18264959,18264433,1051
"21692","chr16",18561707,18562105,18561906,398
"21693","chr15",34514289,34515181,34514735,892
"21694","chr1",10693716,10695464,10694590,1748
"21695","chrX",64395077,64395543,64395310,466
"21696","chrX",40267107,40267491,40267299,384
"21697","chr3",44241747,44242346,44242046,599
"21698","chr15",40279877,40280557,40280217,680
"21699","chr10",38450477,38450776,38450626,299
"21700","chr13",102772948,102774537,102773742,1589
"21701","chr12",132406581,132407768,132407174,1187
"21702","chr1",23743205,23744125,23743665,920
"21703","chr19",4688696,4688988,4688842,292
"21704","chrX",153828654,153829165,153828909,511
"21705","chr8",144277951,144278265,144278108,314
"21706","chr1",225939412,225939995,225939703,583
"21707","chr9",74496862,74497306,74497084,444
"21708","chr20",46312518,46312931,46312724,413
"21709","chr13",99959608,99960024,99959816,416
"21710","chr7",54542041,54542447,54542244,406
"21711","chr17",80822278,80822592,80822435,314
"21712","chr8",11563827,11564925,11564376,1098
"21713","chr19",22010528,22010781,22010654,253
"21714","chr19",47803195,47803448,47803321,253
"21715","chr3",114103289,114103567,114103428,278
"21716","chr21",42653759,42654540,42654149,781
"21717","chr1",181798357,181798757,181798557,400
"21718","chrX",106726456,106727368,106726912,912
"21719","chr12",49549003,49549652,49549327,649
"21720","chr19",12737464,12737772,12737618,308
"21721","chr10",125773661,125774418,125774039,757
"21722","chr10",92045755,92046088,92045921,333
"21723","chr7",99997583,99997882,99997732,299
"21724","chr9",130862767,130863021,130862894,254
"21725","chr14",23575677,23577718,23576697,2041
"21726","chr1",149792572,149793433,149793002,861
"21727","chr19",19211866,19212107,19211986,241
"21728","chr14",104720361,104721409,104720885,1048
"21729","chr1",17011334,17012087,17011710,753
"21730","chr10",133309734,133309944,133309839,210
"21731","chr16",1929487,1930291,1929889,804
"21732","chr19",1295233,1296070,1295651,837
"21733","chr17",82244923,82245413,82245168,490
"21734","chr11",66288738,66289853,66289295,1115
"21735","chr11",69011172,69011383,69011277,211
"21736","chr3",195886717,195887095,195886906,378
"21737","chrX",147911573,147912682,147912127,1109
"21738","chr19",34577501,34577992,34577746,491
"21739","chr11",92915517,92915937,92915727,420
"21740","chr22",45284763,45285135,45284949,372
"21741","chr9",137449151,137449503,137449327,352
"21742","chr14",37587814,37588593,37588203,779
"21743","chr11",1462484,1462724,1462604,240
"21744","chr18",80159763,80160706,80160234,943
"21745","chr1",3732730,3733110,3732920,380
"21746","chr10",1206201,1206565,1206383,364
"21747","chr3",139539310,139539889,139539599,579
"21748","chr18",35041251,35041725,35041488,474
"21749","chr16",32187898,32188355,32188126,457
"21750","chr19",17932671,17933334,17933002,663
"21751","chr15",57326238,57326508,57326373,270
"21752","chr19",1875633,1877922,1876777,2289
"21753","chr11",66616100,66617576,66616838,1476
"21754","chr1",220881212,220881546,220881379,334
"21755","chr17",48610165,48611368,48610766,1203
"21756","chr4",52722022,52722568,52722295,546
"21757","chr9",92718563,92719304,92718933,741
"21758","chr1",37556851,37557118,37556984,267
"21759","chr14",24114059,24115034,24114546,975
"21760","chr18",11689062,11690109,11689585,1047
"21761","chr20",17315480,17315886,17315683,406
"21762","chr1",156676500,156677468,156676984,968
"21763","chr3",184602217,184602430,184602323,213
"21764","chr17",44656118,44657258,44656688,1140
"21765","chr19",15836420,15837116,15836768,696
"21766","chr11",133939661,133940767,133940214,1106
"21767","chr1",13583642,13584373,13584007,731
"21768","chr6",110178822,110179763,110179292,941
"21769","chr1",1739317,1739662,1739489,345
"21770","chr4",116925931,116926366,116926148,435
"21771","chr1",54800604,54801385,54800994,781
"21772","chr16",67480495,67481442,67480968,947
"21773","chr14",70359538,70359863,70359700,325
"21774","chr10",19815522,19817176,19816349,1654
"21775","chr17",7834831,7836617,7835724,1786
"21776","chr4",173522214,173522797,173522505,583
"21777","chr17",17221384,17221617,17221500,233
"21778","chr11",60950956,60951521,60951238,565
"21779","chr19",56638055,56638263,56638159,208
"21780","chr1",153922361,153922810,153922585,449
"21781","chr10",975701,976569,976135,868
"21782","chr4",80202458,80203164,80202811,706
"21783","chr2",190180253,190181103,190180678,850
"21784","chr18",57630128,57630428,57630278,300
"21785","chr19",27793620,27794221,27793920,601
"21786","chr7",726448,727552,727000,1104
"21787","chr7",152128840,152129590,152129215,750
"21788","chr7",32727923,32729236,32728579,1313
"21789","chr19",1039765,1040255,1040010,490
"21790","chr17",2303223,2304085,2303654,862
"21791","chr14",23567190,23567867,23567528,677
"21792","chr9",104926488,104926765,104926626,277
"21793","chr17",8109156,8109528,8109342,372
"21794","chr10",130785456,130785900,130785678,444
"21795","chr16",16331101,16331738,16331419,637
"21796","chr19",8490114,8490367,8490240,253
"21797","chr18",77690364,77690623,77690493,259
"21798","chr11",114961035,114961334,114961184,299
"21799","chr1",58814568,58814818,58814693,250
"21800","chr1",156081448,156081933,156081690,485
"21801","chr14",105093155,105093873,105093514,718
"21802","chr4",1519976,1521554,1520765,1578
"21803","chr14",50231082,50232070,50231576,988
"21804","chr19",3696993,3697353,3697173,360
"21805","chr17",82415400,82415614,82415507,214
"21806","chr1",247171518,247172080,247171799,562
"21807","chr10",79386202,79386441,79386321,239
"21808","chr4",536508,536811,536659,303
"21809","chr17",48750073,48750279,48750176,206
"21810","chr12",56725193,56725590,56725391,397
"21811","chr6",7268940,7269153,7269046,213
"21812","chr15",21383727,21384058,21383892,331
"21813","chr1",6579367,6580301,6579834,934
"21814","chr19",58558566,58559733,58559149,1167
"21815","chr12",38906667,38906878,38906772,211
"21816","chr18",79988045,79988905,79988475,860
"21817","chr21",43786698,43787170,43786934,472
"21818","chr19",58349975,58351040,58350507,1065
"21819","chr22",38454760,38455691,38455225,931
"21820","chr1",218345715,218346332,218346023,617
"21821","chr15",55498103,55498556,55498329,453
"21822","chr9",1042417,1042973,1042695,556
"21823","chr1",40315332,40315773,40315552,441
"21824","chr1",150578852,150579877,150579364,1025
"21825","chr19",7861704,7863866,7862785,2162
"21826","chr17",58514249,58514765,58514507,516
"21827","chr11",64642405,64643512,64642958,1107
"21828","chr20",13299064,13299300,13299182,236
"21829","chr1",146228089,146229263,146228676,1174
"21830","chr19",43951159,43951580,43951369,421
"21831","chr14",99245502,99247094,99246298,1592
"21832","chr14",106480167,106480515,106480341,348
"21833","chr19",11454569,11454896,11454732,327
"21834","chr10",58106621,58107037,58106829,416
"21835","chr17",8186560,8186789,8186674,229
"21836","chr1",211258763,211260792,211259777,2029
"21837","chr2",197164344,197164714,197164529,370
"21838","chr10",50067656,50068527,50068091,871
"21839","chr19",50323523,50323771,50323647,248
"21840","chr11",46119828,46120509,46120168,681
"21841","chr2",84970322,84972198,84971260,1876
"21842","chr15",64460427,64461078,64460752,651
"21843","chr11",64246300,64247869,64247084,1569
"21844","chr16",4648218,4648948,4648583,730
"21845","chr3",9915138,9915980,9915559,842
"21846","chr7",30478371,30478994,30478682,623
"21847","chrX",11427407,11428062,11427734,655
"21848","chr14",39175140,39175818,39175479,678
"21849","chr1",201955208,201955925,201955566,717
"21850","chr17",58197031,58197237,58197134,206
"21851","chr16",3188805,3189492,3189148,687
"21852","chr4",185395989,185397101,185396545,1112
"21853","chr1",1157831,1158096,1157963,265
"21854","chr22",17785202,17785484,17785343,282
"21855","chr11",124843109,124843499,124843304,390
"21856","chr3",170222369,170222990,170222679,621
"21857","chr19",15231815,15232370,15232092,555
"21858","chrX",153954180,153955189,153954684,1009
"21859","chr16",73047691,73048666,73048178,975
"21860","chr17",82403738,82404275,82404006,537
"21861","chr1",1226579,1226901,1226740,322
"21862","chr1",16707273,16708233,16707753,960
"21863","chr9",17906421,17907490,17906955,1069
"21864","chr1",156076552,156077593,156077072,1041
"21865","chr12",6752655,6753239,6752947,584
"21866","chr3",126267201,126267884,126267542,683
"21867","chr18",78933917,78934195,78934056,278
"21868","chr7",32495477,32495928,32495702,451
"21869","chr9",128371287,128371679,128371483,392
"21870","chr22",36816725,36817423,36817074,698
"21871","chr19",57280094,57280855,57280474,761
"21872","chr17",21511401,21512224,21511812,823
"21873","chr14",76151795,76152109,76151952,314
"21874","chr9",87974294,87974892,87974593,598
"21875","chr12",120534364,120535052,120534708,688
"21876","chr19",43668764,43669100,43668932,336
"21877","chr13",28778650,28779068,28778859,418
"21878","chr4",121950257,121952027,121951142,1770
"21879","chr19",42268180,42269373,42268776,1193
"21880","chr11",30018525,30018747,30018636,222
"21881","chr19",2064854,2065266,2065060,412
"21882","chr2",176124609,176124859,176124734,250
"21883","chr1",159945602,159946007,159945804,405
"21884","chr13",52488899,52489301,52489100,402
"21885","chr19",1063545,1064266,1063905,721
"21886","chr18",47176051,47176469,47176260,418
"21887","chr2",74454842,74455074,74454958,232
"21888","chr19",6752504,6753646,6753075,1142
"21889","chr1",16226831,16227165,16226998,334
"21890","chr8",144396370,144396676,144396523,306
"21891","chr9",503936,505722,504829,1786
"21892","chr18",14450104,14450985,14450544,881
"21893","chr11",1009403,1009649,1009526,246
"21894","chr5",150485501,150486510,150486005,1009
"21895","chr19",13833325,13833881,13833603,556
"21896","chr20",64102110,64102969,64102539,859
"21897","chr7",35261539,35262070,35261804,531
"21898","chr8",12435884,12437371,12436627,1487
"21899","chr11",1290121,1290389,1290255,268
"21900","chr2",120252342,120253652,120252997,1310
"21901","chr7",157416100,157416314,157416207,214
"21902","chr11",61361749,61362407,61362078,658
"21903","chr6",3156725,3156933,3156829,208
"21904","chr3",71753409,71755058,71754233,1649
"21905","chr17",5444329,5444554,5444441,225
"21906","chr19",41192838,41193277,41193057,439
"21907","chr19",32605562,32605798,32605680,236
"21908","chr19",43592071,43593356,43592713,1285
"21909","chr20",24469208,24471401,24470304,2193
"21910","chr11",83156918,83157518,83157218,600
"21911","chr19",40576709,40577449,40577079,740
"21912","chr1",16167566,16168010,16167788,444
"21913","chr14",76413812,76414208,76414010,396
"21914","chr19",35704365,35704573,35704469,208
"21915","chr1",3415422,3415663,3415542,241
"21916","chr1",77888696,77888988,77888842,292
"21917","chr16",351971,353463,352717,1492
"21918","chr10",70283690,70284130,70283910,440
"21919","chr2",70888797,70889282,70889039,485
"21920","chr5",177005853,177006907,177006380,1054
"21921","chrX",47179946,47180172,47180059,226
"21922","chr14",104827223,104827542,104827382,319
"21923","chr14",90525423,90525638,90525530,215
"21924","chr15",100879056,100880928,100879992,1872
"21925","chr9",112174874,112175544,112175209,670
"21926","chr2",219562426,219562673,219562549,247
"21927","chr10",75294797,75295325,75295061,528
"21928","chr19",4402486,4403094,4402790,608
"21929","chr22",45671571,45672610,45672090,1039
"21930","chr14",103091269,103091898,103091583,629
"21931","chr22",50184735,50186797,50185766,2062
"21932","chr2",242003255,242004412,242003833,1157
"21933","chr11",77411691,77412043,77411867,352
"21934","chr19",5829037,5829463,5829250,426
"21935","chr1",106080771,106081232,106081001,461
"21936","chr7",79452858,79453111,79452984,253
"21937","chr18",9613737,9615305,9614521,1568
"21938","chr11",2921564,2921836,2921700,272
"21939","chr1",151511097,151511642,151511369,545
"21940","chr17",2694957,2695506,2695231,549
"21941","chr18",75915962,75916703,75916332,741
"21942","chr8",109362323,109362564,109362443,241
"21943","chr22",29470337,29470663,29470500,326
"21944","chr16",2075658,2075994,2075826,336
"21945","chr17",39451140,39451465,39451302,325
"21946","chr2",199911023,199911825,199911424,802
"21947","chr10",117374292,117376121,117375206,1829
"21948","chr16",3035221,3035468,3035344,247
"21949","chr9",93948529,93949435,93948982,906
"21950","chr8",48318962,48319250,48319106,288
"21951","chr15",82952198,82952975,82952586,777
"21952","chr14",77033361,77033681,77033521,320
"21953","chr18",31041523,31043151,31042337,1628
"21954","chr4",3503163,3503467,3503315,304
"21955","chr19",746300,747161,746730,861
"21956","chr1",27615354,27615813,27615583,459
"21957","chr22",37334510,37335309,37334909,799
"21958","chr11",72112622,72112929,72112775,307
"21959","chr17",48550425,48551082,48550753,657
"21960","chr2",201618861,201619234,201619047,373
"21961","chr12",49961056,49962380,49961718,1324
"21962","chrX",145817845,145818748,145818296,903
"21963","chr16",846563,847148,846855,585
"21964","chr14",105218618,105218822,105218720,204
"21965","chr8",22066329,22067002,22066665,673
"21966","chr2",127652989,127653230,127653109,241
"21967","chr19",47045193,47046236,47045714,1043
"21968","chrX",135973512,135974546,135974029,1034
"21969","chr8",8963256,8963602,8963429,346
"21970","chr2",8678162,8678373,8678267,211
"21971","chr10",72007398,72008621,72008009,1223
"21972","chr19",40284830,40285700,40285265,870
"21973","chr2",86809477,86809878,86809677,401
"21974","chr8",67028456,67028762,67028609,306
"21975","chr9",133793989,133794207,133794098,218
"21976","chr19",9140463,9140762,9140612,299
"21977","chr6",29159704,29160213,29159958,509
"21978","chr13",27251214,27251912,27251563,698
"21979","chr16",85235586,85235974,85235780,388
"21980","chr2",3287336,3287732,3287534,396
"21981","chr10",35765194,35765451,35765322,257
"21982","chr11",30585208,30586581,30585894,1373
"21983","chr17",38559455,38559759,38559607,304
"21984","chr13",94596034,94596418,94596226,384
"21985","chr3",42658600,42658863,42658731,263
"21986","chr7",139230688,139232210,139231449,1522
"21987","chr8",266352,266828,266590,476
"21988","chr22",38871534,38873155,38872344,1621
"21989","chr17",28371338,28372538,28371938,1200
"21990","chr15",76931636,76932125,76931880,489
"21991","chr17",47847232,47848441,47847836,1209
"21992","chr17",74842673,74843436,74843054,763
"21993","chr6",35452237,35452989,35452613,752
"21994","chr21",45530672,45532372,45531522,1700
"21995","chr9",83062100,83063406,83062753,1306
"21996","chr5",173888505,173888976,173888740,471
"21997","chr19",4652091,4652488,4652289,397
"21998","chr5",177491573,177492658,177492115,1085
"21999","chr1",228286134,228286342,228286238,208
"22000","chr14",91253232,91253884,91253558,652
"22001","chr12",51907017,51907799,51907408,782
"22002","chr15",63321468,63321886,63321677,418
"22003","chr13",91398899,91399462,91399180,563
"22004","chr10",99527405,99528163,99527784,758
"22005","chr16",824280,824895,824587,615
"22006","chr19",17831147,17831758,17831452,611
"22007","chr10",5648564,5648952,5648758,388
"22008","chr2",130427660,130428015,130427837,355
"22009","chr9",137077047,137079513,137078280,2466
"22010","chr1",1535224,1536210,1535717,986
"22011","chr14",20624776,20624980,20624878,204
"22012","chr19",45346594,45346796,45346695,202
"22013","chr19",17497174,17497597,17497385,423
"22014","chr20",38646048,38646491,38646269,443
"22015","chr9",129610031,129610866,129610448,835
"22016","chr14",63641625,63642234,63641929,609
"22017","chr10",91798213,91798942,91798577,729
"22018","chr19",16889816,16890587,16890201,771
"22019","chr10",32109908,32110168,32110038,260
"22020","chr11",65354467,65355241,65354854,774
"22021","chr13",114314189,114314890,114314539,701
"22022","chr4",190017852,190018119,190017985,267
"22023","chr11",800551,800866,800708,315
"22024","chr19",54115272,54115787,54115529,515
"22025","chr11",379295,380768,380031,1473
"22026","chr17",43211708,43212254,43211981,546
"22027","chr19",33225406,33225735,33225570,329
"22028","chr12",108560719,108561247,108560983,528
"22029","chr16",67246120,67247727,67246923,1607
"22030","chr6",26501497,26501879,26501688,382
"22031","chr11",32437876,32438332,32438104,456
"22032","chrY",9355988,9356251,9356119,263
"22033","chr22",43186673,43187824,43187248,1151
"22034","chr1",16904803,16905185,16904994,382
"22035","chr5",177592063,177592633,177592348,570
"22036","chr20",58467110,58467709,58467409,599
"22037","chr3",194486743,194488056,194487399,1313
"22038","chr2",70258099,70258547,70258323,448
"22039","chr11",50278837,50279051,50278944,214
"22040","chr12",101280012,101280378,101280195,366
"22041","chr19",37317636,37318131,37317883,495
"22042","chr20",62877063,62877325,62877194,262
"22043","chrX",74420063,74420943,74420503,880
"22044","chr11",64777647,64779212,64778429,1565
"22045","chr11",124718187,124718535,124718361,348
"22046","chr1",21225081,21225438,21225259,357
"22047","chr5",78360061,78361173,78360617,1112
"22048","chr11",17077292,17077959,17077625,667
"22049","chr19",2489066,2489643,2489354,577
"22050","chr19",11848762,11849249,11849005,487
"22051","chr20",61978059,61978543,61978301,484
"22052","chr18",78400173,78400444,78400308,271
"22053","chr18",14486799,14487486,14487142,687
"22054","chr19",48415916,48416155,48416035,239
"22055","chr6",127266688,127267457,127267072,769
"22056","chr12",53751104,53752098,53751601,994
"22057","chr3",129439759,129440634,129440196,875
"22058","chr19",49363495,49363952,49363723,457
"22059","chr10",93068345,93069283,93068814,938
"22060","chr9",66900628,66900901,66900764,273
"22061","chr9",34457377,34458894,34458135,1517
"22062","chr6",10383292,10383881,10383586,589
"22063","chr17",1179082,1179461,1179271,379
"22064","chr21",46425681,46425950,46425815,269
"22065","chr19",3110098,3110440,3110269,342
"22066","chr5",176361318,176361995,176361656,677
"22067","chr4",189645395,189646568,189645981,1173
"22068","chr9",136367549,136367944,136367746,395
"22069","chr22",31290650,31291385,31291017,735
"22070","chr11",93784143,93784964,93784553,821
"22071","chr8",144094647,144095537,144095092,890
"22072","chr10",79825914,79827215,79826564,1301
"22073","chr7",1476346,1476605,1476475,259
"22074","chr5",140672474,140673796,140673135,1322
"22075","chr19",47264661,47264942,47264801,281
"22076","chr12",57604834,57605101,57604967,267
"22077","chr11",89947613,89947857,89947735,244
"22078","chr9",94374307,94375374,94374840,1067
"22079","chr7",73570660,73570878,73570769,218
"22080","chr19",46487969,46488186,46488077,217
"22081","chr9",131823754,131824136,131823945,382
"22082","chr7",157653827,157654245,157654036,418
"22083","chr9",5110784,5112274,5111529,1490
"22084","chr11",64369401,64370715,64370058,1314
"22085","chr11",330785,331110,330947,325
"22086","chr17",63549860,63550929,63550394,1069
"22087","chrX",131795905,131796155,131796030,250
"22088","chr11",611691,611943,611817,252
"22089","chr11",118359449,118359653,118359551,204
"22090","chr9",123339498,123339759,123339628,261
"22091","chr12",120265173,120265738,120265455,565
"22092","chr7",1936622,1936828,1936725,206
"22093","chr11",64240811,64242015,64241413,1204
"22094","chr19",1399166,1399389,1399277,223
"22095","chr4",121764705,121765410,121765057,705
"22096","chr17",82735053,82735853,82735453,800
"22097","chr19",52397702,52397905,52397803,203
"22098","chr17",7234039,7234814,7234426,775
"22099","chr11",67023323,67023969,67023646,646
"22100","chr19",35141315,35141668,35141491,353
"22101","chr20",49982422,49983120,49982771,698
"22102","chr17",80444035,80444289,80444162,254
"22103","chr19",2323913,2324128,2324020,215
"22104","chr19",34172026,34173155,34172590,1129
"22105","chr1",3238596,3238797,3238696,201
"22106","chr9",136423010,136424079,136423544,1069
"22107","chr9",127898828,127899768,127899298,940
"22108","chr9",137240254,137242116,137241185,1862
"22109","chr8",10729103,10729376,10729239,273
"22110","chr6",133889501,133890080,133889790,579
"22111","chr22",50434907,50435145,50435026,238
"22112","chr19",5478288,5478566,5478427,278
"22113","chr19",38374623,38375093,38374858,470
"22114","chr18",12883286,12884579,12883932,1293
"22115","chr8",1379165,1379381,1379273,216
"22116","chr19",1390694,1391305,1390999,611
"22117","chr1",50023745,50024174,50023959,429
"22118","chr9",111631066,111631925,111631495,859
"22119","chr2",7767199,7767609,7767404,410
"22120","chr11",66762185,66762425,66762305,240
"22121","chrX",11138871,11139444,11139157,573
"22122","chr17",39605306,39607298,39606302,1992
"22123","chr9",133812148,133812412,133812280,264
"22124","chr4",17709087,17709442,17709264,355
"22125","chr18",58863447,58864115,58863781,668
"22126","chr13",44435156,44435932,44435544,776
"22127","chr19",55156164,55157097,55156630,933
"22128","chr20",5950316,5950977,5950646,661
"22129","chr3",49869426,49870049,49869737,623
"22130","chr19",36850829,36851098,36850963,269
"22131","chr11",65553754,65554352,65554053,598
"22132","chrX",121047447,121048116,121047781,669
"22133","chr20",20017060,20017915,20017487,855
"22134","chr13",113491650,113491857,113491753,207
"22135","chr3",75655421,75655910,75655665,489
"22136","chr8",701163,701453,701308,290
"22137","chr15",90200899,90202091,90201495,1192
"22138","chr11",47378237,47378455,47378346,218
"22139","chr11",6319215,6319509,6319362,294
"22140","chr17",48613028,48614660,48613844,1632
"22141","chr17",42683713,42684249,42683981,536
"22142","chr11",134275665,134277286,134276475,1621
"22143","chr19",1478604,1479622,1479113,1018
"22144","chr10",131310930,131312789,131311859,1859
"22145","chr11",823556,824878,824217,1322
"22146","chr12",51900389,51900848,51900618,459
"22147","chr10",97196237,97196528,97196382,291
"22148","chr19",35000213,35001116,35000664,903
"22149","chr2",191020217,191020691,191020454,474
"22150","chr10",88990536,88991383,88990959,847
"22151","chr11",124739895,124740575,124740235,680
"22152","chr7",1856454,1856815,1856634,361
"22153","chr13",111976254,111976482,111976368,228
"22154","chr19",488554,490011,489282,1457
"22155","chr19",45862944,45863347,45863145,403
"22156","chr4",173518661,173519098,173518879,437
"22157","chr21",39445376,39446047,39445711,671
"22158","chr19",53554160,53555000,53554580,840
"22159","chr22",45268449,45268939,45268694,490
"22160","chr22",30922241,30922502,30922371,261
"22161","chr1",158149698,158149914,158149806,216
"22162","chr6",150037736,150038258,150037997,522
"22163","chr19",42080364,42080603,42080483,239
"22164","chr19",2131293,2131882,2131587,589
"22165","chr20",37345774,37346445,37346109,671
"22166","chr7",81611065,81611392,81611228,327
"22167","chr19",1957775,1958039,1957907,264
"22168","chr1",179882347,179883236,179882791,889
"22169","chr18",46097990,46098386,46098188,396
"22170","chr1",231160813,231161599,231161206,786
"22171","chr16",35552798,35553252,35553025,454
"22172","chr1",1439081,1440204,1439642,1123
"22173","chr19",917034,920787,918910,3753
"22174","chr19",39833267,39834365,39833816,1098
"22175","chr20",62064216,62066749,62065482,2533
"22176","chr19",33772038,33773001,33772519,963
"22177","chr2",3557899,3558742,3558320,843
"22178","chr4",3340056,3340294,3340175,238
"22179","chr19",51018748,51019547,51019147,799
"22180","chr1",34868703,34868905,34868804,202
"22181","chr19",53158177,53158595,53158386,418
"22182","chr13",114198625,114200365,114199495,1740
"22183","chr1",1048826,1049049,1048937,223
"22184","chr1",99004376,99005028,99004702,652
"22185","chr11",124799481,124800623,124800052,1142
"22186","chr16",30334731,30335544,30335137,813
"22187","chrX",14029624,14030190,14029907,566
"22188","chr2",189661332,189661693,189661512,361
"22189","chr2",130372145,130372938,130372541,793
"22190","chr1",41516117,41516372,41516244,255
"22191","chr19",40403593,40403930,40403761,337
"22192","chr8",1945530,1945917,1945723,387
"22193","chr16",88659175,88659428,88659301,253
"22194","chr19",12873318,12874652,12873985,1334
"22195","chr19",3821976,3822280,3822128,304
"22196","chr19",48719797,48720055,48719926,258
"22197","chr13",114032602,114032858,114032730,256
"22198","chr10",101291371,101292353,101291862,982
"22199","chr11",2155609,2155813,2155711,204
"22200","chr1",87328119,87329459,87328789,1340
"22201","chr2",95025112,95026686,95025899,1574
"22202","chr5",139740425,139740635,139740530,210
"22203","chr1",135124,135563,135343,439
"22204","chr19",36305113,36305566,36305339,453
"22205","chr19",7617793,7618102,7617947,309
"22206","chr22",41799949,41800957,41800453,1008
"22207","chr12",122959664,122960018,122959841,354
"22208","chr8",143275827,143276905,143276366,1078
"22209","chr1",181022091,181022329,181022210,238
"22210","chr19",11208768,11209077,11208922,309
"22211","chr1",22142419,22143759,22143089,1340
"22212","chr7",99598060,99598378,99598219,318
"22213","chr8",143373337,143373740,143373538,403
"22214","chr19",14209490,14209832,14209661,342
"22215","chr6",108133856,108134069,108133962,213
"22216","chr19",48933438,48933798,48933618,360
"22217","chr19",49441151,49441577,49441364,426
"22218","chr1",159924539,159925608,159925073,1069
"22219","chr19",17719295,17719837,17719566,542
"22220","chr12",48851873,48852390,48852131,517
"22221","chr8",38268579,38269514,38269046,935
"22222","chr2",172084514,172085398,172084956,884
"22223","chr1",109075957,109076210,109076083,253
"22224","chr18",50266372,50266666,50266519,294
"22225","chr5",177671633,177672524,177672078,891
"22226","chr8",144517080,144518442,144517761,1362
"22227","chr4",110618750,110618971,110618860,221
"22228","chr18",56651225,56651554,56651389,329
"22229","chr19",6230447,6230655,6230551,208
"22230","chr2",55693645,55694008,55693826,363
"22231","chr19",35844092,35844419,35844255,327
"22232","chr1",151909287,151909931,151909609,644
"22233","chr16",58629071,58630144,58629607,1073
"22234","chr18",10589152,10589389,10589270,237
"22235","chr11",420265,421747,421006,1482
"22236","chr9",90642694,90642898,90642796,204
"22237","chr17",1455646,1456520,1456083,874
"22238","chr19",15584487,15584724,15584605,237
"22239","chr2",176178023,176178716,176178369,693
"22240","chr9",136522663,136523066,136522864,403
"22241","chr20",35174600,35175168,35174884,568
"22242","chr1",53945384,53946670,53946027,1286
"22243","chr11",2807215,2807654,2807434,439
"22244","chr19",1924513,1924776,1924644,263
"22245","chr10",5812743,5814002,5813372,1259
"22246","chr2",172080260,172080656,172080458,396
"22247","chr2",202912136,202912799,202912467,663
"22248","chr17",80108645,80108927,80108786,282
"22249","chr17",7296391,7296690,7296540,299
"22250","chr19",45939903,45940950,45940426,1047
"22251","chr18",7116853,7118242,7117547,1389
"22252","chr19",49461770,49462109,49461939,339
"22253","chr12",117760962,117761482,117761222,520
"22254","chr18",59267601,59269595,59268598,1994
"22255","chr4",4226372,4228112,4227242,1740
"22256","chr11",61332601,61333500,61333050,899
"22257","chr1",52055074,52055452,52055263,378
"22258","chr17",48728191,48728786,48728488,595
"22259","chr11",75561905,75562571,75562238,666
"22260","chr19",6230092,6230295,6230193,203
"22261","chr3",119468900,119469461,119469180,561
"22262","chr1",44654565,44655051,44654808,486
"22263","chr16",66935596,66935975,66935785,379
"22264","chr3",119322632,119323408,119323020,776
"22265","chr13",21483856,21484122,21483989,266
"22266","chr17",17812382,17812905,17812643,523
"22267","chr17",16535518,16536132,16535825,614
"22268","chrX",80809424,80809637,80809530,213
"22269","chr19",18220236,18220585,18220410,349
"22270","chrX",153474859,153475199,153475029,340
"22271","chr19",49889812,49890741,49890276,929
"22272","chr9",137422708,137424211,137423459,1503
"22273","chr4",48985773,48986791,48986282,1018
"22274","chr2",71466034,71466997,71466515,963
"22275","chr7",99551885,99552184,99552034,299
"22276","chrX",155026640,155027421,155027030,781
"22277","chr19",49664433,49664941,49664687,508
"22278","chr21",46498584,46498815,46498699,231
"22279","chr9",121896666,121896912,121896789,246
"22280","chr13",108495450,108496671,108496060,1221
"22281","chr11",1996815,1997023,1996919,208
"22282","chr22",20079883,20080679,20080281,796
"22283","chr2",120347136,120347359,120347247,223
"22284","chr18",80077960,80078200,80078080,240
"22285","chr13",111093146,111093350,111093248,204
"22286","chr18",10032461,10032910,10032685,449
"22287","chr17",3888650,3888859,3888754,209
"22288","chr3",197654234,197654994,197654614,760
"22289","chr2",131092899,131093789,131093344,890
"22290","chr19",38561164,38561618,38561391,454
"22291","chr4",103198162,103198506,103198334,344
"22292","chr22",41285545,41286539,41286042,994
"22293","chr8",41828667,41829156,41828911,489
"22294","chrX",10014473,10016543,10015508,2070
"22295","chr8",142477126,142477463,142477294,337
"22296","chr19",7142896,7143098,7142997,202
"22297","chr12",131944983,131945194,131945088,211
"22298","chr7",74306416,74306658,74306537,242
"22299","chr2",232381289,232381738,232381513,449
"22300","chr11",763192,763425,763308,233
"22301","chr4",4856662,4857166,4856914,504
"22302","chr12",49295090,49297577,49296333,2487
"22303","chr8",93754772,93754986,93754879,214
"22304","chr19",15911702,15912040,15911871,338
"22305","chr3",196431732,196432732,196432232,1000
"22306","chr9",130904067,130904547,130904307,480
"22307","chr8",144286314,144286659,144286486,345
"22308","chr10",133131827,133132309,133132068,482
"22309","chr3",75395561,75396460,75396010,899
"22310","chr13",49935808,49936608,49936208,800
"22311","chr5",132293537,132294884,132294210,1347
"22312","chr15",101277041,101277710,101277375,669
"22313","chr1",247115902,247116159,247116030,257
"22314","chr11",77820140,77821216,77820678,1076
"22315","chr11",59173357,59173579,59173468,222
"22316","chr19",54162185,54162644,54162414,459
"22317","chr3",65379267,65379586,65379426,319
"22318","chr1",220528119,220529006,220528562,887
"22319","chr4",74157860,74158483,74158171,623
"22320","chr3",53179630,53179864,53179747,234
"22321","chr1",197902458,197903169,197902813,711
"22322","chr2",88626719,88627777,88627248,1058
"22323","chr11",63908847,63909325,63909086,478
"22324","chr9",68241751,68242040,68241895,289
"22325","chr19",19138373,19138634,19138503,261
"22326","chr11",118634791,118635023,118634907,232
"22327","chr16",18571002,18571330,18571166,328
"22328","chrX",45381602,45382181,45381891,579
"22329","chr19",38735625,38736440,38736032,815
"22330","chr7",1536100,1536357,1536228,257
"22331","chr10",24952181,24952852,24952516,671
"22332","chr20",58205213,58206062,58205637,849
"22333","chr1",12229897,12230528,12230212,631
"22334","chr11",107858223,107858860,107858541,637
"22335","chrX",154490315,154491116,154490715,801
"22336","chr20",62796492,62796927,62796709,435
"22337","chr13",111283064,111283335,111283199,271
"22338","chr1",158113407,158113750,158113578,343
"22339","chr11",1946846,1947827,1947336,981
"22340","chr11",77473148,77474459,77473803,1311
"22341","chr1",227541814,227542791,227542302,977
"22342","chr7",35982709,35982966,35982837,257
"22343","chr22",38057064,38057496,38057280,432
"22344","chr17",1936844,1937915,1937379,1071
"22345","chr1",243979549,243979753,243979651,204
"22346","chr13",19344445,19345081,19344763,636
"22347","chr19",57727217,57727660,57727438,443
"22348","chr17",18681926,18682516,18682221,590
"22349","chr10",100729586,100731254,100730420,1668
"22350","chr1",248826251,248826532,248826391,281
"22351","chr1",230332758,230333104,230332931,346
"22352","chr19",45092828,45093613,45093220,785
"22353","chr12",54005628,54005870,54005749,242
"22354","chr11",62573756,62574223,62573989,467
"22355","chr2",97734521,97734794,97734657,273
"22356","chrX",38562012,38562225,38562118,213
"22357","chr4",131733147,131733543,131733345,396
"22358","chr8",143567245,143567572,143567408,327
"22359","chr9",97697142,97697493,97697317,351
"22360","chr16",88889700,88890127,88889913,427
"22361","chr6",159726697,159728033,159727365,1336
"22362","chr9",86354092,86354989,86354540,897
"22363","chr6",27814469,27814707,27814588,238
"22364","chr19",36572990,36573847,36573418,857
"22365","chr1",61076865,61077205,61077035,340
"22366","chr20",4014926,4015758,4015342,832
"22367","chr1",220877106,220877522,220877314,416
"22368","chr8",96159577,96159794,96159685,217
"22369","chr1",18877380,18877740,18877560,360
"22370","chr1",145284240,145284512,145284376,272
"22371","chr17",5097074,5097910,5097492,836
"22372","chr12",56687506,56688661,56688083,1155
"22373","chr19",35995035,35995950,35995492,915
"22374","chr7",108526425,108526633,108526529,208
"22375","chr16",1786679,1787011,1786845,332
"22376","chr20",63578034,63578290,63578162,256
"22377","chr9",998463,999034,998748,571
"22378","chr9",19049083,19049951,19049517,868
"22379","chr8",144588535,144588812,144588673,277
"22380","chr19",3653268,3653647,3653457,379
"22381","chr20",62182553,62183322,62182937,769
"22382","chr9",127527082,127527311,127527196,229
"22383","chr7",4883076,4883945,4883510,869
"22384","chr20",40682738,40683795,40683266,1057
"22385","chr8",38231217,38232438,38231827,1221
"22386","chr11",120986016,120986465,120986240,449
"22387","chr2",236172667,236173751,236173209,1084
"22388","chr19",48635571,48636144,48635857,573
"22389","chr19",13702447,13702785,13702616,338
"22390","chr19",36127825,36128231,36128028,406
"22391","chr17",35448550,35448775,35448662,225
"22392","chr4",1568173,1568414,1568293,241
"22393","chr12",6310304,6310964,6310634,660
"22394","chr10",46774385,46775278,46774831,893
"22395","chr17",21213537,21214718,21214127,1181
"22396","chr19",34963563,34964343,34963953,780
"22397","chr19",45496503,45497240,45496871,737
"22398","chr16",30582644,30583204,30582924,560
"22399","chr18",79470597,79470803,79470700,206
"22400","chr19",18611548,18613191,18612369,1643
"22401","chr19",1725416,1726155,1725785,739
"22402","chr12",52036735,52037814,52037274,1079
"22403","chr17",36464002,36464912,36464457,910
"22404","chr1",148309958,148310365,148310161,407
"22405","chr19",3623820,3624143,3623981,323
"22406","chr19",13207232,13207998,13207615,766
"22407","chr20",2524513,2525333,2524923,820
"22408","chr17",81707170,81707635,81707402,465
"22409","chr9",134135345,134136876,134136110,1531
"22410","chr5",140802303,140803429,140802866,1126
"22411","chr3",142447360,142448184,142447772,824
"22412","chr10",132858865,132859100,132858982,235
"22413","chrX",47803147,47803377,47803262,230
"22414","chr19",2046075,2046305,2046190,230
"22415","chr20",31849480,31849929,31849704,449
"22416","chr4",1069953,1070171,1070062,218
"22417","chr12",56645263,56646039,56645651,776
"22418","chr19",36054099,36055163,36054631,1064
"22419","chr19",38335663,38335889,38335776,226
"22420","chr6",7140803,7141343,7141073,540
"22421","chr19",40404108,40404419,40404263,311
"22422","chr2",218898265,218898815,218898540,550
"22423","chr12",102061642,102062205,102061923,563
"22424","chr13",112106551,112106799,112106675,248
"22425","chr1",200040679,200040908,200040793,229
"22426","chr19",44356505,44356776,44356640,271
"22427","chr1",46485496,46486120,46485808,624
"22428","chr1",6601716,6603784,6602750,2068
"22429","chr9",107637620,107638276,107637948,656
"22430","chrY",11957130,11957338,11957234,208
"22431","chr7",155344863,155345185,155345024,322
"22432","chr7",129169248,129169552,129169400,304
"22433","chr1",16148616,16148829,16148722,213
"22434","chr1",15847394,15848901,15848147,1507
"22435","chr17",48554438,48554850,48554644,412
"22436","chr7",63572217,63572652,63572434,435
"22437","chr11",134361833,134362064,134361948,231
"22438","chr9",137085925,137087435,137086680,1510
"22439","chr2",219563393,219563620,219563506,227
"22440","chr9",36985989,36986927,36986458,938
"22441","chr16",88184547,88184876,88184711,329
"22442","chr8",56117637,56118325,56117981,688
"22443","chr16",15133265,15134280,15133772,1015
"22444","chr11",119363770,119364504,119364137,734
"22445","chr1",9689237,9690170,9689703,933
"22446","chr7",54546359,54547104,54546731,745
"22447","chr2",118848462,118848737,118848599,275
"22448","chrY",13479379,13479840,13479609,461
"22449","chr11",1448803,1449158,1448980,355
"22450","chr19",29942097,29942958,29942527,861
"22451","chr11",67997447,67997786,67997616,339
"22452","chr20",21505294,21506966,21506130,1672
"22453","chr11",9384561,9385155,9384858,594
"22454","chr3",158732006,158732808,158732407,802
"22455","chr10",95183438,95183980,95183709,542
"22456","chr19",22893803,22894218,22894010,415
"22457","chr1",940225,942983,941604,2758
"22458","chr2",38376427,38377410,38376918,983
"22459","chr9",127508958,127509168,127509063,210
"22460","chr22",49404921,49405135,49405028,214
"22461","chr11",108592871,108593376,108593123,505
"22462","chr17",81936792,81937657,81937224,865
"22463","chr7",75421776,75422000,75421888,224
"22464","chr11",61392364,61392813,61392588,449
"22465","chr17",18263860,18264286,18264073,426
"22466","chr6",117675232,117676212,117675722,980
"22467","chr8",17155927,17157281,17156604,1354
"22468","chr8",22999287,23000014,22999650,727
"22469","chr8",60678227,60680621,60679424,2394
"22470","chr11",62621731,62622319,62622025,588
"22471","chr11",128824189,128824535,128824362,346
"22472","chr7",782052,782997,782524,945
"22473","chr7",54888580,54888906,54888743,326
"22474","chr3",156816050,156817342,156816696,1292
"22475","chr17",17797556,17797766,17797661,210
"22476","chr11",943737,944142,943939,405
"22477","chr11",57476208,57476990,57476599,782
"22478","chr17",75003109,75003883,75003496,774
"22479","chr19",3452460,3452740,3452600,280
"22480","chr2",239189618,239189881,239189749,263
"22481","chr15",28457434,28457704,28457569,270
"22482","chr18",79878263,79878517,79878390,254
"22483","chr22",17119673,17121721,17120697,2048
"22484","chr2",178478528,178478773,178478650,245
"22485","chr19",1234939,1235290,1235114,351
"22486","chr18",55587822,55588464,55588143,642
"22487","chr18",79510793,79511160,79510976,367
"22488","chr6",163149130,163149782,163149456,652
"22489","chr19",40801077,40801408,40801242,331
"22490","chr3",44685436,44685745,44685590,309
"22491","chr19",47112698,47113130,47112914,432
"22492","chr11",63768180,63769963,63769071,1783
"22493","chr19",3547930,3548341,3548135,411
"22494","chr10",50739632,50740261,50739946,629
"22495","chr15",74873032,74873562,74873297,530
"22496","chr15",76904917,76905554,76905235,637
"22497","chr15",68053965,68055070,68054517,1105
"22498","chr2",218387698,218387908,218387803,210
"22499","chr9",16870125,16872022,16871073,1897
"22500","chr2",131528194,131528419,131528306,225
"22501","chr11",1937704,1938017,1937860,313
"22502","chr19",15418479,15419091,15418785,612
"22503","chr17",29005250,29006170,29005710,920
"22504","chr15",89333159,89333725,89333442,566
"22505","chr17",42783946,42784162,42784054,216
"22506","chr15",42274000,42274206,42274103,206
"22507","chr15",88256291,88257786,88257038,1495
"22508","chr17",78128054,78128793,78128423,739
"22509","chr15",85255507,85255733,85255620,226
"22510","chr2",219434761,219435521,219435141,760
"22511","chr6",167796462,167796734,167796598,272
"22512","chr2",63056801,63057012,63056906,211
"22513","chr2",17877771,17877978,17877874,207
"22514","chr9",133120582,133121567,133121074,985
"22515","chr5",41510222,41510549,41510385,327
"22516","chr10",100989113,100989331,100989222,218
"22517","chr19",39402541,39402973,39402757,432
"22518","chr19",3785513,3786655,3786084,1142
"22519","chr7",95396247,95396810,95396528,563
"22520","chr6",137488205,137489067,137488636,862
"22521","chr20",62466217,62466667,62466442,450
"22522","chr2",240630274,240630721,240630497,447
"22523","chr4",1413658,1415436,1414547,1778
"22524","chr17",59220944,59221284,59221114,340
"22525","chr3",134364018,134364359,134364188,341
"22526","chr20",46177960,46178236,46178098,276
"22527","chr19",43463095,43464473,43463784,1378
"22528","chr19",56538306,56539277,56538791,971
"22529","chr8",142402657,142403690,142403173,1033
"22530","chr13",110874636,110874841,110874738,205
"22531","chr9",124022742,124022946,124022844,204
"22532","chr6",98947426,98948093,98947759,667
"22533","chr19",1465207,1471242,1468224,6035
"22534","chr15",94856140,94856595,94856367,455
"22535","chr19",1918818,1919102,1918960,284
"22536","chr22",20319586,20320503,20320044,917
"22537","chr19",40613125,40614488,40613806,1363
"22538","chr19",7554606,7555750,7555178,1144
"22539","chr11",123061465,123063095,123062280,1630
"22540","chr15",43648668,43649504,43649086,836
"22541","chr15",98891336,98891684,98891510,348
"22542","chr19",5119209,5119434,5119321,225
"22543","chr22",18527944,18530474,18529209,2530
"22544","chr17",35089122,35089559,35089340,437
"22545","chr3",187739943,187740160,187740051,217
"22546","chr16",84186590,84187173,84186881,583
"22547","chr13",113262760,113263174,113262967,414
"22548","chr12",53927517,53927937,53927727,420
"22549","chr19",41351342,41351681,41351511,339
"22550","chr22",37560095,37561919,37561007,1824
"22551","chr8",85245606,85245939,85245772,333
"22552","chr1",40449933,40450400,40450166,467
"22553","chr19",5093427,5093649,5093538,222
"22554","chr19",6199281,6199833,6199557,552
"22555","chr17",3695758,3696257,3696007,499
"22556","chrX",43654782,43655545,43655163,763
"22557","chr12",49332808,49333331,49333069,523
"22558","chr10",133389597,133389812,133389704,215
"22559","chr20",17228773,17228977,17228875,204
"22560","chr12",42589325,42590079,42589702,754
"22561","chr6",10886951,10887389,10887170,438
"22562","chr1",159929642,159930063,159929852,421
"22563","chr17",307171,307429,307300,258
"22564","chr7",984385,984597,984491,212
"22565","chrX",153347317,153347995,153347656,678
"22566","chrX",54808787,54809092,54808939,305
"22567","chr17",83068149,83069072,83068610,923
"22568","chr10",42951427,42951702,42951564,275
"22569","chr17",82320985,82321219,82321102,234
"22570","chr11",6418633,6419502,6419067,869
"22571","chr10",28676775,28678337,28677556,1562
"22572","chr3",44712607,44712907,44712757,300
"22573","chr12",56468381,56468644,56468512,263
"22574","chrX",103629508,103629749,103629628,241
"22575","chr12",130703452,130703703,130703577,251
"22576","chr19",1000199,1000995,1000597,796
"22577","chr5",72320180,72320518,72320349,338
"22578","chr5",21459360,21459743,21459551,383
"22579","chr11",114400077,114400968,114400522,891
"22580","chr19",7463725,7463931,7463828,206
"22581","chr7",158268748,158269054,158268901,306
"22582","chr1",1964975,1965189,1965082,214
"22583","chr19",21677990,21678214,21678102,224
"22584","chr1",35576831,35577843,35577337,1012
"22585","chr20",35615756,35616379,35616067,623
"22586","chr22",21641952,21643043,21642497,1091
"22587","chr19",16417947,16418218,16418082,271
"22588","chr16",32478468,32478757,32478612,289
"22589","chr11",124762167,124763343,124762755,1176
"22590","chr10",5641685,5641915,5641800,230
"22591","chr19",12841201,12841467,12841334,266
"22592","chr1",169105528,169107173,169106350,1645
"22593","chr13",68984772,68985172,68984972,400
"22594","chr4",1028498,1028879,1028688,381
"22595","chr9",132586547,132587522,132587034,975
"22596","chr15",84633397,84634371,84633884,974
"22597","chr15",37490683,37490920,37490801,237
"22598","chr5",181114651,181114898,181114774,247
"22599","chr16",88721625,88723032,88722328,1407
"22600","chr2",148020653,148020961,148020807,308
"22601","chr15",67833684,67834231,67833957,547
"22602","chr10",48604807,48605307,48605057,500
"22603","chr11",43880704,43880978,43880841,274
"22604","chr2",240777622,240778976,240778299,1354
"22605","chr5",1079914,1080376,1080145,462
"22606","chr19",49533821,49534413,49534117,592
"22607","chr13",27960295,27961423,27960859,1128
"22608","chr18",79736768,79737180,79736974,412
"22609","chrX",126580907,126581338,126581122,431
"22610","chr18",49814007,49814586,49814296,579
"22611","chr7",44146362,44146585,44146473,223
"22612","chr9",137374261,137374541,137374401,280
"22613","chr19",429260,429581,429420,321
"22614","chr9",112486448,112487464,112486956,1016
"22615","chr19",13024503,13025355,13024929,852
"22616","chr12",54006122,54006711,54006416,589
"22617","chr9",136496950,136497535,136497242,585
"22618","chr7",158877109,158877314,158877211,205
"22619","chr1",3425974,3426242,3426108,268
"22620","chr19",51339821,51340672,51340246,851
"22621","chr11",484663,486082,485372,1419
"22622","chr16",1978198,1978446,1978322,248
"22623","chr12",111397065,111397281,111397173,216
"22624","chr18",37485076,37485796,37485436,720
"22625","chr19",11169978,11170238,11170108,260
"22626","chr4",1035417,1035845,1035631,428
"22627","chr9",71768161,71769786,71768973,1625
"22628","chr9",135714459,135715088,135714773,629
"22629","chr18",499315,501011,500163,1696
"22630","chrX",155380586,155381028,155380807,442
"22631","chr19",8555657,8555861,8555759,204
"22632","chrY",11173002,11173375,11173188,373
"22633","chr6",100467726,100468007,100467866,281
"22634","chr7",151172678,151173078,151172878,400
"22635","chr16",33495874,33496397,33496135,523
"22636","chr19",4446014,4446632,4446323,618
"22637","chr3",147421129,147421777,147421453,648
"22638","chr6",169932558,169932891,169932724,333
"22639","chr7",100569513,100570521,100570017,1008
"22640","chr11",119316237,119317436,119316836,1199
"22641","chr6",99607765,99607990,99607877,225
"22642","chr16",2026890,2027469,2027179,579
"22643","chr10",91887295,91887636,91887465,341
"22644","chr8",143560439,143560918,143560678,479
"22645","chr7",19107300,19107685,19107492,385
"22646","chr3",9731141,9732227,9731684,1086
"22647","chr7",152924831,152925064,152924947,233
"22648","chr20",31968098,31968699,31968398,601
"22649","chr7",2538386,2538732,2538559,346
"22650","chr7",100656159,100656527,100656343,368
"22651","chr17",38752409,38753324,38752866,915
"22652","chr22",49302492,49302873,49302682,381
"22653","chr9",131307943,131308226,131308084,283
"22654","chr10",72692070,72692839,72692454,769
"22655","chr22",38505548,38506900,38506224,1352
"22656","chr20",31994985,31995296,31995140,311
"22657","chr11",123358417,123358764,123358590,347
"22658","chr1",205662849,205663126,205662987,277
"22659","chr16",89070814,89071050,89070932,236
"22660","chr6",26103956,26104274,26104115,318
"22661","chr4",4107007,4107772,4107389,765
"22662","chr16",88828940,88829161,88829050,221
"22663","chr2",27715473,27715754,27715613,281
"22664","chr7",5309065,5309442,5309253,377
"22665","chr7",76358289,76359660,76358974,1371
"22666","chr17",82097303,82099400,82098351,2097
"22667","chr1",1753934,1754532,1754233,598
"22668","chr15",99926275,99928622,99927448,2347
"22669","chr16",89827899,89828927,89828413,1028
"22670","chr13",27792412,27794368,27793390,1956
"22671","chr1",1645016,1645234,1645125,218
"22672","chr22",16386802,16387459,16387130,657
"22673","chr17",80966163,80966382,80966272,219
"22674","chr1",5733497,5733724,5733610,227
"22675","chr17",49575427,49577007,49576217,1580
"22676","chr22",46673626,46673903,46673764,277
"22677","chr1",36178354,36179042,36178698,688
"22678","chr3",46881339,46883692,46882515,2353
"22679","chr12",47758771,47759363,47759067,592
"22680","chr1",6593337,6593614,6593475,277
"22681","chr18",21704204,21705091,21704647,887
"22682","chr1",984346,984547,984446,201
"22683","chr16",88073168,88073731,88073449,563
"22684","chr1",1944178,1944438,1944308,260
"22685","chr1",35930648,35931661,35931154,1013
"22686","chr10",127175326,127175800,127175563,474
"22687","chr10",23343836,23344115,23343975,279
"22688","chr16",67248402,67249249,67248825,847
"22689","chr1",144412227,144412432,144412329,205
"22690","chr11",64269403,64270502,64269952,1099
"22691","chr15",101752508,101764820,101758664,12312
"22692","chr19",40519407,40520199,40519803,792
"22693","chr1",121052119,121052445,121052282,326
"22694","chr20",58514404,58515181,58514792,777
"22695","chr13",113369323,113369604,113369463,281
"22696","chr15",78763969,78764205,78764087,236
"22697","chr7",35971387,35971797,35971592,410
"22698","chr16",1204108,1204375,1204241,267
"22699","chr2",156400296,156400599,156400447,303
"22700","chr4",84582393,84583740,84583066,1347
"22701","chr2",69387076,69387484,69387280,408
"22702","chr19",6211756,6213117,6212436,1361
"22703","chr11",31825585,31825832,31825708,247
"22704","chr11",78139436,78139799,78139617,363
"22705","chr22",20957048,20957667,20957357,619
"22706","chr6",34527299,34527532,34527415,233
"22707","chr16",541327,541590,541458,263
"22708","chr3",82807833,82808093,82807963,260
"22709","chr22",38132813,38133077,38132945,264
"22710","chr22",46085935,46086144,46086039,209
"22711","chr9",96417197,96419441,96418319,2244
"22712","chr19",640789,641005,640897,216
"22713","chr5",141409527,141410195,141409861,668
"22714","chr8",143421250,143421638,143421444,388
"22715","chr3",183824708,183826016,183825362,1308
"22716","chr9",61536149,61536420,61536284,271
"22717","chr17",50719389,50719956,50719672,567
"22718","chr21",36989845,36990568,36990206,723
"22719","chr17",31487596,31488644,31488120,1048
"22720","chr1",220895440,220895817,220895628,377
"22721","chr6",52664141,52664853,52664497,712
"22722","chr1",15617326,15617861,15617593,535
"22723","chr2",130005910,130006191,130006050,281
"22724","chr4",37453657,37453956,37453806,299
"22725","chr22",50190520,50190820,50190670,300
"22726","chr10",103584416,103585282,103584849,866
"22727","chr11",65899205,65900738,65899971,1533
"22728","chrX",74422659,74422931,74422795,272
"22729","chr10",132924714,132925200,132924957,486
"22730","chr1",155194408,155195369,155194888,961
"22731","chr10",133285038,133285726,133285382,688
"22732","chrX",37505069,37505568,37505318,499
"22733","chr20",33731699,33732748,33732223,1049
"22734","chr10",119042149,119042714,119042431,565
"22735","chr19",13905852,13906622,13906237,770
"22736","chr19",6502079,6502400,6502239,321
"22737","chr9",134768667,134768896,134768781,229
"22738","chr19",36772479,36773181,36772830,702
"22739","chr2",159797718,159798380,159798049,662
"22740","chr1",20704515,20704876,20704695,361
"22741","chr1",75724231,75725045,75724638,814
"22742","chr3",42581722,42582380,42582051,658
"22743","chr19",53158936,53159247,53159091,311
"22744","chr8",81630563,81631240,81630901,677
"22745","chr12",122895786,122896347,122896066,561
"22746","chr2",10010565,10016249,10013407,5684
"22747","chr7",1603987,1604212,1604099,225
"22748","chr16",87726160,87726813,87726486,653
"22749","chr3",126288481,126288684,126288582,203
"22750","chrX",111624243,111624519,111624381,276
"22751","chr22",48581364,48581571,48581467,207
"22752","chr1",47433989,47434713,47434351,724
"22753","chrY",11953533,11954302,11953917,769
"22754","chr10",70170251,70170831,70170541,580
"22755","chr6",98843451,98843904,98843677,453
"22756","chr2",170815088,170815294,170815191,206
"22757","chr1",37691623,37692914,37692268,1291
"22758","chr17",27349278,27349577,27349427,299
"22759","chr6",151325533,151325823,151325678,290
"22760","chr10",104315801,104316033,104315917,232
"22761","chr11",116500542,116500889,116500715,347
"22762","chr1",161749624,161750286,161749955,662
"22763","chr5",141351672,141352412,141352042,740
"22764","chr2",44934794,44935786,44935290,992
"22765","chr11",66294360,66295621,66294990,1261
"22766","chr2",171999706,172000116,171999911,410
"22767","chr11",120168893,120169577,120169235,684
"22768","chr22",21340812,21341259,21341035,447
"22769","chr22",30554875,30556088,30555481,1213
"22770","chr16",2868178,2868679,2868428,501
"22771","chr9",113056556,113057063,113056809,507
"22772","chrX",148052014,148052311,148052162,297
"22773","chr22",28883085,28884299,28883692,1214
"22774","chr17",46850921,46852324,46851622,1403
"22775","chr18",54224399,54224821,54224610,422
"22776","chr10",345442,348068,346755,2626
"22777","chr17",47253562,47254400,47253981,838
"22778","chr10",23095632,23096149,23095890,517
"22779","chr1",40819181,40819477,40819329,296
"22780","chr15",93072393,93073956,93073174,1563
"22781","chr2",127651383,127651781,127651582,398
"22782","chr9",137461862,137462535,137462198,673
"22783","chr7",72879203,72880194,72879698,991
"22784","chr15",31372055,31372337,31372196,282
"22785","chr14",105592509,105592710,105592609,201
"22786","chr13",27975702,27976109,27975905,407
"22787","chr1",1341237,1341468,1341352,231
"22788","chr9",137353798,137354163,137353980,365
"22789","chr13",20128712,20128983,20128847,271
"22790","chr10",75111297,75111862,75111579,565
"22791","chr8",143540964,143541747,143541355,783
"22792","chr15",89648247,89649386,89648816,1139
"22793","chr14",104864177,104866314,104865245,2137
"22794","chr11",621963,622176,622069,213
"22795","chr5",141883423,141883630,141883526,207
"22796","chr6",149648363,149648836,149648599,473
"22797","chr8",41649997,41650349,41650173,352
"22798","chr6",45419609,45420427,45420018,818
"22799","chr18",12038414,12039360,12038887,946
"22800","chr22",20267366,20268541,20267953,1175
"22801","chr7",63580750,63580990,63580870,240
"22802","chr17",82870094,82870440,82870267,346
"22803","chr6",146029386,146029644,146029515,258
"22804","chr20",29740672,29744343,29742507,3671
"22805","chr19",52398053,52398274,52398163,221
"22806","chr18",58043596,58045300,58044448,1704
"22807","chr11",33658673,33658882,33658777,209
"22808","chr2",38875520,38876073,38875796,553
"22809","chr13",95002854,95003151,95003002,297
"22810","chr7",74656624,74656827,74656725,203
"22811","chr9",6412353,6414097,6413225,1744
"22812","chr7",121396212,121396616,121396414,404
"22813","chr14",55298619,55298857,55298738,238
"22814","chr22",22117475,22118278,22117876,803
"22815","chr5",173245308,173245968,173245638,660
"22816","chr18",15330309,15331175,15330742,866
"22817","chr14",45135766,45136272,45136019,506
"22818","chr7",73424053,73424485,73424269,432
"22819","chr4",76147913,76148519,76148216,606
"22820","chr18",46334288,46334514,46334401,226
"22821","chr9",130834873,130835898,130835385,1025
"22822","chr8",94719570,94720060,94719815,490
"22823","chr16",30902034,30902594,30902314,560
"22824","chr13",99984858,99985545,99985201,687
"22825","chr17",20852450,20852820,20852635,370
"22826","chr17",16617624,16618003,16617813,379
"22827","chr19",53537558,53538603,53538080,1045
"22828","chr1",2326658,2326984,2326821,326
"22829","chr20",63216214,63216751,63216482,537
"22830","chr18",63366481,63367823,63367152,1342
"22831","chr2",70887603,70888344,70887973,741
"22832","chr19",35944555,35945002,35944778,447
"22833","chr13",20118385,20118628,20118506,243
"22834","chr19",2613934,2614135,2614034,201
"22835","chr8",60909799,60910469,60910134,670
"22836","chr11",30016975,30017276,30017125,301
"22837","chr18",12307555,12309044,12308299,1489
"22838","chr2",3575064,3576114,3575589,1050
"22839","chr9",4984543,4985630,4985086,1087
"22840","chr12",65121098,65122083,65121590,985
"22841","chr7",76461568,76462178,76461873,610
"22842","chr3",40457148,40457769,40457458,621
"22843","chr10",122980276,122980776,122980526,500
"22844","chr18",79520144,79520414,79520279,270
"22845","chr22",17036023,17037610,17036816,1587
"22846","chrX",115561087,115562322,115561704,1235
"22847","chr20",31870104,31870909,31870506,805
"22848","chr2",3643730,3644062,3643896,332
"22849","chr3",79766488,79766750,79766619,262
"22850","chr14",95516161,95517196,95516678,1035
"22851","chr11",66334553,66334808,66334680,255
"22852","chr1",10326125,10326332,10326228,207
"22853","chrX",120874777,120875776,120875276,999
"22854","chr7",6536292,6536758,6536525,466
"22855","chr11",46345326,46345551,46345438,225
"22856","chr21",40182691,40183032,40182861,341
"22857","chr1",85580679,85581557,85581118,878
"22858","chr20",36154401,36154787,36154594,386
"22859","chr6",149954315,149955067,149954691,752
"22860","chr4",1225155,1225930,1225542,775
"22861","chr7",44490111,44490958,44490534,847
"22862","chr13",18598335,18598701,18598518,366
"22863","chr9",137833034,137833410,137833222,376
"22864","chr17",75573082,75573329,75573205,247
"22865","chr19",58361898,58363168,58362533,1270
"22866","chr8",27774329,27774806,27774567,477
"22867","chr1",143904249,143904674,143904461,425
"22868","chr1",111981846,111982763,111982304,917
"22869","chr1",1258981,1259378,1259179,397
"22870","chr10",133577120,133577474,133577297,354
"22871","chr1",147078302,147078527,147078414,225
"22872","chr11",31811158,31811626,31811392,468
"22873","chr1",156920451,156921014,156920732,563
"22874","chr1",1574102,1575367,1574734,1265
"22875","chr9",38069787,38069994,38069890,207
"22876","chr7",27147308,27148073,27147690,765
"22877","chr1",23691865,23692077,23691971,212
"22878","chr19",1619171,1619448,1619309,277
"22879","chr20",41339967,41340220,41340093,253
"22880","chr22",15749416,15749757,15749586,341
"22881","chr19",17647246,17647528,17647387,282
"22882","chr19",42095355,42095766,42095560,411
"22883","chr19",57317571,57317786,57317678,215
"22884","chr12",31728991,31729527,31729259,536
"22885","chr19",18660268,18660530,18660399,262
"22886","chr17",64965823,64966187,64966005,364
"22887","chr22",46701291,46701704,46701497,413
"22888","chr5",139759290,139759657,139759473,367
"22889","chr22",38412779,38413012,38412895,233
"22890","chr14",73950154,73950655,73950404,501
"22891","chr19",1998801,1999333,1999067,532
"22892","chrY",9465148,9465411,9465279,263
"22893","chr1",23559191,23559721,23559456,530
"22894","chrX",11664213,11666424,11665318,2211
"22895","chr19",3198819,3199122,3198970,303
"22896","chr19",48993191,48993516,48993353,325
"22897","chr5",56950708,56952524,56951616,1816
"22898","chr22",29883242,29883869,29883555,627
"22899","chr12",109995974,109996400,109996187,426
"22900","chr15",66293429,66294156,66293792,727
"22901","chr10",5840340,5840672,5840506,332
"22902","chr11",75583022,75583770,75583396,748
"22903","chr18",12896622,12897103,12896862,481
"22904","chr3",142225104,142225678,142225391,574
"22905","chr19",3637310,3637717,3637513,407
"22906","chr3",42664283,42664623,42664453,340
"22907","chr16",4314965,4316981,4315973,2016
"22908","chr20",21302998,21303808,21303403,810
"22909","chr4",56821444,56821865,56821654,421
"22910","chr21",42837856,42838189,42838022,333
"22911","chr2",9319114,9319325,9319219,211
"22912","chr19",1672090,1672575,1672332,485
"22913","chr20",63009128,63009816,63009472,688
"22914","chr19",5719613,5720785,5720199,1172
"22915","chr6",7246432,7247339,7246885,907
"22916","chr8",1456718,1456928,1456823,210
"22917","chr6",1378210,1379083,1378646,873
"22918","chr3",113441452,113441794,113441623,342
"22919","chr12",93677517,93677879,93677698,362
"22920","chr7",44761730,44762082,44761906,352
"22921","chr19",45730783,45731120,45730951,337
"22922","chr19",45404882,45405208,45405045,326
"22923","chr19",11105228,11105631,11105429,403
"22924","chr2",240780048,240780284,240780166,236
"22925","chr4",84483833,84484099,84483966,266
"22926","chr4",1511499,1511706,1511602,207
"22927","chr9",37120053,37120988,37120520,935
"22928","chr8",41566822,41567781,41567301,959
"22929","chr16",1375046,1375603,1375324,557
"22930","chr12",95858242,95858468,95858355,226
"22931","chr10",101829156,101829497,101829326,341
"22932","chr14",105086896,105088546,105087721,1650
"22933","chr16",89240975,89241246,89241110,271
"22934","chr16",791900,792539,792219,639
"22935","chr19",3831365,3831809,3831587,444
"22936","chr9",63812814,63813858,63813336,1044
"22937","chr9",34380212,34380448,34380330,236
"22938","chr8",42436546,42437541,42437043,995
"22939","chr9",35079631,35080216,35079923,585
"22940","chr20",38805563,38806949,38806256,1386
"22941","chr20",64083410,64084408,64083909,998
"22942","chr2",308627,309040,308833,413
"22943","chr14",23010101,23010323,23010212,222
"22944","chr21",43410965,43411356,43411160,391
"22945","chr12",52050769,52051637,52051203,868
"22946","chr19",58581324,58581906,58581615,582
"22947","chr11",67482873,67483393,67483133,520
"22948","chr5",307171,307477,307324,306
"22949","chr1",228469626,228469860,228469743,234
"22950","chr8",141210917,141211383,141211150,466
"22951","chr19",1591999,1593096,1592547,1097
"22952","chr6",29800248,29800555,29800401,307
"22953","chr17",82064779,82066302,82065540,1523
"22954","chr9",136687747,136688163,136687955,416
"22955","chr13",30464233,30464634,30464433,401
"22956","chr14",103132922,103133240,103133081,318
"22957","chr5",141246876,141247805,141247340,929
"22958","chr17",75270259,75271971,75271115,1712
"22959","chr5",177985533,177986021,177985777,488
"22960","chr19",5866700,5867462,5867081,762
"22961","chr16",89119223,89119509,89119366,286
"22962","chr4",41990460,41991108,41990784,648
"22963","chr17",46266660,46267456,46267058,796
"22964","chr14",103084108,103084582,103084345,474
"22965","chrX",134171648,134172906,134172277,1258
"22966","chr3",187738462,187738792,187738627,330
"22967","chr2",182867091,182867365,182867228,274
"22968","chr19",46413330,46413579,46413454,249
"22969","chr19",1918076,1918306,1918191,230
"22970","chr9",38619911,38622634,38621272,2723
"22971","chr13",113531394,113531747,113531570,353
"22972","chr3",75668965,75670008,75669486,1043
"22973","chrX",74421875,74422176,74422025,301
"22974","chr19",46693881,46694143,46694012,262
"22975","chr1",95117194,95117575,95117384,381
"22976","chr19",45886788,45887004,45886896,216
"22977","chr19",57769558,57770118,57769838,560
"22978","chr19",38466116,38466377,38466246,261
"22979","chr19",14431956,14432290,14432123,334
"22980","chr19",2246821,2247036,2246928,215
"22981","chr19",53866133,53866555,53866344,422
"22982","chr5",180127110,180127556,180127333,446
"22983","chr7",1928028,1928358,1928193,330
"22984","chr1",40258124,40258338,40258231,214
"22985","chr19",35874551,35874922,35874736,371
"22986","chr8",57142386,57143685,57143035,1299
"22987","chr9",136093991,136096000,136094995,2009
"22988","chr9",98087417,98088110,98087763,693
"22989","chrX",154341197,154343071,154342134,1874
"22990","chr17",83002634,83005169,83003901,2535
"22991","chr11",70823033,70823283,70823158,250
"22992","chr19",5145805,5146285,5146045,480
"22993","chr1",11980056,11980736,11980396,680
"22994","chr8",10851904,10852270,10852087,366
"22995","chr17",75504866,75505101,75504983,235
"22996","chr21",46322865,46323355,46323110,490
"22997","chr11",119084864,119085122,119084993,258
"22998","chr11",18322078,18322917,18322497,839
"22999","chr7",107563669,107564352,107564010,683
"23000","chr19",55257901,55259507,55258704,1606
"23001","chr19",18461598,18461809,18461703,211
"23002","chr6",3162598,3163289,3162943,691
"23003","chr11",114082898,114083117,114083007,219
"23004","chrX",51407087,51408059,51407573,972
"23005","chr7",4763131,4763389,4763260,258
"23006","chr1",219612992,219613220,219613106,228
"23007","chr16",67236956,67237392,67237174,436
"23008","chr1",119631179,119631761,119631470,582
"23009","chr5",612335,612766,612550,431
"23010","chr1",34865683,34866808,34866245,1125
"23011","chr7",1939073,1939305,1939189,232
"23012","chrX",9992165,9992368,9992266,203
"23013","chr7",139950675,139950880,139950777,205
"23014","chr19",6737228,6737769,6737498,541
"23015","chr1",62435980,62437996,62436988,2016
"23016","chr9",136342324,136343066,136342695,742
"23017","chr1",47984198,47984472,47984335,274
"23018","chr5",141397875,141398371,141398123,496
"23019","chr18",78430598,78430862,78430730,264
"23020","chr10",99530868,99531421,99531144,553
"23021","chr19",48750431,48750964,48750697,533
"23022","chr15",44426988,44427940,44427464,952
"23023","chr22",46409716,46410109,46409912,393
"23024","chr1",58815279,58815522,58815400,243
"23025","chr19",37691892,37692426,37692159,534
"23026","chr19",42697947,42698161,42698054,214
"23027","chr17",19070444,19070764,19070604,320
"23028","chr8",115667471,115667709,115667590,238
"23029","chr22",21957192,21957447,21957319,255
"23030","chr18",74315517,74316509,74316013,992
"23031","chr5",179795607,179796824,179796215,1217
"23032","chr19",54471167,54471676,54471421,509
"23033","chr19",49799922,49800142,49800032,220
"23034","chr19",10309431,10309766,10309598,335
"23035","chr10",2521547,2523030,2522288,1483
"23036","chr19",9818490,9819818,9819154,1328
"23037","chr12",7439810,7440434,7440122,624
"23038","chr21",44939732,44940508,44940120,776
"23039","chr10",101030020,101030237,101030128,217
"23040","chr9",119368808,119369936,119369372,1128
"23041","chr12",77697,78444,78070,747
"23042","chr13",112343759,112343960,112343859,201
"23043","chr19",58356031,58357502,58356766,1471
"23044","chr22",29729363,29729676,29729519,313
"23045","chr17",39753835,39755150,39754492,1315
"23046","chr19",38222427,38222818,38222622,391
"23047","chr19",18309679,18309926,18309802,247
"23048","chr8",100649443,100649684,100649563,241
"23049","chr11",111514612,111514987,111514799,375
"23050","chr17",76072093,76072675,76072384,582
"23051","chr19",17244372,17246691,17245531,2319
"23052","chr5",172958519,172958909,172958714,390
"23053","chr5",6822952,6823164,6823058,212
"23054","chr5",88678134,88678477,88678305,343
"23055","chr16",15127711,15128345,15128028,634
"23056","chr22",44668279,44669212,44668745,933
"23057","chr7",152435132,152437025,152436078,1893
"23058","chr16",90022507,90023005,90022756,498
"23059","chr19",5802223,5802558,5802390,335
"23060","chr19",39886227,39886496,39886361,269
"23061","chr10",70887894,70888573,70888233,679
"23062","chr8",100212849,100213651,100213250,802
"23063","chr19",57230587,57231089,57230838,502
"23064","chr13",94707387,94707620,94707503,233
"23065","chr16",2904190,2905513,2904851,1323
"23066","chr12",57755068,57755998,57755533,930
"23067","chr17",7465682,7465925,7465803,243
"23068","chr1",40802247,40802726,40802486,479
"23069","chr3",122793638,122793951,122793794,313
"23070","chr16",410245,410778,410511,533
"23071","chr2",160062163,160062666,160062414,503
"23072","chr13",114010590,114011011,114010800,421
"23073","chr11",18396120,18396378,18396249,258
"23074","chr7",159061755,159062276,159062015,521
"23075","chr11",1956922,1957197,1957059,275
"23076","chr17",7856963,7858362,7857662,1399
"23077","chr19",55486409,55486776,55486592,367
"23078","chr9",136431828,136432841,136432334,1013
"23079","chrX",49071977,49072702,49072339,725
"23080","chr10",132663794,132664011,132663902,217
"23081","chr3",57692612,57693211,57692911,599
"23082","chr13",24931975,24932203,24932089,228
"23083","chr8",56447340,56447555,56447447,215
"23084","chr19",8584903,8585640,8585271,737
"23085","chr1",227816126,227816382,227816254,256
"23086","chr19",2807226,2808388,2807807,1162
"23087","chr19",4198020,4198572,4198296,552
"23088","chr12",53995329,53995736,53995532,407
"23089","chr17",81955364,81955585,81955474,221
"23090","chr19",50694826,50695934,50695380,1108
"23091","chr9",133562422,133563020,133562721,598
"23092","chr18",79694279,79694617,79694448,338
"23093","chr1",24555948,24556297,24556122,349
"23094","chr1",34859581,34859949,34859765,368
"23095","chr7",5562811,5563021,5562916,210
"23096","chr12",49089818,49090472,49090145,654
"23097","chr19",15237867,15238196,15238031,329
"23098","chr17",75558743,75559026,75558884,283
"23099","chr16",57734905,57735188,57735046,283
"23100","chr18",78703363,78703678,78703520,315
"23101","chr21",10627369,10627724,10627546,355
"23102","chr2",163348230,163348529,163348379,299
"23103","chr1",75615693,75616680,75616186,987
"23104","chr9",34646589,34647006,34646797,417
"23105","chr11",15941336,15941677,15941506,341
"23106","chr5",7394873,7396547,7395710,1674
"23107","chr5",73446781,73448760,73447770,1979
"23108","chr10",38356184,38356585,38356384,401
"23109","chr19",17520971,17521183,17521077,212
"23110","chr4",2763911,2764336,2764123,425
"23111","chr1",198156766,198157712,198157239,946
"23112","chr18",267710,268382,268046,672
"23113","chrX",68783503,68783770,68783636,267
"23114","chr11",9572799,9574989,9573894,2190
"23115","chr19",639565,640370,639967,805
"23116","chr12",113154398,113154815,113154606,417
"23117","chr6",73394702,73395155,73394928,453
"23118","chr17",43170955,43171346,43171150,391
"23119","chr17",7290278,7290494,7290386,216
"23120","chr19",51703879,51704478,51704178,599
"23121","chr6",170612305,170612687,170612496,382
"23122","chr16",21501533,21502650,21502091,1117
"23123","chr10",50024834,50025050,50024942,216
"23124","chr19",13013755,13013974,13013864,219
"23125","chr13",111921409,111921684,111921546,275
"23126","chr20",33489851,33490663,33490257,812
"23127","chr3",46576817,46577179,46576998,362
"23128","chr15",43593815,43594427,43594121,612
"23129","chr6",99589447,99589668,99589557,221
"23130","chrX",99939336,99939600,99939468,264
"23131","chr2",85602143,85603114,85602628,971
"23132","chr4",705410,706162,705786,752
"23133","chr12",71686009,71686481,71686245,472
"23134","chr18",68714697,68715338,68715017,641
"23135","chr8",143018404,143019176,143018790,772
"23136","chr9",76393721,76394846,76394283,1125
"23137","chr6",89829735,89830235,89829985,500
"23138","chr13",52455059,52455993,52455526,934
"23139","chr22",39664745,39665026,39664885,281
"23140","chr19",5065628,5065908,5065768,280
"23141","chr4",6923484,6923864,6923674,380
"23142","chr13",57629452,57630188,57629820,736
"23143","chr11",113474346,113475606,113474976,1260
"23144","chrX",154466009,154466431,154466220,422
"23145","chr17",82092749,82093005,82092877,256
"23146","chr19",1978371,1979985,1979178,1614
"23147","chr7",76150310,76150704,76150507,394
"23148","chr20",45306559,45306993,45306776,434
"23149","chr19",3933475,3933818,3933646,343
"23150","chr13",18665130,18665778,18665454,648
"23151","chr10",43606365,43606918,43606641,553
"23152","chr17",81483898,81484631,81484264,733
"23153","chr9",137027745,137028995,137028370,1250
"23154","chr1",2029968,2030411,2030189,443
"23155","chr5",141241296,141242130,141241713,834
"23156","chr8",1763684,1764488,1764086,804
"23157","chr17",4639420,4641639,4640529,2219
"23158","chr16",21820161,21820623,21820392,462
"23159","chr5",93587781,93588791,93588286,1010
"23160","chrX",71492199,71492971,71492585,772
"23161","chr9",94259182,94259685,94259433,503
"23162","chr17",4788954,4790682,4789818,1728
"23163","chr1",1115135,1117065,1116100,1930
"23164","chr11",8688820,8689264,8689042,444
"23165","chr21",45478651,45479079,45478865,428
"23166","chr17",50373095,50373304,50373199,209
"23167","chr19",6740658,6741192,6740925,534
"23168","chr17",45019241,45019645,45019443,404
"23169","chr10",46358486,46358709,46358597,223
"23170","chr3",184513513,184514103,184513808,590
"23171","chr19",50791619,50791841,50791730,222
"23172","chr5",1489684,1489956,1489820,272
"23173","chr19",35898643,35899065,35898854,422
"23174","chr20",63962440,63963613,63963026,1173
"23175","chr15",79089524,79091867,79090695,2343
"23176","chr10",99534686,99537946,99536316,3260
"23177","chr19",53102806,53103845,53103325,1039
"23178","chr10",37976147,37976795,37976471,648
"23179","chr13",113030211,113030677,113030444,466
"23180","chr10",132768225,132768575,132768400,350
"23181","chr7",26152075,26153137,26152606,1062
"23182","chr7",151125567,151126300,151125933,733
"23183","chr1",90706545,90707214,90706879,669
"23184","chrX",101191251,101191748,101191499,497
"23185","chr19",5892099,5892461,5892280,362
"23186","chr2",207681358,207681838,207681598,480
"23187","chrX",23667289,23667565,23667427,276
"23188","chr16",32278435,32279374,32278904,939
"23189","chr19",55096687,55097680,55097183,993
"23190","chr19",49166018,49166295,49166156,277
"23191","chr1",6205765,6206718,6206241,953
"23192","chr22",50266977,50268124,50267550,1147
"23193","chr19",2076484,2076983,2076733,499
"23194","chr20",63938444,63939423,63938933,979
"23195","chr1",1927807,1928084,1927945,277
"23196","chr17",1588792,1589028,1588910,236
"23197","chr19",10010074,10010555,10010314,481
"23198","chr9",136451185,136451414,136451299,229
"23199","chr17",42404614,42405255,42404934,641
"23200","chr16",89947842,89948205,89948023,363
"23201","chr19",891531,892150,891840,619
"23202","chr4",110618072,110618327,110618199,255
"23203","chr11",67415494,67415922,67415708,428
"23204","chr18",44744489,44745001,44744745,512
"23205","chr19",18152377,18153831,18153104,1454
"23206","chr2",172172579,172173007,172172793,428
"23207","chr9",21696488,21696755,21696621,267
"23208","chr17",57954482,57955799,57955140,1317
"23209","chr3",42264657,42266028,42265342,1371
"23210","chr4",185623600,185624349,185623974,749
"23211","chr2",118849802,118850334,118850068,532
"23212","chr12",57549879,57550143,57550011,264
"23213","chr2",231483672,231484155,231483913,483
"23214","chr17",76969007,76969221,76969114,214
"23215","chr4",150579611,150580147,150579879,536
"23216","chr7",561484,562092,561788,608
"23217","chr6",36423293,36423669,36423481,376
"23218","chr18",57648498,57648700,57648599,202
"23219","chr1",36124854,36125520,36125187,666
"23220","chr1",62194883,62195274,62195078,391
"23221","chr10",100267342,100267733,100267537,391
"23222","chr19",48969265,48969623,48969444,358
"23223","chr1",26471875,26473351,26472613,1476
"23224","chr19",38395469,38396217,38395843,748
"23225","chr20",63087499,63087739,63087619,240
"23226","chr14",104815494,104816638,104816066,1144
"23227","chr19",4361473,4361781,4361627,308
"23228","chr4",112285676,112286122,112285899,446
"23229","chr20",32456137,32456338,32456237,201
"23230","chr2",127695525,127695872,127695698,347
"23231","chr19",11033299,11033573,11033436,274
"23232","chr9",34664933,34665690,34665311,757
"23233","chr17",3535547,3535752,3535649,205
"23234","chr12",132779837,132780119,132779978,282
"23235","chr4",163331802,163332319,163332060,517
"23236","chr4",1055864,1056135,1055999,271
"23237","chr2",127428521,127428794,127428657,273
"23238","chr10",42836939,42837369,42837154,430
"23239","chr17",8002609,8004127,8003368,1518
"23240","chr19",3699952,3700469,3700210,517
"23241","chr2",131801386,131802041,131801713,655
"23242","chr19",11662248,11662590,11662419,342
"23243","chr13",30617374,30618052,30617713,678
"23244","chr15",63381689,63381961,63381825,272
"23245","chr19",3970538,3970748,3970643,210
"23246","chr8",143245933,143247375,143246654,1442
"23247","chr8",74350286,74350809,74350547,523
"23248","chr1",209827784,209828083,209827933,299
"23249","chr10",132792080,132792884,132792482,804
"23250","chr8",41725617,41726006,41725811,389
"23251","chr19",4304545,4305125,4304835,580
"23252","chr2",130120843,130121227,130121035,384
"23253","chr9",114167724,114168088,114167906,364
"23254","chr11",643879,644377,644128,498
"23255","chr1",166975332,166975932,166975632,600
"23256","chrX",48696578,48697172,48696875,594
"23257","chr13",23695360,23695977,23695668,617
"23258","chr2",131363690,131364189,131363939,499
"23259","chr15",21324508,21325396,21324952,888
"23260","chr12",6057776,6058092,6057934,316
"23261","chr1",32291813,32292433,32292123,620
"23262","chr19",50415412,50415903,50415657,491
"23263","chr22",41345927,41346161,41346044,234
"23264","chr2",209209105,209209570,209209337,465
"23265","chr12",52321016,52321267,52321141,251
"23266","chr7",27184648,27184977,27184812,329
"23267","chr19",1980825,1981089,1980957,264
"23268","chr15",65361739,65361996,65361867,257
"23269","chr19",45952951,45953245,45953098,294
"23270","chr10",94402266,94403570,94402918,1304
"23271","chr8",143266878,143267900,143267389,1022
"23272","chr7",97006269,97006698,97006483,429
"23273","chr19",4682714,4683418,4683066,704
"23274","chr7",670509,670993,670751,484
"23275","chr9",97012816,97013820,97013318,1004
"23276","chr11",47338402,47338665,47338533,263
"23277","chr5",37379164,37379554,37379359,390
"23278","chr7",90245007,90245541,90245274,534
"23279","chr17",1561865,1563018,1562441,1153
"23280","chr16",67530155,67530429,67530292,274
"23281","chr17",8221386,8221870,8221628,484
"23282","chr12",38316590,38316841,38316715,251
"23283","chr13",99990520,99990840,99990680,320
"23284","chr16",69726390,69726603,69726496,213
"23285","chr18",57801824,57804031,57802927,2207
"23286","chr11",63911931,63912166,63912048,235
"23287","chr15",98428261,98428647,98428454,386
"23288","chr15",74373843,74374658,74374250,815
"23289","chr3",48989683,48990923,48990303,1240
"23290","chrX",129540156,129540585,129540370,429
"23291","chr19",38769734,38771991,38770862,2257
"23292","chr16",90106296,90106517,90106406,221
"23293","chr2",129992531,129992851,129992691,320
"23294","chr6",89887488,89887934,89887711,446
"23295","chr10",3106214,3106433,3106323,219
"23296","chr17",82374306,82375795,82375050,1489
"23297","chr6",139134900,139135979,139135439,1079
"23298","chr16",30193374,30195058,30194216,1684
"23299","chr15",96366586,96366801,96366693,215
"23300","chr4",1593566,1593812,1593689,246
"23301","chr4",152779387,152780339,152779863,952
"23302","chr17",80962811,80963025,80962918,214
"23303","chr6",73523545,73523823,73523684,278
"23304","chr3",158644391,158644689,158644540,298
"23305","chr19",21851592,21852141,21851866,549
"23306","chr9",137188013,137189401,137188707,1388
"23307","chr2",99489081,99490696,99489888,1615
"23308","chr20",63919360,63920170,63919765,810
"23309","chr4",47706426,47706695,47706560,269
"23310","chr6",43262872,43263326,43263099,454
"23311","chr1",47994140,47994389,47994264,249
"23312","chr7",908657,909531,909094,874
"23313","chr5",139795319,139796587,139795953,1268
"23314","chr1",1013949,1014471,1014210,522
"23315","chr1",206635178,206635842,206635510,664
"23316","chr5",79235708,79237672,79236690,1964
"23317","chr4",44678326,44678724,44678525,398
"23318","chr12",53268144,53268645,53268394,501
"23319","chr6",83707878,83709659,83708768,1781
"23320","chr9",135247661,135247881,135247771,220
"23321","chr20",31723262,31724069,31723665,807
"23322","chr11",1194149,1195241,1194695,1092
"23323","chr2",74421385,74422292,74421838,907
"23324","chr3",28348484,28349364,28348924,880
"23325","chr8",143368206,143369387,143368796,1181
"23326","chr20",1118435,1118918,1118676,483
"23327","chrX",53441631,53442076,53441853,445
"23328","chr8",675114,676802,675958,1688
"23329","chr19",45011905,45012302,45012103,397
"23330","chrX",72713712,72714417,72714064,705
"23331","chr11",117481976,117482246,117482111,270
"23332","chrX",47637783,47637994,47637888,211
"23333","chr9",97220928,97222677,97221802,1749
"23334","chr11",67266204,67267189,67266696,985
"23335","chr11",9264726,9265544,9265135,818
"23336","chr13",24638242,24638485,24638363,243
"23337","chr3",184259760,184262845,184261302,3085
"23338","chr16",89002186,89003063,89002624,877
"23339","chr7",1057769,1058317,1058043,548
"23340","chr7",157411654,157411893,157411773,239
"23341","chr11",67284923,67285639,67285281,716
"23342","chr17",2724007,2725008,2724507,1001
"23343","chr20",57524875,57525194,57525034,319
"23344","chr14",36505343,36506220,36505781,877
"23345","chr17",49568003,49568471,49568237,468
"23346","chr17",79940840,79941083,79940961,243
"23347","chr20",63560028,63560274,63560151,246
"23348","chr12",114408770,114409845,114409307,1075
"23349","chr16",34050115,34051243,34050679,1128
"23350","chr1",26164031,26164557,26164294,526
"23351","chr6",170610030,170610317,170610173,287
"23352","chr17",15917306,15918011,15917658,705
"23353","chr1",100213210,100213542,100213376,332
"23354","chr22",30542029,30542658,30542343,629
"23355","chr10",27252368,27252837,27252602,469
"23356","chr10",96750461,96750670,96750565,209
"23357","chr19",49670123,49670496,49670309,373
"23358","chr10",101830529,101830870,101830699,341
"23359","chr2",26562246,26562819,26562532,573
"23360","chr10",117132650,117133128,117132889,478
"23361","chr12",4243756,4244063,4243909,307
"23362","chr2",241636291,241638148,241637219,1857
"23363","chr1",145964416,145964848,145964632,432
"23364","chr5",157651319,157652556,157651937,1237
"23365","chr19",1577468,1578510,1577989,1042
"23366","chr9",93133725,93134734,93134229,1009
"23367","chr3",138960402,138960737,138960569,335
"23368","chr16",1259156,1259414,1259285,258
"23369","chr2",95991738,95992748,95992243,1010
"23370","chr17",41757464,41757774,41757619,310
"23371","chr13",114043775,114044626,114044200,851
"23372","chr10",58384963,58385575,58385269,612
"23373","chr10",132425373,132425778,132425575,405
"23374","chr2",42809838,42811424,42810631,1586
"23375","chr12",120212411,120212725,120212568,314
"23376","chr17",3636024,3637190,3636607,1166
"23377","chr17",42019913,42020263,42020088,350
"23378","chr3",8990573,8990835,8990704,262
"23379","chr4",131975205,131975729,131975467,524
"23380","chr3",96776773,96777138,96776955,365
"23381","chr3",184572805,184573095,184572950,290
"23382","chr9",130693695,130694064,130693879,369
"23383","chr19",2428351,2428733,2428542,382
"23384","chr4",536059,536260,536159,201
"23385","chr18",78309222,78309699,78309460,477
"23386","chr5",177332070,177332360,177332215,290
"23387","chr12",132592360,132592605,132592482,245
"23388","chr22",46631469,46632013,46631741,544
"23389","chr5",74766741,74767400,74767070,659
"23390","chr16",18384422,18388684,18386553,4262
"23391","chr19",11346068,11346575,11346321,507
"23392","chr4",158671465,158672435,158671950,970
"23393","chr10",100670940,100671362,100671151,422
"23394","chr2",241816063,241816404,241816233,341
"23395","chr11",65404898,65405125,65405011,227
"23396","chr10",26566977,26567353,26567165,376
"23397","chr19",3036218,3036620,3036419,402
"23398","chr13",27919864,27921962,27920913,2098
"23399","chr19",7615316,7615710,7615513,394
"23400","chr9",110255465,110257017,110256241,1552
"23401","chr18",78637483,78638378,78637930,895
"23402","chr10",116125302,116125518,116125410,216
"23403","chr7",73855604,73855902,73855753,298
"23404","chr9",19127181,19127882,19127531,701
"23405","chrX",111681075,111682047,111681561,972
"23406","chr2",44934288,44934545,44934416,257
"23407","chr22",17638514,17639243,17638878,729
"23408","chr16",817032,817833,817432,801
"23409","chr22",42581722,42582061,42581891,339
"23410","chr22",40789193,40789412,40789302,219
"23411","chr22",41395765,41396138,41395951,373
"23412","chr1",144560844,144561241,144561042,397
"23413","chr1",244969999,244971409,244970704,1410
"23414","chr5",115961910,115962396,115962153,486
"23415","chr1",203273391,203273690,203273540,299
"23416","chr17",80963359,80964596,80963977,1237
"23417","chr6",126643503,126643842,126643672,339
"23418","chr10",133215734,133216001,133215867,267
"23419","chr5",141421193,141421505,141421349,312
"23420","chrX",153829491,153830882,153830186,1391
"23421","chr1",66930000,66930800,66930400,800
"23422","chr5",178187101,178187459,178187280,358
"23423","chr9",126671487,126671691,126671589,204
"23424","chr7",73557230,73557783,73557506,553
"23425","chrX",112081854,112082074,112081964,220
"23426","chr15",26670042,26670606,26670324,564
"23427","chr8",98973505,98974755,98974130,1250
"23428","chr8",142533315,142533549,142533432,234
"23429","chr7",1769400,1769724,1769562,324
"23430","chr5",141407880,141408477,141408178,597
"23431","chr21",36245169,36245574,36245371,405
"23432","chr6",34889049,34889887,34889468,838
"23433","chr5",12794860,12795535,12795197,675
"23434","chr1",212558326,212559115,212558720,789
"23435","chr8",66439052,66439604,66439328,552
"23436","chr12",124388695,124389349,124389022,654
"23437","chrY",17518337,17518598,17518467,261
"23438","chr12",53994041,53994628,53994334,587
"23439","chr11",1034834,1035146,1034990,312
"23440","chr19",6534748,6535068,6534908,320
"23441","chr19",49527724,49528011,49527867,287
"23442","chr9",112750331,112751477,112750904,1146
"23443","chr8",1155614,1156066,1155840,452
"23444","chr3",150703396,150704092,150703744,696
"23445","chr1",32351114,32351987,32351550,873
"23446","chr17",19112133,19112383,19112258,250
"23447","chr1",110083906,110084862,110084384,956
"23448","chr16",88903956,88904191,88904073,235
"23449","chr3",62370444,62370703,62370573,259
"23450","chr16",3496366,3496769,3496567,403
"23451","chr9",129597203,129597782,129597492,579
"23452","chr9",124861278,124862207,124861742,929
"23453","chr20",21509552,21510047,21509799,495
"23454","chr1",156368967,156369460,156369213,493
"23455","chr19",35300126,35300386,35300256,260
"23456","chr20",40692649,40693007,40692828,358
"23457","chr1",144415697,144415979,144415838,282
"23458","chr11",858575,859550,859062,975
"23459","chr17",59964485,59964738,59964611,253
"23460","chr1",3891926,3892672,3892299,746
"23461","chr9",124045600,124045902,124045751,302
"23462","chr17",47831418,47831701,47831559,283
"23463","chr17",28227218,28227992,28227605,774
"23464","chr20",17568983,17569406,17569194,423
"23465","chr19",6392865,6393871,6393368,1006
"23466","chr12",116880988,116881716,116881352,728
"23467","chr17",45120910,45121406,45121158,496
"23468","chr13",106534120,106536676,106535398,2556
"23469","chr10",15213055,15213288,15213171,233
"23470","chr7",156942551,156942971,156942761,420
"23471","chrY",24812733,24813115,24812924,382
"23472","chr5",139273631,139274162,139273896,531
"23473","chr10",124610503,124610724,124610613,221
"23474","chr1",166875759,166876536,166876147,777
"23475","chr8",144056394,144056661,144056527,267
"23476","chr11",494853,495156,495004,303
"23477","chr9",135485917,135486126,135486021,209
"23478","chr18",78517579,78517827,78517703,248
"23479","chr1",17005390,17005598,17005494,208
"23480","chr7",35967401,35968544,35967972,1143
"23481","chr1",27830710,27831277,27830993,567
"23482","chr1",202966917,202967499,202967208,582
"23483","chr1",26233958,26234537,26234247,579
"23484","chr20",46709651,46710024,46709837,373
"23485","chr22",49777021,49777303,49777162,282
"23486","chr4",122826585,122827825,122827205,1240
"23487","chr15",75688957,75689259,75689108,302
"23488","chr16",29466068,29467181,29466624,1113
"23489","chr22",15777255,15777813,15777534,558
"23490","chr20",62373438,62373851,62373644,413
"23491","chr7",149104117,149104982,149104549,865
"23492","chr20",63696660,63697205,63696932,545
"23493","chr6",144186689,144187560,144187124,871
"23494","chr9",99906634,99907191,99906912,557
"23495","chr1",1954905,1955431,1955168,526
"23496","chr15",55407942,55408608,55408275,666
"23497","chr19",48194643,48195412,48195027,769
"23498","chr7",73327801,73328707,73328254,906
"23499","chr15",89360215,89360489,89360352,274
"23500","chr13",52333968,52334370,52334169,402
"23501","chr17",78458901,78459191,78459046,290
"23502","chr1",42887570,42887771,42887670,201
"23503","chr6",37044833,37045108,37044970,275
"23504","chr1",3595145,3595554,3595349,409
"23505","chr1",206684881,206686306,206685593,1425
"23506","chr6",24357491,24358081,24357786,590
"23507","chr12",112381662,112382685,112382173,1023
"23508","chr1",223393300,223393926,223393613,626
"23509","chr1",145885750,145886256,145886003,506
"23510","chr1",110338320,110340178,110339249,1858
"23511","chr1",114854827,114855321,114855074,494
"23512","chr16",960335,962198,961266,1863
"23513","chr1",200911465,200912142,200911803,677
"23514","chr10",122163335,122164027,122163681,692
"23515","chr22",15819945,15822209,15821077,2264
"23516","chrX",136300298,136300503,136300400,205
"23517","chr15",75201641,75202990,75202315,1349
"23518","chr21",41810102,41810360,41810231,258
"23519","chr19",2610949,2611466,2611207,517
"23520","chr1",43304851,43305209,43305030,358
"23521","chr12",53219932,53221926,53220929,1994
"23522","chr11",68854640,68854871,68854755,231
"23523","chr9",113221139,113221778,113221458,639
"23524","chr20",11686874,11687349,11687111,475
"23525","chrX",71283411,71284113,71283762,702
"23526","chr2",240557159,240558183,240557671,1024
"23527","chr2",241724792,241725739,241725265,947
"23528","chr13",113016615,113016877,113016746,262
"23529","chr2",85561288,85561616,85561452,328
"23530","chr15",45402212,45403596,45402904,1384
"23531","chr7",122299952,122300594,122300273,642
"23532","chr18",9707755,9709314,9708534,1559
"23533","chr11",64637979,64638534,64638256,555
"23534","chr16",31105780,31106114,31105947,334
"23535","chrX",3873582,3874181,3873881,599
"23536","chr9",113376674,113377408,113377041,734
"23537","chr1",19273755,19274448,19274101,693
"23538","chr1",98053445,98054427,98053936,982
"23539","chr9",114049058,114050109,114049583,1051
"23540","chr1",202214065,202214535,202214300,470
"23541","chr9",126914633,126915730,126915181,1097
"23542","chr15",73442981,73443268,73443124,287
"23543","chr17",1228453,1230073,1229263,1620
"23544","chr4",190018646,190019436,190019041,790
"23545","chr6",170455435,170455677,170455556,242
"23546","chr2",41841223,41841454,41841338,231
"23547","chr17",83011872,83012284,83012078,412
"23548","chr4",121870045,121870680,121870362,635
"23549","chr8",73293988,73295944,73294966,1956
"23550","chr5",134648481,134649304,134648892,823
"23551","chrX",9785526,9787061,9786293,1535
"23552","chr16",67648072,67650021,67649046,1949
"23553","chr13",24680255,24680955,24680605,700
"23554","chr5",36745229,36745480,36745354,251
"23555","chr19",14248823,14249160,14248991,337
"23556","chr9",121369779,121370817,121370298,1038
"23557","chr18",57427593,57429078,57428335,1485
"23558","chr19",4217421,4218071,4217746,650
"23559","chr16",1437016,1437259,1437137,243
"23560","chr11",64607346,64608294,64607820,948
"23561","chr20",63640938,63642511,63641724,1573
"23562","chr1",11762082,11762306,11762194,224
"23563","chr19",11262003,11262450,11262226,447
"23564","chr12",111363030,111363440,111363235,410
"23565","chr16",854416,854669,854542,253
"23566","chr11",890191,890506,890348,315
"23567","chr18",23662402,23663010,23662706,608
"23568","chr4",157076014,157076534,157076274,520
"23569","chr17",38578412,38578993,38578702,581
"23570","chr7",937011,937258,937134,247
"23571","chr7",27239326,27239850,27239588,524
"23572","chr3",43286206,43286714,43286460,508
"23573","chr5",149345325,149345762,149345543,437
"23574","chr9",4117825,4118594,4118209,769
"23575","chr17",28405157,28405373,28405265,216
"23576","chr6",110476094,110476998,110476546,904
"23577","chr5",880865,881162,881013,297
"23578","chr16",874514,874835,874674,321
"23579","chr22",42289888,42290089,42289988,201
"23580","chr4",1512457,1512793,1512625,336
"23581","chr11",448068,448316,448192,248
"23582","chr20",9507028,9507242,9507135,214
"23583","chr12",4164653,4165325,4164989,672
"23584","chr1",6199118,6199823,6199470,705
"23585","chr1",200041497,200041704,200041600,207
"23586","chr9",21974989,21975307,21975148,318
"23587","chrX",46758578,46759534,46759056,956
"23588","chr17",42798456,42798884,42798670,428
"23589","chr19",55178814,55180255,55179534,1441
"23590","chr9",132409923,132410579,132410251,656
"23591","chrX",102745761,102746630,102746195,869
"23592","chr17",82860722,82860927,82860824,205
"23593","chr16",922586,923087,922836,501
"23594","chr9",126682991,126683274,126683132,283
"23595","chr9",131841897,131842207,131842052,310
"23596","chr8",5122795,5123424,5123109,629
"23597","chr2",88170172,88170867,88170519,695
"23598","chr12",132271054,132271369,132271211,315
"23599","chr13",52405864,52406451,52406157,587
"23600","chr11",67353385,67353757,67353571,372
"23601","chr17",16584336,16584570,16584453,234
"23602","chr2",25252837,25253059,25252948,222
"23603","chr11",134762151,134763093,134762622,942
"23604","chr5",123089210,123091141,123090175,1931
"23605","chr12",123671031,123671624,123671327,593
"23606","chr2",206159186,206160257,206159721,1071
"23607","chr19",9498128,9498667,9498397,539
"23608","chr9",109119202,109119998,109119600,796
"23609","chr12",104137396,104138761,104138078,1365
"23610","chr21",45986947,45988542,45987744,1595
"23611","chrX",153793820,153795102,153794461,1282
"23612","chr8",143870446,143871220,143870833,774
"23613","chr9",35096155,35096676,35096415,521
"23614","chr2",130391018,130391843,130391430,825
"23615","chrX",3712691,3713921,3713306,1230
"23616","chr13",20998658,20999321,20998989,663
"23617","chr7",90154253,90154767,90154510,514
"23618","chr3",53845611,53846804,53846207,1193
"23619","chr10",86536413,86536862,86536637,449
"23620","chr3",54120704,54120943,54120823,239
"23621","chr22",18369414,18370679,18370046,1265
"23622","chr9",97076925,97077739,97077332,814
"23623","chr13",30803008,30803356,30803182,348
"23624","chr16",89579770,89581382,89580576,1612
"23625","chr1",68051571,68051791,68051681,220
"23626","chr1",121118208,121118586,121118397,378
"23627","chr2",239690635,239690850,239690742,215
"23628","chr10",93071755,93072555,93072155,800
"23629","chr7",1311828,1312268,1312048,440
"23630","chr9",92669530,92670389,92669959,859
"23631","chr9",131739313,131740286,131739799,973
"23632","chr2",97094447,97095019,97094733,572
"23633","chr13",39038280,39038793,39038536,513
"23634","chr1",166947628,166947978,166947803,350
"23635","chr5",180494201,180495179,180494690,978
"23636","chr9",89318369,89318992,89318680,623
"23637","chr2",130570703,130571447,130571075,744
"23638","chr10",1242088,1242359,1242223,271
"23639","chrX",13734322,13735217,13734769,895
"23640","chr11",32427820,32428093,32427956,273
"23641","chr6",15247935,15248811,15248373,876
"23642","chr21",45265200,45265464,45265332,264
"23643","chr7",1868903,1869167,1869035,264
"23644","chr4",3473331,3473738,3473534,407
"23645","chr19",47418994,47419520,47419257,526
"23646","chr11",130208278,130208772,130208525,494
"23647","chr2",91744879,91745170,91745024,291
"23648","chr22",15784864,15785308,15785086,444
"23649","chr1",1460705,1460958,1460831,253
"23650","chr16",14921274,14921527,14921400,253
"23651","chr7",158996795,158997328,158997061,533
"23652","chr2",171522312,171523679,171522995,1367
"23653","chr17",30731390,30731891,30731640,501
"23654","chr10",96720275,96720730,96720502,455
"23655","chr6",170553036,170553392,170553214,356
"23656","chr20",21102860,21103206,21103033,346
"23657","chr10",726353,726774,726563,421
"23658","chr1",10866898,10867422,10867160,524
"23659","chr8",142449459,142449667,142449563,208
"23660","chr14",33950302,33951232,33950767,930
"23661","chr1",31937681,31938781,31938231,1100
"23662","chr14",23285912,23286247,23286079,335
"23663","chr1",1348553,1351571,1350062,3018
"23664","chr22",49848087,49850270,49849178,2183
"23665","chr1",160098250,160098640,160098445,390
"23666","chr1",229625381,229626552,229625966,1171
"23667","chr15",20581442,20582812,20582127,1370
"23668","chr4",656489,657325,656907,836
"23669","chr1",29236233,29238795,29237514,2562
"23670","chr21",36980556,36980818,36980687,262
"23671","chr19",55647891,55648571,55648231,680
"23672","chr17",60149880,60150359,60150119,479
"23673","chr5",177402338,177402755,177402546,417
"23674","chr4",76585924,76586186,76586055,262
"23675","chr15",40290996,40291588,40291292,592
"23676","chr1",18109072,18109410,18109241,338
"23677","chr4",720551,720791,720671,240
"23678","chr2",231514237,231514955,231514596,718
"23679","chr7",74289483,74289797,74289640,314
"23680","chr9",74498793,74499011,74498902,218
"23681","chr14",19372812,19373486,19373149,674
"23682","chr9",129488187,129488844,129488515,657
"23683","chrX",49079776,49080317,49080046,541
"23684","chrX",133984933,133985498,133985215,565
"23685","chr1",228216447,228216696,228216571,249
"23686","chr1",153727740,153728025,153727882,285
"23687","chr15",76346131,76347482,76346806,1351
"23688","chr16",2105866,2106883,2106374,1017
"23689","chr10",100724023,100724719,100724371,696
"23690","chr16",85640595,85640901,85640748,306
"23691","chr10",133284012,133284297,133284154,285
"23692","chr19",46412054,46412545,46412299,491
"23693","chr8",143317654,143318044,143317849,390
"23694","chr8",141429583,141430447,141430015,864
"23695","chr5",177984341,177984938,177984639,597
"23696","chr14",91947237,91947980,91947608,743
"23697","chr19",3820101,3820306,3820203,205
"23698","chr6",44286160,44286413,44286286,253
"23699","chr14",57864958,57866403,57865680,1445
"23700","chr12",19306323,19306771,19306547,448
"23701","chr1",21439779,21440731,21440255,952
"23702","chr4",165327302,165327911,165327606,609
"23703","chrX",72680604,72680877,72680740,273
"23704","chr19",2513217,2513698,2513457,481
"23705","chr5",141384734,141385113,141384923,379
"23706","chr14",35121920,35122797,35122358,877
"23707","chr17",28902457,28903160,28902808,703
"23708","chr17",80815790,80816032,80815911,242
"23709","chr18",23619467,23619834,23619650,367
"23710","chr19",14480220,14480496,14480358,276
"23711","chr11",64287695,64287916,64287805,221
"23712","chr4",1805390,1805860,1805625,470
"23713","chr19",37855168,37855520,37855344,352
"23714","chr16",30895704,30895937,30895820,233
"23715","chr19",1020512,1021396,1020954,884
"23716","chr7",1987329,1987733,1987531,404
"23717","chrY",18326367,18326671,18326519,304
"23718","chr19",2761667,2761911,2761789,244
"23719","chr6",36962061,36962359,36962210,298
"23720","chr17",302326,302647,302486,321
"23721","chr1",1200980,1201776,1201378,796
"23722","chr10",1173206,1173487,1173346,281
"23723","chr19",35939580,35940499,35940039,919
"23724","chr20",47501684,47502313,47501998,629
"23725","chr15",22664299,22665146,22664722,847
"23726","chr19",41089990,41090235,41090112,245
"23727","chr19",2524730,2525462,2525096,732
"23728","chr17",76239677,76241130,76240403,1453
"23729","chr10",99619951,99621688,99620819,1737
"23730","chr10",110225805,110227456,110226630,1651
"23731","chr2",91588758,91589916,91589337,1158
"23732","chr9",77016052,77016833,77016442,781
"23733","chr2",60756058,60756735,60756396,677
"23734","chr20",64327620,64328160,64327890,540
"23735","chr20",61282881,61283469,61283175,588
"23736","chr22",15855039,15855310,15855174,271
"23737","chr1",15849334,15849622,15849478,288
"23738","chr11",62839069,62839648,62839358,579
"23739","chr10",3103727,3104014,3103870,287
"23740","chr15",31397297,31397504,31397400,207
"23741","chr14",76491522,76491731,76491626,209
"23742","chrY",9336526,9336834,9336680,308
"23743","chr13",95641352,95642349,95641850,997
"23744","chr1",16758916,16760479,16759697,1563
"23745","chr22",45922813,45923207,45923010,394
"23746","chr7",157418866,157419111,157418988,245
"23747","chr14",90541360,90541565,90541462,205
"23748","chr14",24136015,24136551,24136283,536
"23749","chr2",176156996,176157449,176157222,453
"23750","chr9",133225412,133225726,133225569,314
"23751","chr5",151020439,151020800,151020619,361
"23752","chr5",135489241,135489534,135489387,293
"23753","chr17",72640377,72640815,72640596,438
"23754","chr21",46033435,46033989,46033712,554
"23755","chr9",127877459,127877864,127877661,405
"23756","chr10",131625681,131626159,131625920,478
"23757","chr17",81285482,81285737,81285609,255
"23758","chr9",126860332,126861295,126860813,963
"23759","chr11",57741258,57742097,57741677,839
"23760","chr17",4806719,4807500,4807109,781
"23761","chr1",177170984,177171187,177171085,203
"23762","chr5",1444563,1446431,1445497,1868
"23763","chrX",74304084,74304290,74304187,206
"23764","chr7",99012046,99012436,99012241,390
"23765","chr21",34791847,34792637,34792242,790
"23766","chr1",145607838,145608571,145608204,733
"23767","chr14",64549798,64550191,64549994,393
"23768","chr5",1064017,1064353,1064185,336
"23769","chr19",37779639,37779977,37779808,338
"23770","chr17",80214518,80214772,80214645,254
"23771","chr9",61861894,61862097,61861995,203
"23772","chr13",48232846,48233812,48233329,966
"23773","chr1",173824150,173824957,173824553,807
"23774","chr8",95073041,95073519,95073280,478
"23775","chr3",192514283,192515348,192514815,1065
"23776","chr11",66480129,66480752,66480440,623
"23777","chr12",132480183,132480519,132480351,336
"23778","chr15",45112571,45113284,45112927,713
"23779","chr1",10472120,10472743,10472431,623
"23780","chrX",102651073,102652089,102651581,1016
"23781","chr12",63779668,63780458,63780063,790
"23782","chr5",1087418,1087794,1087606,376
"23783","chr19",37270508,37270914,37270711,406
"23784","chr16",32241248,32241467,32241357,219
"23785","chr4",49524373,49524669,49524521,296
"23786","chr16",58684405,58684799,58684602,394
"23787","chr20",18466785,18467697,18467241,912
"23788","chr11",77046005,77046236,77046120,231
"23789","chr11",75428409,75428772,75428590,363
"23790","chr3",185937268,185938241,185937754,973
"23791","chr1",184754118,184755304,184754711,1186
"23792","chr14",104883840,104885102,104884471,1262
"23793","chr9",11618264,11618588,11618426,324
"23794","chr1",1324263,1325255,1324759,992
"23795","chr21",45257804,45258009,45257906,205
"23796","chr17",7462604,7462911,7462757,307
"23797","chr17",17383650,17384058,17383854,408
"23798","chr10",117553255,117554052,117553653,797
"23799","chr7",157525532,157525807,157525669,275
"23800","chr14",105142622,105143136,105142879,514
"23801","chr9",120894472,120894811,120894641,339
"23802","chr9",35828740,35829414,35829077,674
"23803","chr1",18645235,18645603,18645419,368
"23804","chr1",109426026,109426948,109426487,922
"23805","chr3",48210581,48210880,48210730,299
"23806","chr8",120124860,120125090,120124975,230
"23807","chr16",696873,697137,697005,264
"23808","chr8",26050185,26050403,26050294,218
"23809","chr7",571595,571965,571780,370
"23810","chr1",1966142,1966347,1966244,205
"23811","chr13",95433793,95434022,95433907,229
"23812","chr2",131039789,131040515,131040152,726
"23813","chr12",132438782,132439049,132438915,267
"23814","chr19",3456184,3456583,3456383,399
"23815","chr17",82443768,82443982,82443875,214
"23816","chr1",121008630,121010051,121009340,1421
"23817","chr3",49689542,49689907,49689724,365
"23818","chr11",65546372,65546984,65546678,612
"23819","chr9",97922216,97922769,97922492,553
"23820","chr11",1929123,1929428,1929275,305
"23821","chr15",84421372,84422346,84421859,974
"23822","chr10",117734982,117735480,117735231,498
"23823","chr7",57016488,57016698,57016593,210
"23824","chr5",45695292,45696408,45695850,1116
"23825","chr1",32539399,32540138,32539768,739
"23826","chr19",3762657,3763111,3762884,454
"23827","chr19",49641821,49642507,49642164,686
"23828","chr17",36945984,36946272,36946128,288
"23829","chr14",19361970,19362359,19362164,389
"23830","chr19",10295248,10295722,10295485,474
"23831","chr14",38209040,38211732,38210386,2692
"23832","chr19",42242162,42243166,42242664,1004
"23833","chr8",47960715,47961347,47961031,632
"23834","chr17",82272783,82273944,82273363,1161
"23835","chr6",166955951,166956895,166956423,944
"23836","chr5",88674142,88676252,88675197,2110
"23837","chr11",22341316,22341831,22341573,515
"23838","chr19",1152016,1152250,1152133,234
"23839","chr6",26272242,26272468,26272355,226
"23840","chr11",6390116,6390683,6390399,567
"23841","chr19",2120874,2121168,2121021,294
"23842","chr19",18785705,18786013,18785859,308
"23843","chr7",157483632,157483862,157483747,230
"23844","chr2",110071884,110072226,110072055,342
"23845","chr11",102317448,102317709,102317578,261
"23846","chr17",60135481,60135832,60135656,351
"23847","chr9",33510860,33511223,33511041,363
"23848","chr5",70049539,70049994,70049766,455
"23849","chr6",5995952,5996253,5996102,301
"23850","chr13",112818109,112818354,112818231,245
"23851","chr14",89954556,89954831,89954693,275
"23852","chr10",133131007,133131288,133131147,281
"23853","chr6",4135989,4136226,4136107,237
"23854","chr22",41976479,41977295,41976887,816
"23855","chr15",84631258,84631556,84631407,298
"23856","chr9",41359451,41359801,41359626,350
"23857","chr19",3958494,3959814,3959154,1320
"23858","chr9",136438387,136440049,136439218,1662
"23859","chr1",25239968,25240220,25240094,252
"23860","chr19",736135,736426,736280,291
"23861","chr19",19120977,19121212,19121094,235
"23862","chr19",52786335,52786959,52786647,624
"23863","chr17",21041886,21042320,21042103,434
"23864","chr16",90077275,90077673,90077474,398
"23865","chr22",46331481,46331806,46331643,325
"23866","chr19",56097422,56097734,56097578,312
"23867","chr22",48646559,48646820,48646689,261
"23868","chr5",132655862,132656612,132656237,750
"23869","chr14",100825706,100826372,100826039,666
"23870","chr22",46859017,46860528,46859772,1511
"23871","chr19",8399743,8400117,8399930,374
"23872","chr17",47708704,47709556,47709130,852
"23873","chr10",95656103,95656969,95656536,866
"23874","chr2",206443424,206444183,206443803,759
"23875","chr1",200039264,200039919,200039591,655
"23876","chr16",1420501,1421163,1420832,662
"23877","chr19",5231251,5231593,5231422,342
"23878","chr19",6590329,6591061,6590695,732
"23879","chr15",77903944,77904203,77904073,259
"23880","chr19",1822340,1822639,1822489,299
"23881","chr1",1087763,1087967,1087865,204
"23882","chr1",153658589,153658893,153658741,304
"23883","chr11",64251441,64251905,64251673,464
"23884","chr19",3767173,3767453,3767313,280
"23885","chr7",6008765,6009624,6009194,859
"23886","chr18",5294738,5294942,5294840,204
"23887","chr19",41939868,41941103,41940485,1235
"23888","chr20",21713834,21714706,21714270,872
"23889","chr7",75358722,75359652,75359187,930
"23890","chr19",23203847,23204267,23204057,420
"23891","chr19",4580457,4581895,4581176,1438
"23892","chr14",105271822,105272327,105272074,505
"23893","chr9",97803473,97803897,97803685,424
"23894","chr19",55284102,55284452,55284277,350
"23895","chr19",58538411,58538937,58538674,526
"23896","chr9",134325216,134327122,134326169,1906
"23897","chr19",2772813,2773932,2773372,1119
"23898","chr19",17973826,17974264,17974045,438
"23899","chr22",46374536,46374974,46374755,438
"23900","chr17",60119513,60121136,60120324,1623
"23901","chr14",24094047,24094677,24094362,630
"23902","chr19",12945644,12946311,12945977,667
"23903","chr19",11059874,11060161,11060017,287
"23904","chr22",25404587,25405635,25405111,1048
"23905","chr15",83206896,83208327,83207611,1431
"23906","chr2",3284103,3284457,3284280,354
"23907","chr2",238435760,238435986,238435873,226
"23908","chr6",100457568,100457821,100457694,253
"23909","chr7",6607253,6608325,6607789,1072
"23910","chr19",46022788,46023076,46022932,288
"23911","chr19",3398630,3398937,3398783,307
"23912","chr3",100260656,100261194,100260925,538
"23913","chr10",7367596,7367822,7367709,226
"23914","chr11",69918852,69919109,69918980,257
"23915","chr10",92591599,92591858,92591728,259
"23916","chr19",3810780,3811197,3810988,417
"23917","chr9",92913263,92913491,92913377,228
"23918","chr3",195619081,195619437,195619259,356
"23919","chr10",100715519,100715822,100715670,303
"23920","chr1",866595,866958,866776,363
"23921","chr6",169723420,169725232,169724326,1812
"23922","chr20",5315620,5317152,5316386,1532
"23923","chr19",48511354,48511565,48511459,211
"23924","chr10",103917797,103918607,103918202,810
"23925","chr19",49555619,49556918,49556268,1299
"23926","chr19",4891179,4891413,4891296,234
"23927","chr10",125775587,125775816,125775701,229
"23928","chr9",93095421,93096850,93096135,1429
"23929","chr22",26428988,26429714,26429351,726
"23930","chr16",89004238,89004496,89004367,258
"23931","chr11",64802776,64803429,64803102,653
"23932","chr16",18348488,18348785,18348636,297
"23933","chr19",39445291,39445998,39445644,707
"23934","chr2",63058814,63059367,63059090,553
"23935","chr9",134153473,134153748,134153610,275
"23936","chr2",241049747,241050044,241049895,297
"23937","chr19",1028320,1028642,1028481,322
"23938","chr14",49688036,49688521,49688278,485
"23939","chr5",1085025,1085732,1085378,707
"23940","chr7",100893241,100893582,100893411,341
"23941","chr3",184379905,184380871,184380388,966
"23942","chr3",75579697,75580480,75580088,783
"23943","chr22",48678862,48679728,48679295,866
"23944","chr19",310258,310582,310420,324
"23945","chr15",80059560,80060308,80059934,748
"23946","chr12",45991824,45992104,45991964,280
"23947","chr7",5083255,5083533,5083394,278
"23948","chr9",136498737,136499408,136499072,671
"23949","chr6",106325312,106325928,106325620,616
"23950","chr19",38790727,38793022,38791874,2295
"23951","chr1",3510791,3511119,3510955,328
"23952","chr19",47544539,47545905,47545222,1366
"23953","chr11",123301746,123302396,123302071,650
"23954","chrX",154460252,154460520,154460386,268
"23955","chr1",153945896,153946858,153946377,962
"23956","chr11",65525096,65525469,65525282,373
"23957","chr19",551290,551542,551416,252
"23958","chrX",71532788,71533115,71532951,327
"23959","chr4",673484,674937,674210,1453
"23960","chr11",90051735,90052759,90052247,1024
"23961","chr20",1894317,1895551,1894934,1234
"23962","chr6",7986100,7986614,7986357,514
"23963","chr19",1094798,1095650,1095224,852
"23964","chrX",43656077,43656433,43656255,356
"23965","chr17",5438905,5439311,5439108,406
"23966","chr9",136760445,136760702,136760573,257
"23967","chr21",34375027,34375823,34375425,796
"23968","chr19",40714981,40715300,40715140,319
"23969","chr19",13808851,13809262,13809056,411
"23970","chr16",58000043,58000955,58000499,912
"23971","chrX",154332685,154333011,154332848,326
"23972","chr7",5144247,5144592,5144419,345
"23973","chr19",1947722,1948043,1947882,321
"23974","chr19",36972828,36973704,36973266,876
"23975","chr13",19601826,19602626,19602226,800
"23976","chr9",127916841,127917333,127917087,492
"23977","chr20",61544451,61544656,61544553,205
"23978","chrY",14524410,14525111,14524760,701
"23979","chr7",57004244,57004679,57004461,435
"23980","chr19",36014298,36014579,36014438,281
"23981","chr4",127781675,127783060,127782367,1385
"23982","chr19",15471794,15472094,15471944,300
"23983","chr7",155453695,155455017,155454356,1322
"23984","chr1",20696446,20696696,20696571,250
"23985","chr16",1171808,1172208,1172008,400
"23986","chr1",8343637,8344042,8343839,405
"23987","chr9",135301638,135301959,135301798,321
"23988","chr11",46332541,46333640,46333090,1099
"23989","chr8",143250195,143250573,143250384,378
"23990","chr14",105449184,105449594,105449389,410
"23991","chr10",80132466,80132908,80132687,442
"23992","chr6",170712401,170713482,170712941,1081
"23993","chr3",15074496,15074712,15074604,216
"23994","chr9",42550773,42551199,42550986,426
"23995","chr7",223548,223759,223653,211
"23996","chr7",4762210,4762588,4762399,378
"23997","chr11",18588463,18588916,18588689,453
"23998","chr17",50707200,50707970,50707585,770
"23999","chr19",45914270,45914487,45914378,217
"24000","chr14",49692949,49693706,49693327,757
"24001","chr18",76613852,76614125,76613988,273
"24002","chrX",49230747,49231058,49230902,311
"24003","chr13",111559715,111559950,111559832,235
"24004","chr19",55621673,55622500,55622086,827
"24005","chr1",147928241,147928974,147928607,733
"24006","chr17",42312275,42312929,42312602,654
"24007","chr5",154631313,154631599,154631456,286
"24008","chr2",172098895,172099407,172099151,512
"24009","chr3",137761715,137762115,137761915,400
"24010","chr20",62055166,62055369,62055267,203
"24011","chr10",68471639,68472040,68471839,401
"24012","chr5",141392818,141393115,141392966,297
"24013","chr21",43694080,43694383,43694231,303
"24014","chr21",46181106,46181315,46181210,209
"24015","chr9",127921690,127922091,127921890,401
"24016","chr6",37753721,37753929,37753825,208
"24017","chr10",100713449,100714269,100713859,820
"24018","chr10",23194968,23195569,23195268,601
"24019","chr20",37944019,37944367,37944193,348
"24020","chr1",202927076,202927396,202927236,320
"24021","chrY",11789337,11789763,11789550,426
"24022","chr6",37650087,37650371,37650229,284
"24023","chr11",65640873,65641087,65640980,214
"24024","chr11",65652382,65653056,65652719,674
"24025","chr5",1060469,1060694,1060581,225
"24026","chr11",6271026,6271463,6271244,437
"24027","chr9",27528978,27529887,27529432,909
"24028","chr11",130123629,130123902,130123765,273
"24029","chr7",76379920,76380334,76380127,414
"24030","chr9",34400839,34401084,34400961,245
"24031","chr12",132151492,132151758,132151625,266
"24032","chr20",58981004,58981722,58981363,718
"24033","chr3",51973694,51974232,51973963,538
"24034","chr6",6008624,6009364,6008994,740
"24035","chr21",43959635,43959935,43959785,300
"24036","chr19",345260,345590,345425,330
"24037","chr13",87674345,87674664,87674504,319
"24038","chr11",27719097,27719618,27719357,521
"24039","chr4",107931339,107932231,107931785,892
"24040","chr9",37485804,37486102,37485953,298
"24041","chrX",5903061,5903658,5903359,597
"24042","chr17",38841195,38841408,38841301,213
"24043","chr7",63926230,63926507,63926368,277
"24044","chr1",16871066,16871354,16871210,288
"24045","chr19",34481149,34482740,34481944,1591
"24046","chr17",29572493,29573049,29572771,556
"24047","chr20",63931192,63931509,63931350,317
"24048","chr11",31804195,31806373,31805284,2178
"24049","chr13",113296781,113297675,113297228,894
"24050","chr3",32819649,32819937,32819793,288
"24051","chr19",50428013,50428381,50428197,368
"24052","chr12",106583610,106583935,106583772,325
"24053","chr5",178576622,178577246,178576934,624
"24054","chr7",64883019,64883438,64883228,419
"24055","chr19",4785238,4785478,4785358,240
"24056","chr19",47406850,47407331,47407090,481
"24057","chr6",99588665,99589271,99588968,606
"24058","chr19",55599335,55600697,55600016,1362
"24059","chr5",2743352,2743636,2743494,284
"24060","chr17",8383058,8384018,8383538,960
"24061","chr14",76134303,76134518,76134410,215
"24062","chr19",40549218,40549425,40549321,207
"24063","chr11",471542,472145,471843,603
"24064","chr9",134464535,134466956,134465745,2421
"24065","chr20",663331,664589,663960,1258
"24066","chr14",104752029,104752283,104752156,254
"24067","chr19",1302531,1302812,1302671,281
"24068","chr14",105149005,105149287,105149146,282
"24069","chr14",70821686,70822240,70821963,554
"24070","chr7",195474,195988,195731,514
"24071","chr4",6112770,6112973,6112871,203
"24072","chr14",103075366,103075804,103075585,438
"24073","chr19",1512962,1514035,1513498,1073
"24074","chr19",7830209,7830573,7830391,364
"24075","chr9",136692372,136692596,136692484,224
"24076","chr9",99221437,99222679,99222058,1242
"24077","chr7",32957120,32957979,32957549,859
"24078","chr11",1031751,1032001,1031876,250
"24079","chr20",46021606,46021896,46021751,290
"24080","chr14",23301303,23302693,23301998,1390
"24081","chr12",51172897,51173289,51173093,392
"24082","chr10",13302235,13302498,13302366,263
"24083","chr1",227925249,227925514,227925381,265
"24084","chr11",44304107,44304967,44304537,860
"24085","chr1",32702418,32703264,32702841,846
"24086","chr11",89785892,89786314,89786103,422
"24087","chr12",131896084,131896397,131896240,313
"24088","chr20",63287672,63288451,63288061,779
"24089","chr7",1863126,1863423,1863274,297
"24090","chr17",47789737,47790378,47790057,641
"24091","chr1",40096994,40097456,40097225,462
"24092","chr5",177782717,177783522,177783119,805
"24093","chr19",3094143,3094384,3094263,241
"24094","chr12",104265279,104265805,104265542,526
"24095","chr4",107719689,107720679,107720184,990
"24096","chr9",69013491,69013991,69013741,500
"24097","chr1",42785091,42785411,42785251,320
"24098","chr8",144443727,144445077,144444402,1350
"24099","chr6",1618858,1620859,1619858,2001
"24100","chr18",596829,597254,597041,425
"24101","chr17",19866993,19868195,19867594,1202
"24102","chr9",2241337,2241659,2241498,322
"24103","chr11",64250963,64251256,64251109,293
"24104","chr19",19637435,19638322,19637878,887
"24105","chr1",112508191,112509679,112508935,1488
"24106","chr19",9324108,9324468,9324288,360
"24107","chr6",50724436,50724662,50724549,226
"24108","chr11",86374651,86374964,86374807,313
"24109","chr21",45345814,45346067,45345940,253
"24110","chr7",159023401,159023718,159023559,317
"24111","chrY",13751465,13752954,13752209,1489
"24112","chr1",235642018,235642471,235642244,453
"24113","chr19",35931508,35931805,35931656,297
"24114","chr5",843343,843652,843497,309
"24115","chr19",35994002,35994574,35994288,572
"24116","chr5",53481958,53482166,53482062,208
"24117","chr9",133991108,133993559,133992333,2451
"24118","chr4",52750951,52751440,52751195,489
"24119","chrX",154457754,154458784,154458269,1030
"24120","chr3",122183895,122184798,122184346,903
"24121","chr12",121442250,121442915,121442582,665
"24122","chr21",25361794,25362171,25361982,377
"24123","chr20",2800314,2800851,2800582,537
"24124","chr20",38165147,38165465,38165306,318
"24125","chr19",5141252,5141592,5141422,340
"24126","chr20",1305872,1306083,1305977,211
"24127","chr17",143855,144056,143955,201
"24128","chr14",19300376,19302642,19301509,2266
"24129","chr3",181719396,181719690,181719543,294
"24130","chr20",63553720,63554193,63553956,473
"24131","chr19",2546622,2546860,2546741,238
"24132","chr19",31352974,31353277,31353125,303
"24133","chr17",43983678,43984275,43983976,597
"24134","chr19",4053881,4055291,4054586,1410
"24135","chr17",29294151,29294437,29294294,286
"24136","chr19",1920893,1921201,1921047,308
"24137","chr22",18833422,18833749,18833585,327
"24138","chr20",63742708,63743000,63742854,292
"24139","chr5",55227848,55228073,55227960,225
"24140","chr7",118183930,118184431,118184180,501
"24141","chr19",58400893,58401767,58401330,874
"24142","chr16",32650414,32651365,32650889,951
"24143","chr19",17192761,17193089,17192925,328
"24144","chr10",102656798,102657408,102657103,610
"24145","chr19",38899393,38900255,38899824,862
"24146","chr14",23346677,23346901,23346789,224
"24147","chr12",114686924,114687347,114687135,423
"24148","chr17",80023924,80024152,80024038,228
"24149","chr20",34859376,34859701,34859538,325
"24150","chrX",135421713,135422640,135422176,927
"24151","chr19",13762615,13763071,13762843,456
"24152","chr2",214011,214245,214128,234
"24153","chr17",44774937,44776283,44775610,1346
"24154","chr11",57349841,57350101,57349971,260
"24155","chrX",37010448,37010702,37010575,254
"24156","chr10",119892491,119892995,119892743,504
"24157","chr9",137455252,137455518,137455385,266
"24158","chr1",86155595,86156219,86155907,624
"24159","chr7",63114218,63114725,63114471,507
"24160","chr11",67955163,67955887,67955525,724
"24161","chr13",24922450,24923161,24922805,711
"24162","chr20",63775110,63775826,63775468,716
"24163","chr9",4662252,4662951,4662601,699
"24164","chr22",45163417,45164902,45164159,1485
"24165","chr11",17883896,17884426,17884161,530
"24166","chr21",46648605,46648896,46648750,291
"24167","chr1",228394727,228395193,228394960,466
"24168","chr6",26251670,26252005,26251837,335
"24169","chr17",36486464,36487086,36486775,622
"24170","chr9",93860828,93861199,93861013,371
"24171","chr20",46251251,46251649,46251450,398
"24172","chr21",44310337,44310561,44310449,224
"24173","chr10",46786481,46787146,46786813,665
"24174","chr11",34358941,34359163,34359052,222
"24175","chr5",181115153,181115402,181115277,249
"24176","chr5",141210172,141211085,141210628,913
"24177","chr19",13001356,13001995,13001675,639
"24178","chr11",1996229,1996630,1996429,401
"24179","chr9",132944139,132945142,132944640,1003
"24180","chr9",134066874,134068679,134067776,1805
"24181","chr20",63414916,63415512,63415214,596
"24182","chr9",129352051,129352424,129352237,373
"24183","chr6",169664874,169665174,169665024,300
"24184","chr9",129110345,129111627,129110986,1282
"24185","chr9",122940819,122941318,122941068,499
"24186","chr8",11201445,11201733,11201589,288
"24187","chr17",38296874,38297175,38297024,301
"24188","chr4",1503527,1503833,1503680,306
"24189","chr11",109423939,109424257,109424098,318
"24190","chr9",121598159,121600103,121599131,1944
"24191","chr16",2707534,2707910,2707722,376
"24192","chr7",143620200,143620971,143620585,771
"24193","chr12",53935636,53935906,53935771,270
"24194","chr5",181219688,181220049,181219868,361
"24195","chr9",130171934,130173264,130172599,1330
"24196","chr19",667289,667543,667416,254
"24197","chr1",23778012,23778773,23778392,761
"24198","chr16",378161,378487,378324,326
"24199","chr19",49157623,49157900,49157761,277
"24200","chr19",53978158,53978701,53978429,543
"24201","chr13",77329263,77329737,77329500,474
"24202","chr8",26041819,26042176,26041997,357
"24203","chr6",168285519,168285784,168285651,265
"24204","chr10",87009677,87009900,87009788,223
"24205","chr7",73324348,73324641,73324494,293
"24206","chr14",38255049,38256332,38255690,1283
"24207","chr12",30822451,30823358,30822904,907
"24208","chr19",4930726,4930939,4930832,213
"24209","chr11",65572302,65573012,65572657,710
"24210","chr19",45382528,45382741,45382634,213
"24211","chr9",137523174,137523404,137523289,230
"24212","chr4",1112901,1113940,1113420,1039
"24213","chr19",507457,508079,507768,622
"24214","chr19",8136184,8136466,8136325,282
"24215","chr3",179322678,179323844,179323261,1166
"24216","chr10",87222936,87223205,87223070,269
"24217","chr22",43923698,43924633,43924165,935
"24218","chr22",42128729,42129906,42129317,1177
"24219","chr19",42005707,42005942,42005824,235
"24220","chr2",25041813,25042858,25042335,1045
"24221","chr2",131353276,131353596,131353436,320
"24222","chrX",9765114,9766020,9765567,906
"24223","chr6",33771628,33771959,33771793,331
"24224","chr7",102494424,102495128,102494776,704
"24225","chr10",132047641,132047920,132047780,279
"24226","chr18",69469671,69470012,69469841,341
"24227","chr22",46793587,46793810,46793698,223
"24228","chr9",4490262,4490916,4490589,654
"24229","chr14",92121205,92122678,92121941,1473
"24230","chr7",100852150,100852995,100852572,845
"24231","chr4",131725694,131726074,131725884,380
"24232","chr4",849529,850148,849838,619
"24233","chr2",237735262,237735466,237735364,204
"24234","chr10",8009104,8009378,8009241,274
"24235","chr9",137020317,137020599,137020458,282
"24236","chr7",156940845,156942056,156941450,1211
"24237","chr2",239107978,239108268,239108123,290
"24238","chr5",1073445,1073908,1073676,463
"24239","chr19",18787419,18787640,18787529,221
"24240","chr19",4059919,4060133,4060026,214
"24241","chr19",45444284,45444789,45444536,505
"24242","chr9",96566528,96567482,96567005,954
"24243","chr14",58395823,58396491,58396157,668
"24244","chr10",49609049,49609263,49609156,214
"24245","chr14",104889517,104889747,104889632,230
"24246","chr14",76376163,76377503,76376833,1340
"24247","chr11",68390591,68390897,68390744,306
"24248","chr12",63149856,63151187,63150521,1331
"24249","chr11",73141131,73143115,73142123,1984
"24250","chr5",77086902,77087342,77087122,440
"24251","chr10",117175223,117175669,117175446,446
"24252","chr3",184185598,184186707,184186152,1109
"24253","chr12",9569741,9570065,9569903,324
"24254","chr12",132434097,132434343,132434220,246
"24255","chr11",1411982,1412460,1412221,478
"24256","chr10",102502467,102502767,102502617,300
"24257","chr17",48619191,48619564,48619377,373
"24258","chr11",66592626,66593363,66592994,737
"24259","chr9",125746042,125748391,125747216,2349
"24260","chr14",24141197,24141949,24141573,752
"24261","chr9",137578550,137579229,137578889,679
"24262","chr19",3651792,3652136,3651964,344
"24263","chr17",9002919,9004763,9003841,1844
"24264","chr19",8342790,8343454,8343122,664
"24265","chr4",39170622,39170902,39170762,280
"24266","chr7",6504164,6504477,6504320,313
"24267","chr7",100874753,100875772,100875262,1019
"24268","chr4",110476521,110476933,110476727,412
"24269","chr19",17323641,17323970,17323805,329
"24270","chr11",3093530,3093798,3093664,268
"24271","chr19",58216911,58217363,58217137,452
"24272","chr5",150946342,150946632,150946487,290
"24273","chr8",143929421,143929977,143929699,556
"24274","chr19",15368945,15369330,15369137,385
"24275","chr19",41998578,41999332,41998955,754
"24276","chr5",506176,506412,506294,236
"24277","chr11",101914863,101915397,101915130,534
"24278","chr19",52570055,52570786,52570420,731
"24279","chr2",66433320,66433662,66433491,342
"24280","chr12",124324426,124324630,124324528,204
"24281","chr16",32115593,32116822,32116207,1229
"24282","chr11",62547289,62547582,62547435,293
"24283","chr20",64037951,64039377,64038664,1426
"24284","chr4",634762,635605,635183,843
"24285","chr7",65081030,65081374,65081202,344
"24286","chr1",145280761,145281100,145280930,339
"24287","chr1",143736121,143736547,143736334,426
"24288","chr19",48837231,48837517,48837374,286
"24289","chr22",15573408,15573620,15573514,212
"24290","chr19",45785730,45786676,45786203,946
"24291","chr19",48738761,48739705,48739233,944
"24292","chr17",81994265,81994618,81994441,353
"24293","chr2",113541458,113542600,113542029,1142
"24294","chr2",23926386,23927484,23926935,1098
"24295","chr12",69359725,69360308,69360016,583
"24296","chr17",49570014,49570298,49570156,284
"24297","chr1",16859616,16860028,16859822,412
"24298","chr22",46626855,46627313,46627084,458
"24299","chr1",17622957,17623175,17623066,218
"24300","chr16",31981882,31982229,31982055,347
"24301","chr1",36341761,36341983,36341872,222
"24302","chr9",123370719,123370974,123370846,255
"24303","chrX",23333025,23335522,23334273,2497
"24304","chr12",57865203,57865713,57865458,510
"24305","chr19",1122476,1123288,1122882,812
"24306","chr1",1082719,1083010,1082864,291
"24307","chr11",910242,911581,910911,1339
"24308","chr17",1268114,1268652,1268383,538
"24309","chr15",41486195,41486790,41486492,595
"24310","chr22",49928922,49929803,49929362,881
"24311","chr19",3659643,3659951,3659797,308
"24312","chr22",39534798,39535110,39534954,312
"24313","chr12",132582639,132583990,132583314,1351
"24314","chr12",124417008,124417297,124417152,289
"24315","chr17",74351785,74352183,74351984,398
"24316","chr10",103473164,103473699,103473431,535
"24317","chr2",174248198,174249015,174248606,817
"24318","chr17",82692009,82692235,82692122,226
"24319","chr4",72568066,72568572,72568319,506
"24320","chrX",39613543,39614039,39613791,496
"24321","chr5",50690,51784,51237,1094
"24322","chr20",62603765,62604065,62603915,300
"24323","chrY",6246023,6246543,6246283,520
"24324","chr17",17476861,17477077,17476969,216
"24325","chr10",43573911,43574731,43574321,820
"24326","chr5",135852480,135852821,135852650,341
"24327","chr15",84500134,84501030,84500582,896
"24328","chr11",113790033,113790324,113790178,291
"24329","chr11",116579942,116580322,116580132,380
"24330","chr17",63434292,63434525,63434408,233
"24331","chr9",109166917,109167307,109167112,390
"24332","chr1",2043247,2043503,2043375,256
"24333","chr3",44578381,44578775,44578578,394
"24334","chr12",132278584,132278796,132278690,212
"24335","chr1",2025607,2025947,2025777,340
"24336","chr5",123636064,123636314,123636189,250
"24337","chr11",63916271,63917067,63916669,796
"24338","chr17",36182627,36183601,36183114,974
"24339","chr13",27928920,27929237,27929078,317
"24340","chr13",113023313,113023522,113023417,209
"24341","chr20",2750417,2750749,2750583,332
"24342","chr6",108663561,108663808,108663684,247
"24343","chr2",128902107,128902373,128902240,266
"24344","chr11",64299285,64301269,64300277,1984
"24345","chr1",23959295,23960211,23959753,916
"24346","chr9",136984821,136986128,136985474,1307
"24347","chr10",100738981,100739886,100739433,905
"24348","chr1",148264740,148265029,148264884,289
"24349","chr17",402831,404515,403673,1684
"24350","chr17",9162835,9163071,9162953,236
"24351","chr4",2793412,2793740,2793576,328
"24352","chr17",5078062,5078684,5078373,622
"24353","chr7",158508574,158508918,158508746,344
"24354","chr2",101386815,101387725,101387270,910
"24355","chr10",100737397,100737918,100737657,521
"24356","chr1",1430792,1431014,1430903,222
"24357","chr1",970916,971158,971037,242
"24358","chr17",28949201,28951859,28950530,2658
"24359","chr4",3476141,3476506,3476323,365
"24360","chr13",109127335,109127618,109127476,283
"24361","chr10",46106177,46106858,46106517,681
"24362","chr5",176887450,176887661,176887555,211
"24363","chr1",143653481,143653710,143653595,229
"24364","chr2",128268196,128268845,128268520,649
"24365","chr7",29566211,29566674,29566442,463
"24366","chr11",1007921,1008343,1008132,422
"24367","chr11",68670171,68670551,68670361,380
"24368","chr12",120437851,120438563,120438207,712
"24369","chr15",69031619,69031892,69031755,273
"24370","chr17",76710383,76711110,76710746,727
"24371","chr12",64780450,64781389,64780919,939
"24372","chr3",33096591,33097277,33096934,686
"24373","chr2",208112176,208112497,208112336,321
"24374","chr12",120903611,120904633,120904122,1022
"24375","chr3",50320947,50322175,50321561,1228
"24376","chr15",21081295,21081585,21081440,290
"24377","chrX",49570314,49570927,49570620,613
"24378","chr19",54982538,54982751,54982644,213
"24379","chr1",167714240,167714680,167714460,440
"24380","chr17",29612426,29613752,29613089,1326
"24381","chr22",19713991,19714946,19714468,955
"24382","chr11",31509584,31509954,31509769,370
"24383","chr8",47764277,47764548,47764412,271
"24384","chr3",14178215,14178908,14178561,693
"24385","chr7",98470570,98470977,98470773,407
"24386","chr1",1427516,1427953,1427734,437
"24387","chr1",43147737,43148171,43147954,434
"24388","chr2",31580223,31581334,31580778,1111
"24389","chr8",145051868,145052212,145052040,344
"24390","chr1",181483570,181483937,181483753,367
"24391","chr9",93958304,93960907,93959605,2603
"24392","chr13",28100090,28101033,28100561,943
"24393","chr3",183064386,183064788,183064587,402
"24394","chr20",24992029,24993064,24992546,1035
"24395","chr1",1331705,1331906,1331805,201
"24396","chr3",44581069,44581374,44581221,305
"24397","chr9",136821211,136821989,136821600,778
"24398","chr17",48621518,48621721,48621619,203
"24399","chr10",100680843,100681254,100681048,411
"24400","chr1",233904707,233905711,233905209,1004
"24401","chr17",80896337,80896643,80896490,306
"24402","chrX",41275863,41276416,41276139,553
"24403","chr15",28322078,28322549,28322313,471
"24404","chr6",168307458,168307803,168307630,345
"24405","chr2",131424754,131425536,131425145,782
"24406","chr9",39791405,39792174,39791789,769
"24407","chr10",48523404,48524593,48523998,1189
"24408","chr16",56675765,56676041,56675903,276
"24409","chr12",51217108,51218113,51217610,1005
"24410","chr14",77032811,77033159,77032985,348
"24411","chr1",1318942,1319168,1319055,226
"24412","chr14",105354594,105354809,105354701,215
"24413","chrX",110002244,110003445,110002844,1201
"24414","chr19",19501907,19502119,19502013,212
"24415","chr16",285829,286034,285931,205
"24416","chr2",52629556,52629986,52629771,430
"24417","chr20",63448262,63448559,63448410,297
"24418","chr14",105350966,105351198,105351082,232
"24419","chr1",148458796,148460187,148459491,1391
"24420","chr20",31845097,31845439,31845268,342
"24421","chr11",48900173,48901190,48900681,1017
"24422","chr17",48754747,48755270,48755008,523
"24423","chr2",202375142,202376118,202375630,976
"24424","chr11",63918017,63918496,63918256,479
"24425","chr10",43407132,43409344,43408238,2212
"24426","chr1",16696491,16696789,16696640,298
"24427","chr2",92072549,92075037,92073793,2488
"24428","chr2",26178826,26179150,26178988,324
"24429","chr14",77616241,77616907,77616574,666
"24430","chr19",3595634,3595988,3595811,354
"24431","chr12",124336473,124337047,124336760,574
"24432","chr7",4973877,4974805,4974341,928
"24433","chr21",41245890,41246093,41245991,203
"24434","chr6",42984489,42984849,42984669,360
"24435","chr19",57559185,57559905,57559545,720
"24436","chr9",137921309,137922336,137921822,1027
"24437","chr15",79310878,79311751,79311314,873
"24438","chr7",559452,559690,559571,238
"24439","chr14",22822480,22823069,22822774,589
"24440","chr21",37005637,37007137,37006387,1500
"24441","chr20",3248592,3249047,3248819,455
"24442","chr5",181169863,181170124,181169993,261
"24443","chr19",44704056,44704272,44704164,216
"24444","chr19",5694371,5694837,5694604,466
"24445","chr5",179816545,179817453,179816999,908
"24446","chr7",4755114,4755411,4755262,297
"24447","chr9",131502806,131503405,131503105,599
"24448","chr9",89497339,89497608,89497473,269
"24449","chr17",74356688,74357659,74357173,971
"24450","chr17",26962461,26963406,26962933,945
"24451","chr22",49724447,49725174,49724810,727
"24452","chr17",79795137,79795363,79795250,226
"24453","chr9",126015478,126015699,126015588,221
"24454","chr17",46977951,46979472,46978711,1521
"24455","chr17",63445639,63447109,63446374,1470
"24456","chr19",1093224,1093453,1093338,229
"24457","chr1",151993181,151994417,151993799,1236
"24458","chr9",137500766,137501303,137501034,537
"24459","chr14",105850536,105850823,105850679,287
"24460","chrX",40158119,40158631,40158375,512
"24461","chr4",386110,386610,386360,500
"24462","chr19",5567671,5567899,5567785,228
"24463","chr14",55191514,55191832,55191673,318
"24464","chr15",89665556,89666048,89665802,492
"24465","chr5",72955355,72956686,72956020,1331
"24466","chr19",384250,384464,384357,214
"24467","chr7",27094478,27094684,27094581,206
"24468","chr7",128405488,128406244,128405866,756
"24469","chr11",1252364,1252631,1252497,267
"24470","chr20",33644364,33644597,33644480,233
"24471","chr9",26946849,26947580,26947214,731
"24472","chr16",791347,791551,791449,204
"24473","chr22",18185629,18186366,18185997,737
"24474","chr19",1851579,1852204,1851891,625
"24475","chr16",69742185,69742491,69742338,306
"24476","chr7",102293051,102293283,102293167,232
"24477","chr21",43298705,43299274,43298989,569
"24478","chr2",157628346,157629183,157628764,837
"24479","chr15",78759344,78759570,78759457,226
"24480","chr19",3190636,3191420,3191028,784
"24481","chr11",318361,319052,318706,691
"24482","chr7",5312465,5312849,5312657,384
"24483","chr9",86948575,86948783,86948679,208
"24484","chr20",23365397,23366013,23365705,616
"24485","chr11",32439040,32439269,32439154,229
"24486","chr19",12495368,12495916,12495642,548
"24487","chr19",49590400,49592250,49591325,1850
"24488","chr16",88431692,88432417,88432054,725
"24489","chr19",30222501,30222958,30222729,457
"24490","chr17",1635121,1635557,1635339,436
"24491","chr7",6636823,6637920,6637371,1097
"24492","chrX",153126233,153127047,153126640,814
"24493","chr1",1084438,1084646,1084542,208
"24494","chr22",21183286,21184560,21183923,1274
"24495","chr9",137234110,137234571,137234340,461
"24496","chr2",118853720,118854305,118854012,585
"24497","chr3",23916450,23917690,23917070,1240
"24498","chr4",41873428,41873777,41873602,349
"24499","chr2",153873100,153873405,153873252,305
"24500","chr11",46237713,46238497,46238105,784
"24501","chr9",136659207,136659463,136659335,256
"24502","chr11",67117804,67119859,67118831,2055
"24503","chr22",42079470,42080090,42079780,620
"24504","chr15",92882715,92883521,92883118,806
"24505","chr14",91417017,91417222,91417119,205
"24506","chr17",81458821,81459353,81459087,532
"24507","chr15",89358683,89359554,89359118,871
"24508","chrX",68132808,68133081,68132944,273
"24509","chr1",38005167,38005699,38005433,532
"24510","chr1",158177643,158178064,158177853,421
"24511","chr5",141340571,141341262,141340916,691
"24512","chr17",48620051,48620339,48620195,288
"24513","chr1",34929209,34930605,34929907,1396
"24514","chr3",55482082,55482402,55482242,320
"24515","chr1",1484846,1485304,1485075,458
"24516","chrX",104112340,104112874,104112607,534
"24517","chr14",99274797,99275104,99274950,307
"24518","chrX",137033626,137034116,137033871,490
"24519","chr17",42685004,42685507,42685255,503
"24520","chr12",111766694,111767175,111766934,481
"24521","chr8",144547261,144548582,144547921,1321
"24522","chr7",5121142,5121633,5121387,491
"24523","chrX",9342678,9342889,9342783,211
"24524","chr21",44258407,44258661,44258534,254
"24525","chr17",40796961,40797261,40797111,300
"24526","chr17",44070557,44071133,44070845,576
"24527","chr9",41123536,41124983,41124259,1447
"24528","chr7",33062326,33063295,33062810,969
"24529","chr19",48452739,48453029,48452884,290
"24530","chr3",113947512,113948543,113948027,1031
"24531","chr20",5302189,5302416,5302302,227
"24532","chr7",128409445,128410434,128409939,989
"24533","chr20",62312125,62314192,62313158,2067
"24534","chr22",41021677,41022883,41022280,1206
"24535","chr9",127423997,127424881,127424439,884
"24536","chrX",48834926,48835635,48835280,709
"24537","chr20",62812215,62812468,62812341,253
"24538","chrX",23332167,23332479,23332323,312
"24539","chr21",45512167,45512473,45512320,306
"24540","chr1",21659210,21659609,21659409,399
"24541","chr18",12325041,12326050,12325545,1009
"24542","chr6",107070127,107070363,107070245,236
"24543","chr2",90238048,90238831,90238439,783
"24544","chr18",78429718,78430190,78429954,472
"24545","chr3",69052070,69052513,69052291,443
"24546","chr10",102503919,102504398,102504158,479
"24547","chr19",11639714,11640191,11639952,477
"24548","chr19",45864113,45864550,45864331,437
"24549","chr11",120511168,120512226,120511697,1058
"24550","chr10",22345071,22345933,22345502,862
"24551","chrX",152769491,152769783,152769637,292
"24552","chr7",5299043,5299371,5299207,328
"24553","chr2",27428398,27429262,27428830,864
"24554","chr2",27356429,27357268,27356848,839
"24555","chr3",190514447,190514655,190514551,208
"24556","chr15",90932396,90932696,90932546,300
"24557","chr17",80824980,80825360,80825170,380
"24558","chr19",875214,875420,875317,206
"24559","chr22",49750782,49750987,49750884,205
"24560","chr10",37125217,37125841,37125529,624
"24561","chr18",9478454,9478922,9478688,468
"24562","chr9",127771174,127771603,127771388,429
"24563","chr12",6278488,6279002,6278745,514
"24564","chr15",100373233,100373974,100373603,741
"24565","chr1",197910886,197912507,197911696,1621
"24566","chr15",77632226,77633646,77632936,1420
"24567","chr10",102408807,102409396,102409101,589
"24568","chrX",41442181,41442714,41442447,533
"24569","chr20",63246502,63246719,63246610,217
"24570","chr1",109687616,109687992,109687804,376
"24571","chr3",197028806,197030503,197029654,1697
"24572","chrX",119272978,119273683,119273330,705
"24573","chr22",29720141,29721171,29720656,1030
"24574","chr3",197298981,197299234,197299107,253
"24575","chr9",2717903,2718953,2718428,1050
"24576","chr2",199659278,199659481,199659379,203
"24577","chr9",21559134,21559817,21559475,683
"24578","chr9",22446682,22447696,22447189,1014
"24579","chr6",26198969,26199238,26199103,269
"24580","chr16",625906,626139,626022,233
"24581","chrX",47190689,47190941,47190815,252
"24582","chr13",20987978,20989277,20988627,1299
"24583","chr15",45522137,45523146,45522641,1009
"24584","chr18",59899684,59900491,59900087,807
"24585","chr12",113112080,113112309,113112194,229
"24586","chr17",3947420,3947839,3947629,419
"24587","chr9",38478284,38478537,38478410,253
"24588","chr1",42888276,42888499,42888387,223
"24589","chr12",113479589,113480302,113479945,713
"24590","chr18",12432891,12433246,12433068,355
"24591","chr5",84382319,84382576,84382447,257
"24592","chr17",50468209,50469539,50468874,1330
"24593","chr9",6645080,6645975,6645527,895
"24594","chr11",17695720,17696220,17695970,500
"24595","chr12",131840408,131840861,131840634,453
"24596","chr5",157731370,157731848,157731609,478
"24597","chr6",26895679,26895997,26895838,318
"24598","chr10",100747725,100749889,100748807,2164
"24599","chr19",1290410,1290638,1290524,228
"24600","chr12",76558927,76560050,76559488,1123
"24601","chr15",76335182,76335497,76335339,315
"24602","chr20",31861293,31861654,31861473,361
"24603","chr12",75209211,75209564,75209387,353
"24604","chr14",70188378,70189360,70188869,982
"24605","chr19",3960983,3961243,3961113,260
"24606","chr9",107282831,107284022,107283426,1191
"24607","chr17",74835916,74836511,74836213,595
"24608","chr19",18145012,18145239,18145125,227
"24609","chr2",130355517,130356475,130355996,958
"24610","chr13",101916075,101917125,101916600,1050
"24611","chr17",22692474,22692682,22692578,208
"24612","chr17",49470009,49470522,49470265,513
"24613","chr22",49301608,49301891,49301749,283
"24614","chr19",36139518,36140240,36139879,722
"24615","chr17",17794396,17794749,17794572,353
"24616","chr16",19115799,19116002,19115900,203
"24617","chr9",37079453,37080396,37079924,943
"24618","chr19",1033606,1035237,1034421,1631
"24619","chr20",63444707,63444910,63444808,203
"24620","chr20",61965358,61965585,61965471,227
"24621","chr2",232901139,232901409,232901274,270
"24622","chr16",1030267,1030732,1030499,465
"24623","chr4",176001924,176002479,176002201,555
"24624","chr14",64971694,64972645,64972169,951
"24625","chr9",124453012,124453639,124453325,627
"24626","chr19",2720632,2721785,2721208,1153
"24627","chr7",6551044,6551326,6551185,282
"24628","chr12",132286000,132286370,132286185,370
"24629","chr19",7267373,7267677,7267525,304
"24630","chr19",37280626,37281048,37280837,422
"24631","chr10",100735359,100735856,100735607,497
"24632","chr8",1016997,1017198,1017097,201
"24633","chr9",126235851,126236147,126235999,296
"24634","chr5",90409919,90410125,90410022,206
"24635","chr2",240918770,240919118,240918944,348
"24636","chr9",42568943,42569223,42569083,280
"24637","chr19",12734184,12734850,12734517,666
"24638","chr19",1260265,1261335,1260800,1070
"24639","chr19",15233280,15233608,15233444,328
"24640","chr17",45241062,45242061,45241561,999
"24641","chr19",2050631,2051567,2051099,936
"24642","chr14",60485258,60486228,60485743,970
"24643","chr19",2444302,2444524,2444413,222
"24644","chr19",17211662,17212179,17211920,517
"24645","chr2",176091776,176091979,176091877,203
"24646","chr19",846011,846435,846223,424
"24647","chr16",1998193,1998753,1998473,560
"24648","chr3",27715169,27715450,27715309,281
"24649","chrX",154643850,154644118,154643984,268
"24650","chr19",403553,403864,403708,311
"24651","chr16",2756310,2756578,2756444,268
"24652","chr18",3448008,3448533,3448270,525
"24653","chr10",26391705,26392222,26391963,517
"24654","chr5",181261050,181261961,181261505,911
"24655","chr11",124920918,124921458,124921188,540
"24656","chr1",156923727,156924440,156924083,713
"24657","chr9",62550615,62550969,62550792,354
"24658","chr6",21596500,21596860,21596680,360
"24659","chr9",12775487,12775814,12775650,327
"24660","chr3",40615668,40615904,40615786,236
"24661","chr16",29167819,29168128,29167973,309
"24662","chr2",130252937,130253191,130253064,254
"24663","chr2",130549296,130550040,130549668,744
"24664","chr17",36933103,36933363,36933233,260
"24665","chr19",41993667,41994408,41994037,741
"24666","chr19",37334199,37334854,37334526,655
"24667","chr11",43579162,43579859,43579510,697
"24668","chr18",79783073,79783323,79783198,250
"24669","chr2",86930680,86930886,86930783,206
"24670","chr20",63306130,63306386,63306258,256
"24671","chr6",78910613,78911000,78910806,387
"24672","chr10",117162840,117164009,117163424,1169
"24673","chr19",16530732,16531027,16530879,295
"24674","chr9",104927566,104928517,104928041,951
"24675","chr7",140672765,140673643,140673204,878
"24676","chr19",8490552,8490766,8490659,214
"24677","chr9",134501202,134501459,134501330,257
"24678","chr14",74585864,74586117,74585990,253
"24679","chr17",80470683,80470903,80470793,220
"24680","chr19",3028594,3029330,3028962,736
"24681","chr19",35612652,35612902,35612777,250
"24682","chr19",2216347,2216742,2216544,395
"24683","chr17",76137558,76138033,76137795,475
"24684","chr19",40798562,40799805,40799183,1243
"24685","chr2",161423324,161424198,161423761,874
"24686","chr12",124839690,124840004,124839847,314
"24687","chr18",79436121,79436568,79436344,447
"24688","chr19",19203328,19203607,19203467,279
"24689","chr9",34611953,34612644,34612298,691
"24690","chr3",48634973,48635727,48635350,754
"24691","chr14",19037642,19038046,19037844,404
"24692","chr19",1626496,1626759,1626627,263
"24693","chr7",4760985,4761288,4761136,303
"24694","chr19",54011840,54012088,54011964,248
"24695","chr3",184386520,184386731,184386625,211
"24696","chr8",23702325,23703078,23702701,753
"24697","chr14",52552320,52553496,52552908,1176
"24698","chr8",144472496,144473401,144472948,905
"24699","chr19",45616196,45616557,45616376,361
"24700","chr7",1929700,1930628,1930164,928
"24701","chr17",64776790,64777066,64776928,276
"24702","chr19",45717231,45717456,45717343,225
"24703","chr19",10119486,10120006,10119746,520
"24704","chr7",19145195,19145410,19145302,215
"24705","chr9",134839040,134839356,134839198,316
"24706","chr9",134827437,134827658,134827547,221
"24707","chr19",375830,376094,375962,264
"24708","chr17",39867892,39868384,39868138,492
"24709","chr11",67423940,67424195,67424067,255
"24710","chr18",13826187,13826524,13826355,337
"24711","chr20",50840600,50840805,50840702,205
"24712","chr14",101628517,101628867,101628692,350
"24713","chr1",16534378,16535801,16535089,1423
"24714","chr11",1024003,1024492,1024247,489
"24715","chr9",137217297,137217540,137217418,243
"24716","chr21",41756502,41756734,41756618,232
"24717","chr11",3667145,3667777,3667461,632
"24718","chr19",53908122,53908714,53908418,592
"24719","chr19",48414858,48415083,48414970,225
"24720","chr19",20039046,20039366,20039206,320
"24721","chr19",8208646,8209036,8208841,390
"24722","chr18",79719099,79719387,79719243,288
"24723","chr2",91748850,91749264,91749057,414
"24724","chr19",45467703,45469410,45468556,1707
"24725","chr19",48812288,48812508,48812398,220
"24726","chrX",71603663,71604253,71603958,590
"24727","chr19",10395584,10396317,10395950,733
"24728","chr20",63686152,63686422,63686287,270
"24729","chr9",38067686,38069631,38068658,1945
"24730","chr16",88886811,88887037,88886924,226
"24731","chr8",82411,83494,82952,1083
"24732","chr19",2136823,2137091,2136957,268
"24733","chr19",18777222,18778159,18777690,937
"24734","chr11",102346843,102347516,102347179,673
"24735","chr19",13286604,13286831,13286717,227
"24736","chr15",31329452,31329690,31329571,238
"24737","chr19",900808,901132,900970,324
"24738","chr16",848972,849173,849072,201
"24739","chr19",17981621,17982139,17981880,518
"24740","chr19",36418379,36418952,36418665,573
"24741","chr19",43414702,43414975,43414838,273
"24742","chr20",38961974,38962541,38962257,567
"24743","chr19",42225264,42226209,42225736,945
"24744","chr19",2347137,2350409,2348773,3272
"24745","chr1",179591616,179592461,179592038,845
"24746","chr19",49676753,49677789,49677271,1036
"24747","chr18",79616688,79617995,79617341,1307
"24748","chr1",6471411,6471676,6471543,265
"24749","chr7",99580191,99580425,99580308,234
"24750","chr1",47593121,47593558,47593339,437
"24751","chr21",44011765,44013097,44012431,1332
"24752","chr4",124450,124959,124704,509
"24753","chr1",93079001,93079475,93079238,474
"24754","chr1",201154117,201154618,201154367,501
"24755","chr7",100886804,100887030,100886917,226
"24756","chrX",48891114,48892089,48891601,975
"24757","chr2",197437,198535,197986,1098
"24758","chr1",228058930,228059496,228059213,566
"24759","chr11",70820323,70820674,70820498,351
"24760","chr11",68128319,68128637,68128478,318
"24761","chr15",66654809,66655079,66654944,270
"24762","chr12",100199475,100199926,100199700,451
"24763","chr12",120397783,120398124,120397953,341
"24764","chr9",33816800,33818302,33817551,1502
"24765","chr9",108933790,108934676,108934233,886
"24766","chr15",32342235,32343113,32342674,878
"24767","chr13",18725443,18725681,18725562,238
"24768","chr15",30195573,30196477,30196025,904
"24769","chr8",66113110,66113364,66113237,254
"24770","chr8",650428,650638,650533,210
"24771","chr8",143810750,143811298,143811024,548
"24772","chr5",55232267,55232576,55232421,309
"24773","chr7",158526278,158526480,158526379,202
"24774","chrX",153803208,153804898,153804053,1690
"24775","chr21",10521043,10522543,10521793,1500
"24776","chrX",49341062,49341676,49341369,614
"24777","chrX",109732933,109733665,109733299,732
"24778","chr11",89786921,89787941,89787431,1020
"24779","chr7",1475734,1476106,1475920,372
"24780","chr17",264269,264562,264415,293
"24781","chr4",473682,474050,473866,368
"24782","chr18",48859895,48860110,48860002,215
"24783","chr1",155140500,155140703,155140601,203
"24784","chr16",32253210,32254123,32253666,913
"24785","chr18",79532133,79532556,79532344,423
"24786","chr6",100469329,100469647,100469488,318
"24787","chr18",80109264,80109756,80109510,492
"24788","chr22",36454846,36455419,36455132,573
"24789","chr17",46922848,46923235,46923041,387
"24790","chr19",1748168,1750090,1749129,1922
"24791","chr18",74290906,74292535,74291720,1629
"24792","chr17",44066286,44066728,44066507,442
"24793","chr1",6249103,6250032,6249567,929
"24794","chr11",77994554,77994989,77994771,435
"24795","chr19",579191,579790,579490,599
"24796","chr5",141215436,141216308,141215872,872
"24797","chr3",150779011,150779645,150779328,634
"24798","chr10",101139420,101139732,101139576,312
"24799","chr5",75052416,75053856,75053136,1440
"24800","chr22",42269446,42271413,42270429,1967
"24801","chr8",47132964,47133174,47133069,210
"24802","chr9",137368473,137369196,137368834,723
"24803","chr6",27291179,27291384,27291281,205
"24804","chr9",137147833,137148556,137148194,723
"24805","chr6",26199610,26199892,26199751,282
"24806","chr17",82023806,82024087,82023946,281
"24807","chr19",49665578,49666085,49665831,507
"24808","chr19",44808802,44809216,44809009,414
"24809","chr6",56433205,56433416,56433310,211
"24810","chr5",179550297,179551290,179550793,993
"24811","chr6",166297674,166298117,166297895,443
"24812","chr19",18683381,18683849,18683615,468
"24813","chr19",41904163,41904383,41904273,220
"24814","chr19",53467548,53468178,53467863,630
"24815","chr1",976046,979425,977735,3379
"24816","chr17",191542,192708,192125,1166
"24817","chr22",15553845,15554120,15553982,275
"24818","chr5",75236801,75237074,75236937,273
"24819","chr17",39723400,39723606,39723503,206
"24820","chr18",46028174,46028544,46028359,370
"24821","chr21",45074258,45075557,45074907,1299
"24822","chr19",2782896,2783621,2783258,725
"24823","chr9",136236570,136236806,136236688,236
"24824","chr11",66022473,66022697,66022585,224
"24825","chr9",126499582,126499877,126499729,295
"24826","chr10",63973507,63973816,63973661,309
"24827","chr5",1256853,1257107,1256980,254
"24828","chr22",50605404,50605713,50605558,309
"24829","chr7",53187289,53187511,53187400,222
"24830","chr8",41766854,41767472,41767163,618
"24831","chr10",133568030,133570014,133569022,1984
"24832","chr2",73284029,73284958,73284493,929
"24833","chr1",91546272,91546505,91546388,233
"24834","chr7",907726,908024,907875,298
"24835","chr17",206328,207441,206884,1113
"24836","chr3",195631569,195631815,195631692,246
"24837","chr18",79426267,79426512,79426389,245
"24838","chr11",14644785,14645128,14644956,343
"24839","chr17",82807640,82807900,82807770,260
"24840","chr9",137113848,137115021,137114434,1173
"24841","chr19",3770568,3770944,3770756,376
"24842","chr9",122092545,122093540,122093042,995
"24843","chrY",9466019,9466325,9466172,306
"24844","chr18",79374250,79374551,79374400,301
"24845","chr5",132369477,132370240,132369858,763
"24846","chr17",48724422,48724709,48724565,287
"24847","chr15",27771253,27771509,27771381,256
"24848","chr15",90956663,90957469,90957066,806
"24849","chr11",49851565,49852600,49852082,1035
"24850","chrX",120732965,120733281,120733123,316
"24851","chr18",78879260,78879744,78879502,484
"24852","chr17",74354207,74354572,74354389,365
"24853","chr5",177436061,177436265,177436163,204
"24854","chr13",114016390,114016636,114016513,246
"24855","chr18",76821853,76823949,76822901,2096
"24856","chr5",77638864,77639471,77639167,607
"24857","chrX",120984666,120985635,120985150,969
"24858","chr12",49018516,49018973,49018744,457
"24859","chr9",130042000,130043724,130042862,1724
"24860","chr2",110423122,110424030,110423576,908
"24861","chr4",1655008,1655588,1655298,580
"24862","chrX",53088288,53088851,53088569,563
"24863","chr13",20127678,20128495,20128086,817
"24864","chr20",62811491,62811701,62811596,210
"24865","chr18",69400273,69401932,69401102,1659
"24866","chr19",11178345,11178572,11178458,227
"24867","chr8",140349056,140349522,140349289,466
"24868","chrX",120076817,120077183,120077000,366
"24869","chr2",105037791,105038313,105038052,522
"24870","chr8",54135145,54135445,54135295,300
"24871","chr8",144605315,144605827,144605571,512
"24872","chr1",2044684,2045207,2044945,523
"24873","chr7",148940943,148941232,148941087,289
"24874","chr7",102493711,102493958,102493834,247
"24875","chr5",141923554,141924069,141923811,515
"24876","chr19",40512618,40513579,40513098,961
"24877","chr19",1985881,1986199,1986040,318
"24878","chr18",47261035,47261467,47261251,432
"24879","chr2",26727670,26728606,26728138,936
"24880","chr12",84911884,84912097,84911990,213
"24881","chr19",8536301,8536548,8536424,247
"24882","chr19",5212136,5212473,5212304,337
"24883","chr19",40662895,40663185,40663040,290
"24884","chr15",81118374,81118726,81118550,352
"24885","chr5",6773826,6774460,6774143,634
"24886","chr7",66996870,66997120,66996995,250
"24887","chr12",132610151,132610517,132610334,366
"24888","chr19",50716797,50717041,50716919,244
"24889","chr12",56299896,56300561,56300228,665
"24890","chr22",38793716,38794000,38793858,284
"24891","chr19",56197686,56197904,56197795,218
"24892","chr21",46125273,46125518,46125395,245
"24893","chr19",51311484,51312204,51311844,720
"24894","chr13",21261250,21261469,21261359,219
"24895","chr11",116707423,116707684,116707553,261
"24896","chr17",1029786,1029996,1029891,210
"24897","chr19",53365557,53366232,53365894,675
"24898","chr9",127890647,127890881,127890764,234
"24899","chr19",35126349,35126736,35126542,387
"24900","chr8",7748306,7748741,7748523,435
"24901","chr1",211416335,211416879,211416607,544
"24902","chr19",49596884,49597924,49597404,1040
"24903","chr17",80999256,80999493,80999374,237
"24904","chr19",2455865,2457080,2456472,1215
"24905","chr17",8120642,8120921,8120781,279
"24906","chr18",514510,515477,514993,967
"24907","chr20",20712104,20713143,20712623,1039
"24908","chr19",18160928,18161422,18161175,494
"24909","chr10",133565379,133566263,133565821,884
"24910","chr2",130522709,130523356,130523032,647
"24911","chr5",52996,54149,53572,1153
"24912","chr12",120096748,120097213,120096980,465
"24913","chr3",5122153,5122855,5122504,702
"24914","chr16",3028229,3028552,3028390,323
"24915","chr12",4324567,4324818,4324692,251
"24916","chr19",440535,440918,440726,383
"24917","chr11",67805015,67806380,67805697,1365
"24918","chr17",68205025,68206181,68205603,1156
"24919","chr9",133030025,133031163,133030594,1138
"24920","chr1",121116888,121117313,121117100,425
"24921","chr19",2334496,2334772,2334634,276
"24922","chr1",43605221,43605471,43605346,250
"24923","chr5",154647258,154647697,154647477,439
"24924","chr18",79553826,79554082,79553954,256
"24925","chr21",45984194,45984398,45984296,204
"24926","chr17",17823541,17823968,17823754,427
"24927","chr18",36828595,36829326,36828960,731
"24928","chr19",17617634,17617838,17617736,204
"24929","chr16",3500108,3500346,3500227,238
"24930","chr9",136250164,136250442,136250303,278
"24931","chr7",152894373,152894621,152894497,248
"24932","chr22",21308585,21309508,21309046,923
"24933","chr7",5486758,5487062,5486910,304
"24934","chr2",8645738,8645942,8645840,204
"24935","chr13",114038140,114038376,114038258,236
"24936","chr22",46214227,46214892,46214559,665
"24937","chr4",187505156,187505439,187505297,283
"24938","chr13",114015216,114015572,114015394,356
"24939","chr1",2504115,2504389,2504252,274
"24940","chr22",46737757,46738686,46738221,929
"24941","chr10",45700003,45700226,45700114,223
"24942","chr9",34989558,34989878,34989718,320
"24943","chr12",110613888,110614345,110614116,457
"24944","chr1",156505150,156505528,156505339,378
"24945","chr7",5321009,5321238,5321123,229
"24946","chr9",113150801,113151527,113151164,726
"24947","chr21",45745872,45747012,45746442,1140
"24948","chr4",736493,737216,736854,723
"24949","chr4",146654957,146655610,146655283,653
"24950","chr19",35740285,35741318,35740801,1033
"24951","chr18",79459239,79459516,79459377,277
"24952","chr6",110180406,110180618,110180512,212
"24953","chr9",128881632,128882470,128882051,838
"24954","chr17",28306868,28307444,28307156,576
"24955","chr18",79480432,79480736,79480584,304
"24956","chr7",56106219,56106705,56106462,486
"24957","chr12",54079521,54079778,54079649,257
"24958","chr18",37243835,37244054,37243944,219
"24959","chr9",130681026,130682258,130681642,1232
"24960","chr15",67840302,67840733,67840517,431
"24961","chr7",56825625,56825847,56825736,222
"24962","chr7",45768584,45769146,45768865,562
"24963","chr22",38866333,38867206,38866769,873
"24964","chr22",18872645,18873649,18873147,1004
"24965","chr6",108116794,108117187,108116990,393
"24966","chr12",132399664,132399949,132399806,285
"24967","chr11",68030335,68030946,68030640,611
"24968","chr1",2133189,2133740,2133464,551
"24969","chr4",143337709,143337934,143337821,225
"24970","chr12",51721626,51721895,51721760,269
"24971","chr9",39809460,39809824,39809642,364
"24972","chr18",50664064,50664299,50664181,235
"24973","chr13",114017198,114017407,114017302,209
"24974","chr1",2169414,2169746,2169580,332
"24975","chr9",133331838,133332337,133332087,499
"24976","chr9",124015122,124018674,124016898,3552
"24977","chr17",1260047,1260479,1260263,432
"24978","chr19",52857571,52857814,52857692,243
"24979","chr3",42263452,42263819,42263635,367
"24980","chr17",42405987,42406256,42406121,269
"24981","chr6",37658250,37658670,37658460,420
"24982","chr18",48161426,48162141,48161783,715
"24983","chr18",77668276,77668612,77668444,336
"24984","chr19",17841387,17842665,17842026,1278
"24985","chr1",32650942,32651762,32651352,820
"24986","chr6",3090760,3094081,3092420,3321
"24987","chr13",114147400,114147982,114147691,582
"24988","chr4",1492815,1493026,1492920,211
"24989","chr9",78150935,78151206,78151070,271
"24990","chr6",1316665,1317727,1317196,1062
"24991","chrX",44310264,44310519,44310391,255
"24992","chr9",2241891,2242102,2241996,211
"24993","chr1",2414452,2414717,2414584,265
"24994","chr16",49868367,49868584,49868475,217
"24995","chr17",40341275,40342711,40341993,1436
"24996","chr9",128771500,128772416,128771958,916
"24997","chr4",687524,687725,687624,201
"24998","chr16",5090353,5090561,5090457,208
"24999","chr9",35665062,35665361,35665211,299
"25000","chr10",71888870,71889198,71889034,328
"25001","chr11",32333214,32333938,32333576,724
"25002","chr17",39401113,39402729,39401921,1616
"25003","chr11",31810072,31810547,31810309,475
"25004","chr9",127450864,127452056,127451460,1192
"25005","chr19",38319736,38320309,38320022,573
"25006","chr17",1478452,1478749,1478600,297
"25007","chr9",36258173,36258889,36258531,716
"25008","chr1",65254291,65254909,65254600,618
"25009","chr5",181104008,181104218,181104113,210
"25010","chr12",132396109,132396355,132396232,246
"25011","chr18",79512584,79513603,79513093,1019
"25012","chr5",146344731,146344988,146344859,257
"25013","chr5",482651,484798,483724,2147
"25014","chr12",50025152,50025617,50025384,465
"25015","chr19",52269565,52270004,52269784,439
"25016","chr20",63770689,63771744,63771216,1055
"25017","chr18",10131856,10132138,10131997,282
"25018","chr20",64316295,64317111,64316703,816
"25019","chr11",1113894,1114133,1114013,239
"25020","chrX",91781685,91782270,91781977,585
"25021","chr10",101050130,101050525,101050327,395
"25022","chr18",62526581,62526972,62526776,391
"25023","chr19",5096548,5096846,5096697,298
"25024","chr19",5822273,5822521,5822397,248
"25025","chr14",105679611,105679868,105679739,257
"25026","chr19",46678426,46678636,46678531,210
"25027","chr19",5799278,5799531,5799404,253
"25028","chr2",131331173,131331391,131331282,218
"25029","chr1",25800324,25800616,25800470,292
"25030","chr2",209809304,209809525,209809414,221
"25031","chr5",750876,751185,751030,309
"25032","chr19",35032540,35032749,35032644,209
"25033","chr19",3112649,3113630,3113139,981
"25034","chr5",141193850,141194743,141194296,893
"25035","chr16",4681560,4681834,4681697,274
"25036","chr19",8526410,8526958,8526684,548
"25037","chrX",153928059,153928484,153928271,425
"25038","chr8",144513255,144513875,144513565,620
"25039","chr16",2894284,2894677,2894480,393
"25040","chr19",40848546,40848780,40848663,234
"25041","chr5",181610,181829,181719,219
"25042","chr12",13044304,13044847,13044575,543
"25043","chr19",710822,711066,710944,244
"25044","chr14",36583929,36584485,36584207,556
"25045","chr15",19898887,19899448,19899167,561
"25046","chr12",56752059,56752549,56752304,490
"25047","chr19",1117271,1117573,1117422,302
"25048","chr7",100604440,100606029,100605234,1589
"25049","chr19",1630863,1631065,1630964,202
"25050","chr6",108174450,108174782,108174616,332
"25051","chr14",53951959,53952163,53952061,204
"25052","chr6",39048531,39049222,39048876,691
"25053","chr15",67834582,67836062,67835322,1480
"25054","chr19",17947841,17948654,17948247,813
"25055","chr21",39312444,39314398,39313421,1954
"25056","chr20",49567656,49568296,49567976,640
"25057","chr19",44707842,44708056,44707949,214
"25058","chr9",136665352,136666553,136665952,1201
"25059","chr16",33027600,33029286,33028443,1686
"25060","chr18",79755844,79756144,79755994,300
"25061","chr18",37564944,37565326,37565135,382
"25062","chr5",140808429,140809401,140808915,972
"25063","chr5",168486292,168486636,168486464,344
"25064","chr12",54090409,54090704,54090556,295
"25065","chr18",79406704,79407043,79406873,339
"25066","chr12",124518671,124518936,124518803,265
"25067","chr17",82096295,82096516,82096405,221
"25068","chr7",2060033,2060723,2060378,690
"25069","chr19",58278548,58279606,58279077,1058
"25070","chrY",11306915,11308238,11307576,1323
"25071","chr11",65584760,65585663,65585211,903
"25072","chr10",73625324,73626236,73625780,912
"25073","chr3",10707567,10708293,10707930,726
"25074","chr16",2078726,2078951,2078838,225
"25075","chr13",113011674,113013017,113012345,1343
"25076","chr1",1692087,1693628,1692857,1541
"25077","chr8",848296,848951,848623,655
"25078","chr20",48921626,48922061,48921843,435
"25079","chr6",117270370,117271116,117270743,746
"25080","chr9",109497681,109498507,109498094,826
"25081","chr5",507630,508720,508175,1090
"25082","chr16",4885025,4885286,4885155,261
"25083","chr19",58499117,58499644,58499380,527
"25084","chr18",35972188,35972676,35972432,488
"25085","chr13",19561259,19561901,19561580,642
"25086","chr9",109780033,109780387,109780210,354
"25087","chr9",79570564,79573645,79572104,3081
"25088","chr9",27573761,27573989,27573875,228
"25089","chr10",132917929,132918509,132918219,580
"25090","chr15",32536131,32536980,32536555,849
"25091","chr9",35646747,35647216,35646981,469
"25092","chr16",620625,620851,620738,226
"25093","chr19",5507236,5507512,5507374,276
"25094","chr9",128191240,128191972,128191606,732
"25095","chr4",41750263,41750485,41750374,222
"25096","chr5",171316174,171317103,171316638,929
"25097","chr12",106247102,106248596,106247849,1494
"25098","chr18",37524570,37524979,37524774,409
"25099","chr4",41867157,41867442,41867299,285
"25100","chr2",85595281,85595860,85595570,579
"25101","chr2",99154646,99155174,99154910,528
"25102","chr5",43556317,43557501,43556909,1184
"25103","chr19",3204528,3204918,3204723,390
"25104","chr8",94638978,94639532,94639255,554
"25105","chr12",121452420,121452707,121452563,287
"25106","chr18",21740628,21741978,21741303,1350
"25107","chr9",37787077,37787612,37787344,535
"25108","chr10",132226694,132226914,132226804,220
"25109","chr9",96924873,96925305,96925089,432
"25110","chr8",143558226,143558602,143558414,376
"25111","chr17",4596832,4597038,4596935,206
"25112","chr20",44651420,44652086,44651753,666
"25113","chr13",112062811,112063107,112062959,296
"25114","chr22",23521573,23522192,23521882,619
"25115","chr9",95784368,95784746,95784557,378
"25116","chr19",40554152,40554659,40554405,507
"25117","chr9",137398540,137399035,137398787,495
"25118","chrX",154884849,154885291,154885070,442
"25119","chr20",62795344,62795747,62795545,403
"25120","chr11",1287401,1287854,1287627,453
"25121","chr13",113532788,113533154,113532971,366
"25122","chrX",154386858,154387080,154386969,222
"25123","chr11",111601999,111603215,111602607,1216
"25124","chr19",39403918,39404128,39404023,210
"25125","chr10",73669,74222,73945,553
"25126","chr1",93847761,93848072,93847916,311
"25127","chr16",30947921,30948212,30948066,291
"25128","chr17",82439555,82439766,82439660,211
"25129","chr10",132807568,132807868,132807718,300
"25130","chr3",27714721,27714931,27714826,210
"25131","chr19",47130654,47131107,47130880,453
"25132","chr9",127980236,127981207,127980721,971
"25133","chr7",143901774,143902333,143902053,559
"25134","chr8",98972356,98972844,98972600,488
"25135","chr11",68892073,68892693,68892383,620
"25136","chr19",37654925,37656318,37655621,1393
"25137","chr6",50823397,50823860,50823628,463
"25138","chr10",97633029,97633618,97633323,589
"25139","chr19",10194290,10195188,10194739,898
"25140","chr17",11997125,11997667,11997396,542
"25141","chr17",47099892,47100389,47100140,497
"25142","chr12",132761395,132762403,132761899,1008
"25143","chr3",127598141,127598688,127598414,547
"25144","chr13",21319946,21320467,21320206,521
"25145","chr12",120103760,120103984,120103872,224
"25146","chr9",99828460,99829021,99828740,561
"25147","chr18",79871560,79871777,79871668,217
"25148","chr17",18225263,18225728,18225495,465
"25149","chr9",111037633,111039095,111038364,1462
"25150","chr22",19758632,19759618,19759125,986
"25151","chr4",1862455,1862690,1862572,235
"25152","chr2",106465872,106468480,106467176,2608
"25153","chr20",62824987,62825213,62825100,226
"25154","chr10",101032285,101032509,101032397,224
"25155","chr3",50226970,50227669,50227319,699
"25156","chr2",131682260,131682849,131682554,589
"25157","chrX",69305707,69306048,69305877,341
"25158","chr18",76458574,76458835,76458704,261
"25159","chr19",38223908,38224425,38224166,517
"25160","chr11",289771,290010,289890,239
"25161","chr21",45981194,45981522,45981358,328
"25162","chr20",34979611,34979976,34979793,365
"25163","chr11",7088901,7090145,7089523,1244
"25164","chr1",18640757,18641625,18641191,868
"25165","chr1",1092129,1092350,1092239,221
"25166","chr17",78993560,78993957,78993758,397
"25167","chr4",57163675,57164360,57164017,685
"25168","chr10",326992,327219,327105,227
"25169","chr10",46131130,46131347,46131238,217
"25170","chr10",73744215,73744464,73744339,249
"25171","chr1",108192605,108192891,108192748,286
"25172","chr6",21665484,21665800,21665642,316
"25173","chr1",155188536,155192004,155190270,3468
"25174","chr1",148354039,148354260,148354149,221
"25175","chr9",137129295,137130558,137129926,1263
"25176","chr1",220891547,220892258,220891902,711
"25177","chr20",22578915,22579363,22579139,448
"25178","chr19",56663693,56665039,56664366,1346
"25179","chr12",96035236,96035731,96035483,495
"25180","chr20",833477,834112,833794,635
"25181","chr19",14071923,14073932,14072927,2009
"25182","chrX",3838065,3838689,3838377,624
"25183","chr17",83099780,83100136,83099958,356
"25184","chr6",146434339,146434765,146434552,426
"25185","chr10",86376887,86377531,86377209,644
"25186","chr13",111410301,111410556,111410428,255
"25187","chr20",50009899,50010439,50010169,540
"25188","chr1",228555165,228555760,228555462,595
"25189","chr19",2732658,2733541,2733099,883
"25190","chr19",1393156,1393471,1393313,315
"25191","chr12",52014597,52015337,52014967,740
"25192","chr12",46371351,46372986,46372168,1635
"25193","chr9",129413242,129414611,129413926,1369
"25194","chr18",79559182,79559421,79559301,239
"25195","chr20",62911002,62911525,62911263,523
"25196","chr11",119320825,119321472,119321148,647
"25197","chr20",21515241,21515447,21515344,206
"25198","chr21",33403131,33404187,33403659,1056
"25199","chr2",129979632,129980145,129979888,513
"25200","chr18",79915990,79916322,79916156,332
"25201","chr2",241852701,241852931,241852816,230
"25202","chr17",46244099,46244427,46244263,328
"25203","chrX",135436154,135437229,135436691,1075
"25204","chr19",11449230,11449480,11449355,250
"25205","chr9",18776760,18777745,18777252,985
"25206","chr21",32392704,32393443,32393073,739
"25207","chr4",4118073,4118308,4118190,235
"25208","chr10",349230,349464,349347,234
"25209","chr15",74957225,74957581,74957403,356
"25210","chr13",28532186,28533117,28532651,931
"25211","chr18",6929451,6930089,6929770,638
"25212","chrX",115725408,115726473,115725940,1065
"25213","chr19",32580969,32581902,32581435,933
"25214","chr21",45498274,45498496,45498385,222
"25215","chr11",31819768,31820456,31820112,688
"25216","chr7",32942326,32943206,32942766,880
"25217","chr19",899490,899720,899605,230
"25218","chr9",128947074,128948285,128947679,1211
"25219","chr20",3231260,3231532,3231396,272
"25220","chr1",226061756,226063756,226062756,2000
"25221","chr16",717140,717378,717259,238
"25222","chr3",137770209,137770567,137770388,358
"25223","chr15",78601925,78602159,78602042,234
"25224","chr17",58659393,58659601,58659497,208
"25225","chr17",20840773,20841533,20841153,760
"25226","chr11",66626453,66626661,66626557,208
"25227","chr11",57667732,57668674,57668203,942
"25228","chr17",16689521,16689975,16689748,454
"25229","chr7",6615114,6616229,6615671,1115
"25230","chr1",11536325,11536565,11536445,240
"25231","chr1",2503602,2503818,2503710,216
"25232","chr17",35735149,35735394,35735271,245
"25233","chr19",48330137,48330463,48330300,326
"25234","chr9",61330338,61330951,61330644,613
"25235","chr18",79848383,79849118,79848750,735
"25236","chr1",3266257,3266652,3266454,395
"25237","chr2",176104489,176105167,176104828,678
"25238","chr5",181448826,181451601,181450213,2775
"25239","chr21",44425109,44425810,44425459,701
"25240","chr12",50032769,50033135,50032952,366
"25241","chr19",3687788,3688264,3688026,476
"25242","chr17",81959410,81962146,81960778,2736
"25243","chr1",1254016,1254865,1254440,849
"25244","chr20",63591877,63592252,63592064,375
"25245","chr8",43271844,43272096,43271970,252
"25246","chr17",44984233,44984976,44984604,743
"25247","chr15",74955936,74956796,74956366,860
"25248","chr18",49560705,49561076,49560890,371
"25249","chr10",114767765,114768715,114768240,950
"25250","chr12",125049514,125049981,125049747,467
"25251","chr19",35987195,35987428,35987311,233
"25252","chr9",129258350,129258759,129258554,409
"25253","chr19",3599916,3600568,3600242,652
"25254","chr3",10234341,10234731,10234536,390
"25255","chr19",42279922,42281390,42280656,1468
"25256","chr19",45733170,45733699,45733434,529
"25257","chr19",47600240,47600829,47600534,589
"25258","chr22",46389274,46389484,46389379,210
"25259","chr19",595661,595971,595816,310
"25260","chr1",84998201,84998484,84998342,283
"25261","chr10",132655311,132655578,132655444,267
"25262","chr19",21483287,21484074,21483680,787
"25263","chr18",79005747,79006833,79006290,1086
"25264","chr11",20163024,20163951,20163487,927
"25265","chr5",115962653,115963440,115963046,787
"25266","chr21",45302667,45302892,45302779,225
"25267","chr2",106843067,106843426,106843246,359
"25268","chr19",22901422,22902005,22901713,583
"25269","chr16",662234,662440,662337,206
"25270","chr19",1377845,1378267,1378056,422
"25271","chr11",95150171,95150401,95150286,230
"25272","chr1",2535495,2535773,2535634,278
"25273","chr4",1408409,1408647,1408528,238
"25274","chr9",34620265,34620554,34620409,289
"25275","chr19",1651622,1653332,1652477,1710
"25276","chr19",22709044,22709269,22709156,225
"25277","chr17",47492467,47492768,47492617,301
"25278","chr11",400096,403400,401748,3304
"25279","chr19",47226060,47226776,47226418,716
"25280","chr19",18291746,18292593,18292169,847
"25281","chr11",49049993,49050212,49050102,219
"25282","chr17",81870760,81872259,81871509,1499
"25283","chr19",11201895,11202109,11202002,214
"25284","chr11",64630172,64630544,64630358,372
"25285","chr19",49017830,49018984,49018407,1154
"25286","chr19",46648511,46649868,46649189,1357
"25287","chr7",65764383,65764761,65764572,378
"25288","chr10",117551693,117552593,117552143,900
"25289","chr18",12093608,12093843,12093725,235
"25290","chr17",81868928,81869799,81869363,871
"25291","chr19",9791676,9793314,9792495,1638
"25292","chr21",45554872,45555134,45555003,262
"25293","chr17",46224742,46225108,46224925,366
"25294","chr21",44322653,44322942,44322797,289
"25295","chr19",47698831,47699284,47699057,453
"25296","chr19",4944120,4944486,4944303,366
"25297","chr20",61970721,61971727,61971224,1006
"25298","chr22",46381809,46382032,46381920,223
"25299","chr19",45217510,45217819,45217664,309
"25300","chr17",20843470,20844376,20843923,906
"25301","chr17",79608767,79611425,79610096,2658
"25302","chrX",120251609,120251980,120251794,371
"25303","chr18",50268080,50268626,50268353,546
"25304","chr19",18322832,18323368,18323100,536
"25305","chr9",36136191,36137232,36136711,1041
"25306","chr9",33290320,33291005,33290662,685
"25307","chr15",101745483,101746213,101745848,730
"25308","chr19",524156,524369,524262,213
"25309","chr15",96360082,96360482,96360282,400
"25310","chr2",86719278,86721328,86720303,2050
"25311","chr2",232379613,232379941,232379777,328
"25312","chr2",19351974,19352200,19352087,226
"25313","chr19",1194462,1194864,1194663,402
"25314","chr19",4932649,4933073,4932861,424
"25315","chr20",57092071,57092345,57092208,274
"25316","chr19",267085,267660,267372,575
"25317","chr20",61251921,61253922,61252921,2001
"25318","chr13",22848548,22848757,22848652,209
"25319","chr5",177467414,177467793,177467603,379
"25320","chr19",5824092,5824323,5824207,231
"25321","chr22",44752333,44752812,44752572,479
"25322","chr9",137780673,137781373,137781023,700
"25323","chr1",118993043,118993364,118993203,321
"25324","chr7",76397473,76397906,76397689,433
"25325","chr15",30392884,30393841,30393362,957
"25326","chr19",1003193,1003722,1003457,529
"25327","chr16",16309604,16310899,16310251,1295
"25328","chr20",31637769,31638049,31637909,280
"25329","chr16",88206791,88207443,88207117,652
"25330","chr1",16514289,16514533,16514411,244
"25331","chr19",8403420,8404060,8403740,640
"25332","chr20",2751593,2752984,2752288,1391
"25333","chr2",132645147,132645437,132645292,290
"25334","chr1",2508687,2509039,2508863,352
"25335","chr2",240916565,240916784,240916674,219
"25336","chr17",75742498,75742729,75742613,231
"25337","chr4",92182466,92182802,92182634,336
"25338","chr19",308413,308930,308671,517
"25339","chr19",53521391,53521669,53521530,278
"25340","chr18",79068638,79069796,79069217,1158
"25341","chr19",57099320,57099569,57099444,249
"25342","chr19",10625323,10625720,10625521,397
"25343","chr6",100461334,100461568,100461451,234
"25344","chr17",47323508,47324074,47323791,566
"25345","chr18",78548229,78548578,78548403,349
"25346","chr19",1155021,1155306,1155163,285
"25347","chr17",21463876,21464280,21464078,404
"25348","chr19",50309040,50309251,50309145,211
"25349","chr10",119103898,119104892,119104395,994
"25350","chr19",56765246,56765574,56765410,328
"25351","chr13",80339878,80341533,80340705,1655
"25352","chr9",42850943,42852981,42851962,2038
"25353","chr20",35617065,35617347,35617206,282
"25354","chr9",136116188,136117050,136116619,862
"25355","chr7",920411,920714,920562,303
"25356","chr2",240455831,240456385,240456108,554
"25357","chr9",136510637,136510840,136510738,203
"25358","chr5",1084362,1084597,1084479,235
"25359","chr8",143867997,143868421,143868209,424
"25360","chr5",70415129,70415481,70415305,352
"25361","chr19",690638,690927,690782,289
"25362","chr19",29724325,29724687,29724506,362
"25363","chr19",37251836,37252127,37251981,291
"25364","chr1",149899526,149900393,149899959,867
"25365","chr18",34224516,34224911,34224713,395
"25366","chr19",40810638,40811413,40811025,775
"25367","chr3",179347772,179348191,179347981,419
"25368","chr19",38228449,38229987,38229218,1538
"25369","chr15",77032179,77032418,77032298,239
"25370","chr9",77647530,77648785,77648157,1255
"25371","chr9",128420189,128421288,128420738,1099
"25372","chr8",144852546,144853431,144852988,885
"25373","chr14",36583332,36583633,36583482,301
"25374","chr19",10380343,10381044,10380693,701
"25375","chr7",150378850,150379767,150379308,917
"25376","chr9",124013820,124014044,124013932,224
"25377","chr4",9532147,9532901,9532524,754
"25378","chr8",8227494,8229086,8228290,1592
"25379","chr1",40316007,40316284,40316145,277
"25380","chr7",6763852,6764119,6763985,267
"25381","chr16",16324448,16325440,16324944,992
"25382","chr10",133164426,133164644,133164535,218
"25383","chr19",387964,388350,388157,386
"25384","chr1",1338106,1340460,1339283,2354
"25385","chr1",16547906,16548318,16548112,412
"25386","chr7",74787989,74789285,74788637,1296
"25387","chr9",136790798,136791526,136791162,728
"25388","chr16",2635019,2635272,2635145,253
"25389","chr19",39502717,39503125,39502921,408
"25390","chr9",63702862,63703381,63703121,519
"25391","chr19",52453403,52453992,52453697,589
"25392","chr9",135792035,135792248,135792141,213
"25393","chr7",73005449,73006395,73005922,946
"25394","chr19",46077127,46077713,46077420,586
"25395","chr5",140796081,140797228,140796654,1147
"25396","chr9",34376502,34377189,34376845,687
"25397","chr19",45882769,45883006,45882887,237
"25398","chr15",73752220,73753544,73752882,1324
"25399","chr18",76350415,76350892,76350653,477
"25400","chr22",49704420,49704670,49704545,250
"25401","chr19",2723170,2723392,2723281,222
"25402","chr1",213987455,213987691,213987573,236
"25403","chr11",85647821,85648182,85648001,361
"25404","chr19",29872295,29872620,29872457,325
"25405","chr22",50783344,50783889,50783616,545
"25406","chr18",79792401,79792603,79792502,202
"25407","chr19",49808754,49809564,49809159,810
"25408","chr3",56682464,56683630,56683047,1166
"25409","chr19",35702178,35702803,35702490,625
"25410","chr16",18401247,18402541,18401894,1294
"25411","chr15",75687588,75688055,75687821,467
"25412","chr19",49487178,49487708,49487443,530
"25413","chr19",57106233,57107080,57106656,847
"25414","chr2",113554211,113554613,113554412,402
"25415","chr14",67411817,67412450,67412133,633
"25416","chr19",35869362,35869933,35869647,571
"25417","chr7",65074874,65075252,65075063,378
"25418","chr5",71587109,71587586,71587347,477
"25419","chr19",29610326,29610545,29610435,219
"25420","chr19",18929384,18929622,18929503,238
"25421","chr8",144082273,144083332,144082802,1059
"25422","chr19",11041194,11041481,11041337,287
"25423","chr1",206612451,206612677,206612564,226
"25424","chr19",15223311,15224011,15223661,700
"25425","chr18",36760621,36760887,36760754,266
"25426","chr1",1296481,1298279,1297380,1798
"25427","chr14",104174132,104174352,104174242,220
"25428","chr2",236178084,236179820,236178952,1736
"25429","chr4",3512810,3513121,3512965,311
"25430","chr16",2564919,2565172,2565045,253
"25431","chr17",80107551,80107939,80107745,388
"25432","chr19",4328526,4328868,4328697,342
"25433","chr7",24981394,24981901,24981647,507
"25434","chrX",153321440,153321694,153321567,254
"25435","chr8",231838,232862,232350,1024
"25436","chr8",94640227,94640645,94640436,418
"25437","chr11",9364290,9364694,9364492,404
"25438","chr18",79524291,79525544,79524917,1253
"25439","chr10",99540240,99541102,99540671,862
"25440","chr1",1519922,1520512,1520217,590
"25441","chr11",464450,464685,464567,235
"25442","chr14",24310668,24311726,24311197,1058
"25443","chr17",39175172,39175376,39175274,204
"25444","chr6",27892875,27893140,27893007,265
"25445","chr4",48270009,48270281,48270145,272
"25446","chr15",41660337,41661024,41660680,687
"25447","chr11",48968624,48968933,48968778,309
"25448","chr14",105155785,105156236,105156010,451
"25449","chr22",23095734,23096244,23095989,510
"25450","chr1",228215531,228215827,228215679,296
"25451","chr3",129343987,129344290,129344138,303
"25452","chr1",143661460,143662025,143661742,565
"25453","chr14",106401256,106401876,106401566,620
"25454","chr19",581325,581599,581462,274
"25455","chr12",132333867,132334216,132334041,349
"25456","chr10",80207233,80207761,80207497,528
"25457","chr20",6770048,6770310,6770179,262
"25458","chr9",133274615,133275949,133275282,1334
"25459","chr18",13262330,13263272,13262801,942
"25460","chr14",101955814,101956019,101955916,205
"25461","chr1",52368467,52368856,52368661,389
"25462","chr8",22048823,22049419,22049121,596
"25463","chr14",105112700,105113039,105112869,339
"25464","chr10",22229097,22229405,22229251,308
"25465","chr18",9102418,9102975,9102696,557
"25466","chr13",111668477,111668782,111668629,305
"25467","chr1",1522574,1523649,1523111,1075
"25468","chr10",100710049,100710584,100710316,535
"25469","chr12",95995627,95995897,95995762,270
"25470","chr11",49048168,49049170,49048669,1002
"25471","chr15",83379070,83379353,83379211,283
"25472","chr6",27824002,27824439,27824220,437
"25473","chr20",18058888,18059284,18059086,396
"25474","chr14",105574091,105574296,105574193,205
"25475","chr2",95649247,95649482,95649364,235
"25476","chr19",46471300,46471816,46471558,516
"25477","chr11",133864806,133865269,133865037,463
"25478","chr19",58396086,58397055,58396570,969
"25479","chr14",64601650,64601950,64601800,300
"25480","chr19",13872782,13873338,13873060,556
"25481","chr20",46307293,46308671,46307982,1378
"25482","chr19",47701272,47702519,47701895,1247
"25483","chr19",41135402,41136177,41135789,775
"25484","chr18",21896891,21897142,21897016,251
"25485","chr5",488135,488595,488365,460
"25486","chr21",45365215,45365424,45365319,209
"25487","chr12",132555310,132555571,132555440,261
"25488","chrX",115843397,115889109,115866253,45712
"25489","chr1",147079927,147080215,147080071,288
"25490","chr17",82088178,82088454,82088316,276
"25491","chr1",222617605,222617878,222617741,273
"25492","chr14",105192249,105192889,105192569,640
"25493","chr19",58150370,58150920,58150645,550
"25494","chr11",46121577,46121845,46121711,268
"25495","chr12",53344762,53345202,53344982,440
"25496","chr7",56882171,56882629,56882400,458
"25497","chr1",145214833,145216221,145215527,1388
"25498","chr15",65396804,65397024,65396914,220
"25499","chr13",110719153,110719813,110719483,660
"25500","chr16",28750208,28750825,28750516,617
"25501","chr19",18099101,18099458,18099279,357
"25502","chr19",2478867,2479260,2479063,393
"25503","chr5",159104367,159104640,159104503,273
"25504","chr9",35675651,35676378,35676014,727
"25505","chr16",32084341,32086012,32085176,1671
"25506","chr14",91264399,91264697,91264548,298
"25507","chr19",55083416,55083718,55083567,302
"25508","chr6",7728652,7728875,7728763,223
"25509","chr19",48810840,48811177,48811008,337
"25510","chr5",135034490,135034702,135034596,212
"25511","chr9",96449882,96451225,96450553,1343
"25512","chr1",11680342,11681660,11681001,1318
"25513","chr9",132486605,132487094,132486849,489
"25514","chr3",44579059,44579261,44579160,202
"25515","chr2",118848993,118849250,118849121,257
"25516","chr5",140842537,140843523,140843030,986
"25517","chr1",220887508,220887729,220887618,221
"25518","chr18",23503197,23504189,23503693,992
"25519","chr20",61979411,61980536,61979973,1125
"25520","chr1",7942348,7942639,7942493,291
"25521","chr9",124477624,124478177,124477900,553
"25522","chr20",8132250,8132945,8132597,695
"25523","chr14",22871645,22872283,22871964,638
"25524","chr9",138022785,138023711,138023248,926
"25525","chr11",130032916,130033317,130033116,401
"25526","chr1",23216884,23217744,23217314,860
"25527","chr17",7922809,7923096,7922952,287
"25528","chr11",49208165,49208488,49208326,323
"25529","chr5",168529771,168530366,168530068,595
"25530","chr9",971479,973276,972377,1797
"25531","chr22",20979252,20979650,20979451,398
"25532","chr12",132308802,132309006,132308904,204
"25533","chr10",47384164,47384902,47384533,738
"25534","chr1",11719509,11719959,11719734,450
"25535","chr14",64743125,64743371,64743248,246
"25536","chr9",137316100,137316613,137316356,513
"25537","chr10",119725551,119726619,119726085,1068
"25538","chr3",87052617,87052858,87052737,241
"25539","chr20",46089121,46090174,46089647,1053
"25540","chr14",99730106,99730740,99730423,634
"25541","chr14",105411034,105411815,105411424,781
"25542","chr2",47272325,47272674,47272499,349
"25543","chr19",18719697,18719932,18719814,235
"25544","chr17",49014611,49014849,49014730,238
"25545","chr7",44039405,44039652,44039528,247
"25546","chr1",2433987,2434240,2434113,253
"25547","chr2",131395193,131395471,131395332,278
"25548","chr11",65478865,65479120,65478992,255
"25549","chr7",76280385,76280588,76280486,203
"25550","chr4",131763009,131763332,131763170,323
"25551","chr9",77177154,77178412,77177783,1258
"25552","chr16",85633959,85634244,85634101,285
"25553","chr20",35619081,35619759,35619420,678
"25554","chr7",65647346,65648321,65647833,975
"25555","chr9",13323113,13323351,13323232,238
"25556","chr8",71841639,71842520,71842079,881
"25557","chr10",125026534,125026807,125026670,273
"25558","chr17",49260219,49260631,49260425,412
"25559","chr19",1438288,1438870,1438579,582
"25560","chr9",35791596,35791927,35791761,331
"25561","chr19",1299755,1300240,1299997,485
"25562","chr15",28508293,28508794,28508543,501
"25563","chr20",45304272,45304760,45304516,488
"25564","chr20",44885593,44886244,44885918,651
"25565","chr2",5691055,5694076,5692565,3021
"25566","chr19",1615203,1615593,1615398,390
"25567","chr7",937360,937636,937498,276
"25568","chr19",45935344,45935588,45935466,244
"25569","chr12",52258234,52258959,52258596,725
"25570","chr9",93451058,93452671,93451864,1613
"25571","chr15",31440878,31441286,31441082,408
"25572","chr16",1010490,1010799,1010644,309
"25573","chr12",57520602,57521037,57520819,435
"25574","chr14",21069847,21070506,21070176,659
"25575","chr11",46143100,46143301,46143200,201
"25576","chr18",79739753,79740274,79740013,521
"25577","chr9",95511396,95511626,95511511,230
"25578","chr15",96344564,96344801,96344682,237
"25579","chr1",146052259,146052583,146052421,324
"25580","chr11",77102843,77103293,77103068,450
"25581","chr9",131762372,131762763,131762567,391
"25582","chr9",126690805,126691068,126690936,263
"25583","chr13",18408229,18408660,18408444,431
"25584","chr15",28737523,28738351,28737937,828
"25585","chr2",208255168,208255585,208255376,417
"25586","chrX",125203416,125204355,125203885,939
"25587","chr1",21669668,21669916,21669792,248
"25588","chr2",44949589,44949958,44949773,369
"25589","chr1",16895732,16895971,16895851,239
"25590","chr18",79918372,79918713,79918542,341
"25591","chr19",50050755,50051235,50050995,480
"25592","chr12",6493194,6493420,6493307,226
"25593","chr14",105686791,105687027,105686909,236
"25594","chr7",63931084,63931796,63931440,712
"25595","chr11",925183,926083,925633,900
"25596","chr14",104773832,104774144,104773988,312
"25597","chr1",155322678,155325642,155324160,2964
"25598","chr18",77092171,77092504,77092337,333
"25599","chr12",48789266,48789499,48789382,233
"25600","chr4",9493661,9493862,9493761,201
"25601","chr1",1071836,1072253,1072044,417
"25602","chr6",2902941,2903672,2903306,731
"25603","chr18",77087188,77088082,77087635,894
"25604","chr17",1508831,1509156,1508993,325
"25605","chr1",25337115,25337516,25337315,401
"25606","chr22",17083712,17084105,17083908,393
"25607","chr7",576924,577209,577066,285
"25608","chr22",18653953,18654400,18654176,447
"25609","chr14",105136994,105137195,105137094,201
"25610","chr9",4491167,4491418,4491292,251
"25611","chr1",86156615,86157188,86156901,573
"25612","chr18",46963074,46964866,46963970,1792
"25613","chr11",118621354,118621555,118621454,201
"25614","chr12",114664882,114666177,114665529,1295
"25615","chr5",140835615,140836574,140836094,959
"25616","chr12",29380513,29380983,29380748,470
"25617","chr18",79727345,79727547,79727446,202
"25618","chr9",136508236,136508449,136508342,213
"25619","chr10",117165760,117166018,117165889,258
"25620","chr17",235218,235623,235420,405
"25621","chr4",722492,723188,722840,696
"25622","chr8",11200175,11200970,11200572,795
"25623","chr8",141209098,141209346,141209222,248
"25624","chr18",79735021,79735911,79735466,890
"25625","chr20",64087119,64087663,64087391,544
"25626","chr7",45726914,45727303,45727108,389
"25627","chr18",78841754,78841963,78841858,209
"25628","chr2",173964871,173965649,173965260,778
"25629","chr11",49817728,49818016,49817872,288
"25630","chr5",150671554,150672578,150672066,1024
"25631","chr20",58853969,58856184,58855076,2215
"25632","chr4",112523866,112524194,112524030,328
"25633","chr9",76458991,76459645,76459318,654
"25634","chr9",134818116,134818445,134818280,329
"25635","chr11",46239066,46239394,46239230,328
"25636","chr1",153941867,153942102,153941984,235
"25637","chr1",120354652,120354979,120354815,327
"25638","chrX",101485234,101485614,101485424,380
"25639","chr1",109466340,109467165,109466752,825
"25640","chr9",136327440,136327937,136327688,497
"25641","chr5",1570047,1570259,1570153,212
"25642","chr15",68257007,68257270,68257138,263
"25643","chr11",288863,289474,289168,611
"25644","chr11",95089433,95090447,95089940,1014
"25645","chr18",79800088,79800292,79800190,204
"25646","chr13",25046799,25047416,25047107,617
"25647","chr3",5095863,5096216,5096039,353
"25648","chr19",2275712,2276373,2276042,661
"25649","chr12",56041789,56042622,56042205,833
"25650","chr20",2508544,2508998,2508771,454
"25651","chr5",77628062,77628677,77628369,615
"25652","chr10",92573490,92574710,92574100,1220
"25653","chr9",29826528,29826738,29826633,210
"25654","chr7",102363773,102364720,102364246,947
"25655","chr19",8510934,8511941,8511437,1007
"25656","chr9",130537503,130537709,130537606,206
"25657","chr9",68704782,68706021,68705401,1239
"25658","chr6",26598296,26598530,26598413,234
"25659","chr5",140876688,140877705,140877196,1017
"25660","chr20",62393944,62394230,62394087,286
"25661","chr4",131748124,131748447,131748285,323
"25662","chr11",65547441,65548005,65547723,564
"25663","chr5",154482582,154482891,154482736,309
"25664","chr18",36186428,36188182,36187305,1754
"25665","chr9",36881953,36882214,36882083,261
"25666","chr9",69121158,69122451,69121804,1293
"25667","chr10",91162521,91164132,91163326,1611
"25668","chr7",65508507,65510081,65509294,1574
"25669","chr7",4785485,4785714,4785599,229
"25670","chr16",646495,646802,646648,307
"25671","chr13",113565963,113566306,113566134,343
"25672","chr18",79552679,79552970,79552824,291
"25673","chr15",64841898,64842130,64842014,232
"25674","chr19",13118072,13118762,13118417,690
"25675","chr13",19782007,19783094,19782550,1087
"25676","chr19",436540,436742,436641,202
"25677","chr6",89433032,89433916,89433474,884
"25678","chr19",2321582,2321991,2321786,409
"25679","chr17",81498789,81499599,81499194,810
"25680","chr19",16807647,16807933,16807790,286
"25681","chr1",2519778,2520112,2519945,334
"25682","chr19",11193021,11193933,11193477,912
"25683","chr14",22929201,22929543,22929372,342
"25684","chr20",34559723,34559940,34559831,217
"25685","chr10",351003,351288,351145,285
"25686","chr9",89603918,89604344,89604131,426
"25687","chr5",1195931,1196132,1196031,201
"25688","chr19",5036948,5037209,5037078,261
"25689","chr16",89922422,89924099,89923260,1677
"25690","chr19",5238756,5239049,5238902,293
"25691","chr10",133224581,133225002,133224791,421
"25692","chr11",1445074,1445980,1445527,906
"25693","chr19",3825122,3825518,3825320,396
"25694","chr19",19539874,19541238,19540556,1364
"25695","chr16",14924948,14925175,14925061,227
"25696","chr20",62972325,62973316,62972820,991
"25697","chr19",1614309,1614600,1614454,291
"25698","chr21",14078820,14079137,14078978,317
"25699","chr15",41559525,41559772,41559648,247
"25700","chr1",220894105,220894843,220894474,738
"25701","chr10",1542979,1543226,1543102,247
"25702","chr1",149850334,149853629,149851981,3295
"25703","chr19",49338761,49339066,49338913,305
"25704","chr3",125958021,125958799,125958410,778
"25705","chr19",5074580,5074803,5074691,223
"25706","chr19",42199452,42199824,42199638,372
"25707","chr19",49132967,49133437,49133202,470
"25708","chr22",49091515,49091723,49091619,208
"25709","chr19",37312614,37312920,37312767,306
"25710","chr14",105697510,105697715,105697612,205
"25711","chr9",39078692,39079009,39078850,317
"25712","chr8",229001,229288,229144,287
"25713","chr1",18883132,18883420,18883276,288
"25714","chr2",11618456,11618908,11618682,452
"25715","chr9",85805071,85806089,85805580,1018
"25716","chr22",50287679,50288091,50287885,412
"25717","chr20",9515824,9516246,9516035,422
"25718","chr19",40433897,40434191,40434044,294
"25719","chr18",58768458,58768751,58768604,293
"25720","chr11",65574149,65575030,65574589,881
"25721","chr19",18700751,18700981,18700866,230
"25722","chr19",306214,306681,306447,467
"25723","chr17",38477712,38477936,38477824,224
"25724","chr9",23822414,23822669,23822541,255
"25725","chr19",11380979,11382064,11381521,1085
"25726","chr3",50275256,50276988,50276122,1732
"25727","chr11",1291616,1291899,1291757,283
"25728","chr2",94874436,94874970,94874703,534
"25729","chr18",79493182,79495003,79494092,1821
"25730","chr18",77112193,77112458,77112325,265
"25731","chr6",27890388,27890786,27890587,398
"25732","chr19",2810143,2810764,2810453,621
"25733","chr11",614760,616068,615414,1308
"25734","chr4",40750674,40750879,40750776,205
"25735","chr6",170724263,170724854,170724558,591
"25736","chr19",3977497,3978162,3977829,665
"25737","chr9",19102472,19103112,19102792,640
"25738","chr17",29591143,29591380,29591261,237
"25739","chr19",11174446,11174656,11174551,210
"25740","chr19",1734222,1734628,1734425,406
"25741","chr19",3586744,3587106,3586925,362
"25742","chr4",173530677,173531811,173531244,1134
"25743","chr19",50607927,50608262,50608094,335
"25744","chr2",503671,503902,503786,231
"25745","chr19",16525169,16526014,16525591,845
"25746","chr9",136506426,136507117,136506771,691
"25747","chr11",127338,127777,127557,439
"25748","chr19",950020,950370,950195,350
"25749","chr10",100562798,100563002,100562900,204
"25750","chr7",102688790,102689037,102688913,247
"25751","chr5",179124776,179125119,179124947,343
"25752","chr3",134029076,134029422,134029249,346
"25753","chr17",75181967,75183185,75182576,1218
"25754","chr19",4101031,4101517,4101274,486
"25755","chr19",18007932,18008744,18008338,812
"25756","chr22",46618391,46618801,46618596,410
"25757","chr19",15141231,15141550,15141390,319
"25758","chr5",75034911,75035129,75035020,218
"25759","chr16",88823449,88823873,88823661,424
"25760","chr13",113117540,113117774,113117657,234
"25761","chr12",132205335,132205652,132205493,317
"25762","chr19",42042495,42042744,42042619,249
"25763","chr4",1328606,1329087,1328846,481
"25764","chr18",37336749,37336952,37336850,203
"25765","chr9",128723936,128724475,128724205,539
"25766","chr8",7227756,7228293,7228024,537
"25767","chr19",9785515,9786318,9785916,803
"25768","chr5",181059154,181059892,181059523,738
"25769","chr22",49771216,49771865,49771540,649
"25770","chr15",64841172,64841748,64841460,576
"25771","chr15",68930250,68931041,68930645,791
"25772","chr16",686750,687394,687072,644
"25773","chr19",1818466,1818782,1818624,316
"25774","chr19",1799935,1800249,1800092,314
"25775","chr19",1872632,1872849,1872740,217
"25776","chr6",149925616,149926121,149925868,505
"25777","chr19",7868377,7870012,7869194,1635
"25778","chr11",65887998,65888735,65888366,737
"25779","chr5",71067562,71067914,71067738,352
"25780","chr3",195868851,195869102,195868976,251
"25781","chr1",1529128,1529426,1529277,298
"25782","chr19",53879410,53879697,53879553,287
"25783","chr9",128218621,128219038,128218829,417
"25784","chr16",88436067,88436276,88436171,209
"25785","chr10",72261015,72261265,72261140,250
"25786","chr19",1163467,1163877,1163672,410
"25787","chr19",1419752,1420406,1420079,654
"25788","chr7",63556558,63556908,63556733,350
"25789","chr16",18394077,18394690,18394383,613
"25790","chr18",12407716,12408243,12407979,527
"25791","chr19",2540908,2541140,2541024,232
"25792","chr19",1253927,1254455,1254191,528
"25793","chr10",133329869,133330076,133329972,207
"25794","chr19",1371027,1371283,1371155,256
"25795","chr4",190021579,190023743,190022661,2164
"25796","chr19",4552432,4552662,4552547,230
"25797","chr19",48363230,48363450,48363340,220
"25798","chr10",92695767,92696139,92695953,372
"25799","chr7",74657220,74658752,74657986,1532
"25800","chr20",1937431,1937632,1937531,201
"25801","chr19",12885272,12886225,12885748,953
"25802","chr19",4941509,4941969,4941739,460
"25803","chr19",41134726,41134931,41134828,205
"25804","chr8",8065350,8066078,8065714,728
"25805","chr8",1354601,1355237,1354919,636
"25806","chr19",16471302,16472488,16471895,1186
"25807","chr19",52923368,52923613,52923490,245
"25808","chr17",75891115,75891316,75891215,201
"25809","chr9",99296559,99296931,99296745,372
"25810","chr19",5237283,5237658,5237470,375
"25811","chr17",491112,491651,491381,539
"25812","chr7",30028146,30028676,30028411,530
"25813","chrX",112840843,112841587,112841215,744
"25814","chr3",52998797,52999100,52998948,303
"25815","chr7",129783111,129783515,129783313,404
"25816","chr17",36442827,36443054,36442940,227
"25817","chr8",673372,673710,673541,338
"25818","chr9",10612635,10613333,10612984,698
"25819","chr18",47251261,47251713,47251487,452
"25820","chr22",48742439,48742710,48742574,271
"25821","chr2",95641096,95641366,95641231,270
"25822","chr19",40443241,40443641,40443441,400
"25823","chr15",64835765,64835986,64835875,221
"25824","chr7",72954264,72954933,72954598,669
"25825","chr19",990183,990413,990298,230
"25826","chr19",45395621,45397057,45396339,1436
"25827","chr19",45766904,45767162,45767033,258
"25828","chr19",55346232,55346687,55346459,455
"25829","chr12",34107801,34108763,34108282,962
"25830","chr19",57819636,57820066,57819851,430
"25831","chr2",176084783,176085067,176084925,284
"25832","chr9",16828937,16829171,16829054,234
"25833","chr10",45971895,45972794,45972344,899
"25834","chr19",1240155,1240547,1240351,392
"25835","chr17",40345144,40345587,40345365,443
"25836","chr17",287537,287809,287673,272
"25837","chr19",49788557,49788803,49788680,246
"25838","chr9",128702339,128703551,128702945,1212
"25839","chr14",59727173,59727584,59727378,411
"25840","chr18",79411704,79412118,79411911,414
"25841","chr19",3482629,3483431,3483030,802
"25842","chr9",75087969,75088903,75088436,934
"25843","chr19",1307429,1307685,1307557,256
"25844","chr19",18595119,18595337,18595228,218
"25845","chr22",15510803,15511485,15511144,682
"25846","chr13",76980128,76980400,76980264,272
"25847","chr14",18646366,18646578,18646472,212
"25848","chr19",1503512,1503792,1503652,280
"25849","chr1",30824435,30824702,30824568,267
"25850","chr9",124450345,124450785,124450565,440
"25851","chr17",31901585,31901943,31901764,358
"25852","chrX",39162409,39162878,39162643,469
"25853","chr9",133459554,133460405,133459979,851
"25854","chr11",2572727,2572971,2572849,244
"25855","chr9",137438435,137438688,137438561,253
"25856","chr19",12757582,12758026,12757804,444
"25857","chr4",25863441,25863754,25863597,313
"25858","chr19",5994811,5995056,5994933,245
"25859","chr19",39196957,39197324,39197140,367
"25860","chr14",60397725,60397959,60397842,234
"25861","chr19",2294887,2295102,2294994,215
"25862","chr19",39098916,39099208,39099062,292
"25863","chr9",87859265,87859563,87859414,298
"25864","chr11",57464840,57465100,57464970,260
"25865","chr2",87825666,87825915,87825790,249
"25866","chr11",49893391,49893820,49893605,429
"25867","chr15",26893754,26894506,26894130,752
"25868","chr9",136122775,136123002,136122888,227
"25869","chr13",27928225,27928607,27928416,382
"25870","chr11",6270108,6270328,6270218,220
"25871","chr4",1568819,1569196,1569007,377
"25872","chr17",6654902,6655122,6655012,220
"25873","chr13",113022467,113022806,113022636,339
"25874","chr1",227558456,227558753,227558604,297
"25875","chr20",58228226,58229056,58228641,830
"25876","chr17",8109854,8110466,8110160,612
"25877","chr20",652897,653462,653179,565
"25878","chr17",83089639,83090089,83089864,450
"25879","chr1",18636321,18636987,18636654,666
"25880","chr12",52250198,52250627,52250412,429
"25881","chr19",4950658,4950928,4950793,270
"25882","chr1",37753621,37754340,37753980,719
"25883","chr2",161341049,161341385,161341217,336
"25884","chr19",2217743,2218097,2217920,354
"25885","chr14",103278895,103279934,103279414,1039
"25886","chr18",34159083,34159558,34159320,475
"25887","chr21",44848981,44849348,44849164,367
"25888","chr21",43425952,43428041,43426996,2089
"25889","chr12",34336816,34337198,34337007,382
"25890","chr19",498546,498992,498769,446
"25891","chr17",62140426,62140635,62140530,209
"25892","chr16",2622791,2623056,2622923,265
"25893","chr1",31588740,31589242,31588991,502
"25894","chr1",155320815,155321210,155321012,395
"25895","chr19",1255217,1255595,1255406,378
"25896","chr11",134252868,134253087,134252977,219
"25897","chr19",17966943,17967450,17967196,507
"25898","chr11",89979902,89980633,89980267,731
"25899","chr20",21515747,21516076,21515911,329
"25900","chr20",62219123,62220117,62219620,994
"25901","chr11",119310686,119310960,119310823,274
"25902","chr19",27909372,27909925,27909648,553
"25903","chr16",280060,280994,280527,934
"25904","chr19",55304572,55304909,55304740,337
"25905","chr16",511007,511212,511109,205
"25906","chr19",8402092,8402296,8402194,204
"25907","chr15",42273254,42273593,42273423,339
"25908","chr19",41908223,41908432,41908327,209
"25909","chr22",30574590,30574900,30574745,310
"25910","chr5",42423428,42423645,42423536,217
"25911","chr19",3387965,3388205,3388085,240
"25912","chr9",66152538,66154267,66153402,1729
"25913","chr19",46716177,46717560,46716868,1383
"25914","chr10",101310534,101310747,101310640,213
"25915","chr9",34329008,34329501,34329254,493
"25916","chr19",1507918,1508144,1508031,226
"25917","chr1",11501309,11502099,11501704,790
"25918","chr1",121097207,121098110,121097658,903
"25919","chr6",44076573,44076811,44076692,238
"25920","chr19",1220486,1220817,1220651,331
"25921","chrY",9398221,9398537,9398379,316
"25922","chr16",67969504,67969856,67969680,352
"25923","chr1",154999394,154999928,154999661,534
"25924","chr1",1056298,1056699,1056498,401
"25925","chrY",26409388,26409785,26409586,397
"25926","chr11",72241068,72241484,72241276,416
"25927","chr22",23262613,23263379,23262996,766
"25928","chr19",3697839,3698380,3698109,541
"25929","chr9",135075264,135076020,135075642,756
"25930","chr15",20168341,20168830,20168585,489
"25931","chr8",7680104,7680745,7680424,641
"25932","chr17",29176580,29176996,29176788,416
"25933","chrX",120015228,120015777,120015502,549
"25934","chr19",1168577,1169140,1168858,563
"25935","chr9",124257771,124258462,124258116,691
"25936","chr19",57916253,57916686,57916469,433
"25937","chr17",81203257,81203473,81203365,216
"25938","chr16",14824614,14824942,14824778,328
"25939","chr9",137466754,137467030,137466892,276
"25940","chr19",23116925,23117365,23117145,440
"25941","chr12",132271508,132272204,132271856,696
"25942","chr11",72239771,72240306,72240038,535
"25943","chr19",17580655,17580892,17580773,237
"25944","chr13",110308577,110308796,110308686,219
"25945","chr19",1315776,1316093,1315934,317
"25946","chr21",46001930,46003969,46002949,2039
"25947","chr19",33401669,33401874,33401771,205
"25948","chrX",25020773,25021087,25020930,314
"25949","chr19",679786,680728,680257,942
"25950","chr13",18599564,18600122,18599843,558
"25951","chr17",81983171,81983507,81983339,336
"25952","chr16",88072034,88072302,88072168,268
"25953","chr19",40365710,40365917,40365813,207
"25954","chr19",17539178,17540575,17539876,1397
"25955","chr1",26864575,26865486,26865030,911
"25956","chr19",42323591,42324997,42324294,1406
"25957","chr11",61743569,61744112,61743840,543
"25958","chr19",3434931,3435419,3435175,488
"25959","chr13",30445723,30446000,30445861,277
"25960","chr16",2115377,2115619,2115498,242
"25961","chr5",1083763,1084054,1083908,291
"25962","chr9",22005888,22006230,22006059,342
"25963","chr19",53941977,53942491,53942234,514
"25964","chr19",35059646,35059928,35059787,282
"25965","chr19",46638588,46639700,46639144,1112
"25966","chr4",1513131,1513483,1513307,352
"25967","chr19",40598060,40598416,40598238,356
"25968","chrX",154443927,154444672,154444299,745
"25969","chr17",42785165,42785462,42785313,297
"25970","chr9",99104712,99105862,99105287,1150
"25971","chr9",135478892,135480568,135479730,1676
"25972","chr20",63626236,63628123,63627179,1887
"25973","chr19",45529046,45529597,45529321,551
"25974","chr19",34428515,34429055,34428785,540
"25975","chr19",48271298,48272084,48271691,786
"25976","chr21",43301103,43301332,43301217,229
"25977","chr8",144147048,144148688,144147868,1640
"25978","chr5",176060564,176061847,176061205,1283
"25979","chr19",10115488,10116026,10115757,538
"25980","chr2",241863600,241863882,241863741,282
"25981","chr19",3114754,3115096,3114925,342
"25982","chr4",131755571,131755894,131755732,323
"25983","chr19",2622524,2622861,2622692,337
"25984","chr4",1278828,1279278,1279053,450
"25985","chr7",75442208,75442988,75442598,780
"25986","chr10",114173620,114173994,114173807,374
"25987","chr8",7221547,7222149,7221848,602
"25988","chr19",984165,984866,984515,701
"25989","chr19",35723726,35724012,35723869,286
"25990","chr12",48814422,48815356,48814889,934
"25991","chr6",10882693,10882916,10882804,223
"25992","chr10",133622643,133623301,133622972,658
"25993","chr19",47572711,47573620,47573165,909
"25994","chr19",2200689,2201355,2201022,666
"25995","chr1",25337795,25338907,25338351,1112
"25996","chr19",15195432,15196300,15195866,868
"25997","chr19",49130403,49130689,49130546,286
"25998","chr19",1424613,1424975,1424794,362
"25999","chr3",130345731,130345997,130345864,266
"26000","chr5",179632336,179632699,179632517,363
"26001","chr5",121851692,121852429,121852060,737
"26002","chr12",8396259,8396916,8396587,657
"26003","chr1",156436713,156436973,156436843,260
"26004","chr19",35143257,35143725,35143491,468
"26005","chr19",993855,994512,994183,657
"26006","chr11",89865294,89865657,89865475,363
"26007","chr16",89584384,89584650,89584517,266
"26008","chr19",47740893,47741436,47741164,543
"26009","chr4",190065227,190092454,190078840,27227
"26010","chr19",45079079,45079678,45079378,599
"26011","chr4",122922998,122923283,122923140,285
"26012","chr19",8513777,8514335,8514056,558
"26013","chrX",2917908,2918195,2918051,287
"26014","chr19",44844755,44844972,44844863,217
"26015","chr17",60139432,60140154,60139793,722
"26016","chr19",422147,422629,422388,482
"26017","chr17",48725428,48725714,48725571,286
"26018","chr9",95351165,95351380,95351272,215
"26019","chr11",66346499,66346787,66346643,288
"26020","chr22",37807581,37808211,37807896,630
"26021","chr19",54456052,54456769,54456410,717
"26022","chr11",65917629,65917893,65917761,264
"26023","chr1",153963305,153963652,153963478,347
"26024","chr2",60551422,60551761,60551591,339
"26025","chr19",47111151,47111404,47111277,253
"26026","chr22",18492019,18492996,18492507,977
"26027","chr1",1312606,1313113,1312859,507
"26028","chr10",123140188,123140561,123140374,373
"26029","chr9",83707102,83708248,83707675,1146
"26030","chr5",139765602,139765949,139765775,347
"26031","chr19",56140822,56141315,56141068,493
"26032","chr19",45071608,45071885,45071746,277
"26033","chr19",58466842,58467591,58467216,749
"26034","chr19",8605073,8605324,8605198,251
"26035","chr19",6007818,6008214,6008016,396
"26036","chr13",21259622,21260317,21259969,695
"26037","chr17",83055086,83055540,83055313,454
"26038","chr21",33588082,33588946,33588514,864
"26039","chr9",976162,977828,976995,1666
"26040","chr16",540093,540368,540230,275
"26041","chr22",15689214,15689648,15689431,434
"26042","chr22",21282222,21282508,21282365,286
"26043","chr1",155860404,155860698,155860551,294
"26044","chr9",87497599,87498902,87498250,1303
"26045","chr9",8858125,8858708,8858416,583
"26046","chr9",137604759,137606439,137605599,1680
"26047","chr1",16872131,16873554,16872842,1423
"26048","chr15",30191394,30192725,30192059,1331
"26049","chr6",10413983,10414265,10414124,282
"26050","chr17",304879,305121,305000,242
"26051","chr19",55489355,55489659,55489507,304
"26052","chr17",288361,288943,288652,582
"26053","chr21",27143483,27143987,27143735,504
"26054","chr9",70258773,70259348,70259060,575
"26055","chr15",30470724,30471592,30471158,868
"26056","chr2",132352743,132353746,132353244,1003
"26057","chr16",297027,297416,297221,389
"26058","chr17",80468768,80469035,80468901,267
"26059","chr19",49151845,49152138,49151991,293
"26060","chr6",6006456,6006810,6006633,354
"26061","chr21",13825448,13825677,13825562,229
"26062","chr19",15551302,15551547,15551424,245
"26063","chr9",122219256,122220556,122219906,1300
"26064","chr1",58816217,58816563,58816390,346
"26065","chr8",141219602,141219853,141219727,251
"26066","chr9",128250175,128251150,128250662,975
"26067","chr17",42686831,42687044,42686937,213
"26068","chr9",109499730,109500037,109499883,307
"26069","chr19",40223180,40223523,40223351,343
"26070","chrX",73078787,73079269,73079028,482
"26071","chr22",50326618,50327680,50327149,1062
"26072","chr9",129495934,129496874,129496404,940
"26073","chr10",102399339,102399779,102399559,440
"26074","chr19",36009267,36009525,36009396,258
"26075","chr12",43571954,43572183,43572068,229
"26076","chr22",21151337,21151784,21151560,447
"26077","chr17",48723583,48723926,48723754,343
"26078","chr19",344164,344839,344501,675
"26079","chr4",1310980,1311326,1311153,346
"26080","chr22",24659135,24659421,24659278,286
"26081","chr7",6272463,6272895,6272679,432
"26082","chr19",39169513,39169722,39169617,209
"26083","chr8",143729067,143729276,143729171,209
"26084","chr5",178988942,178989196,178989069,254
"26085","chr19",5222501,5223340,5222920,839
"26086","chr9",34577868,34578073,34577970,205
"26087","chr5",132825212,132826117,132825664,905
"26088","chr9",128455821,128457119,128456470,1298
"26089","chr12",102956311,102956644,102956477,333
"26090","chr7",63398046,63398448,63398247,402
"26091","chr9",61634437,61634861,61634649,424
"26092","chr10",42177061,42177984,42177522,923
"26093","chr7",128530520,128532317,128531418,1797
"26094","chr9",64488550,64488807,64488678,257
"26095","chr11",48880145,48880363,48880254,218
"26096","chr5",175967847,175968380,175968113,533
"26097","chr9",101737567,101738794,101738180,1227
"26098","chr12",25385198,25385410,25385304,212
"26099","chr21",42848292,42849194,42848743,902
"26100","chr17",3944705,3945276,3944990,571
"26101","chr7",63763724,63764312,63764018,588
"26102","chr13",114041435,114041705,114041570,270
"26103","chr5",141375687,141376374,141376030,687
"26104","chr8",8027938,8028411,8028174,473
"26105","chr2",218985138,218985789,218985463,651
"26106","chr5",141179350,141180208,141179779,858
"26107","chr1",148379176,148379496,148379336,320
"26108","chr10",59882069,59882384,59882226,315
"26109","chr10",103455295,103455703,103455499,408
"26110","chr10",133637379,133638363,133637871,984
"26111","chr19",38336833,38337289,38337061,456
"26112","chr4",102868837,102869353,102869095,516
"26113","chr12",57241457,57241789,57241623,332
"26114","chr19",3576630,3578316,3577473,1686
"26115","chr19",41127871,41128142,41128006,271
"26116","chr4",30278099,30278465,30278282,366
"26117","chr19",843468,844593,844030,1125
"26118","chr1",120851000,120851320,120851160,320
"26119","chr11",74683365,74683716,74683540,351
"26120","chr20",46013455,46013767,46013611,312
"26121","chr17",50476081,50476371,50476226,290
"26122","chr1",120847594,120847866,120847730,272
"26123","chr15",28099042,28099594,28099318,552
"26124","chr12",132397114,132397328,132397221,214
"26125","chr11",66347026,66348054,66347540,1028
"26126","chrY",11986431,11986774,11986602,343
"26127","chr10",47461430,47461682,47461556,252
"26128","chr9",63784503,63784747,63784625,244
"26129","chr11",10302806,10303281,10303043,475
"26130","chr3",138949793,138950481,138950137,688
"26131","chr9",135132117,135132318,135132217,201
"26132","chr9",124940865,124941535,124941200,670
"26133","chr7",152366749,152366995,152366872,246
"26134","chr22",35380969,35381228,35381098,259
"26135","chr11",63764981,63765228,63765104,247
"26136","chr1",2521356,2521568,2521462,212
"26137","chr11",826941,827625,827283,684
"26138","chr20",63421554,63421973,63421763,419
"26139","chr1",53283766,53284193,53283979,427
"26140","chr1",2121722,2124405,2123063,2683
"26141","chr17",82222054,82222306,82222180,252
"26142","chr19",15177533,15178100,15177816,567
"26143","chr19",17949040,17949339,17949189,299
"26144","chr1",120912704,120914255,120913479,1551
"26145","chr19",8609453,8609885,8609669,432
"26146","chr14",105597673,105597928,105597800,255
"26147","chr12",121809875,121810518,121810196,643
"26148","chr19",5789187,5789724,5789455,537
"26149","chr8",7611252,7611786,7611519,534
"26150","chr9",137184877,137185312,137185094,435
"26151","chr19",3293269,3293550,3293409,281
"26152","chr2",242088149,242089411,242088780,1262
"26153","chr20",63342509,63342945,63342727,436
"26154","chr17",68135252,68135766,68135509,514
"26155","chr6",100467070,100467369,100467219,299
"26156","chrY",9526942,9527250,9527096,308
"26157","chr2",241819410,241819613,241819511,203
"26158","chr1",153670842,153671053,153670947,211
"26159","chr19",48491093,48491535,48491314,442
"26160","chr9",131276466,131278158,131277312,1692
"26161","chr19",47716574,47717041,47716807,467
"26162","chr9",120494759,120495096,120494927,337
"26163","chr14",103532606,103532865,103532735,259
"26164","chr9",111661289,111662028,111661658,739
"26165","chrY",18337955,18338167,18338061,212
"26166","chr11",1278045,1278248,1278146,203
"26167","chr9",120842765,120843307,120843036,542
"26168","chr9",94030370,94031154,94030762,784
"26169","chr19",12804127,12804392,12804259,265
"26170","chr7",44113558,44113849,44113703,291
"26171","chr19",10581159,10581381,10581270,222
"26172","chr22",37802299,37802570,37802434,271
"26173","chr12",131845310,131845544,131845427,234
"26174","chr9",38241244,38241583,38241413,339
"26175","chr9",92141290,92141545,92141417,255
"26176","chr2",239085934,239086626,239086280,692
"26177","chr21",43776006,43776874,43776440,868
"26178","chr19",36269673,36270126,36269899,453
"26179","chr17",41967793,41968029,41967911,236
"26180","chr19",1287417,1287886,1287651,469
"26181","chr17",45405762,45406088,45405925,326
"26182","chr15",43589894,43590328,43590111,434
"26183","chr1",42380307,42381317,42380812,1010
"26184","chr19",55080537,55082612,55081574,2075
"26185","chr1",1211328,1211534,1211431,206
"26186","chr18",48538690,48538892,48538791,202
"26187","chr17",78353062,78353378,78353220,316
"26188","chr19",49210238,49210862,49210550,624
"26189","chr15",27806392,27806644,27806518,252
"26190","chr22",29049650,29050125,29049887,475
"26191","chr7",159230991,159231338,159231164,347
"26192","chr4",4872234,4872446,4872340,212
"26193","chr14",104223702,104223937,104223819,235
"26194","chr20",58853253,58853461,58853357,208
"26195","chr17",14298409,14298735,14298572,326
"26196","chr9",68306358,68306561,68306459,203
"26197","chr11",95067079,95067918,95067498,839
"26198","chr16",28403536,28404048,28403792,512
"26199","chr8",1406737,1407251,1406994,514
"26200","chr16",21404274,21404574,21404424,300
"26201","chr9",33001218,33001670,33001444,452
"26202","chr1",41423598,41423954,41423776,356
"26203","chr12",114447300,114447613,114447456,313
"26204","chr9",113059791,113061136,113060463,1345
"26205","chr19",9674804,9675130,9674967,326
"26206","chr9",125261901,125262317,125262109,416
"26207","chr10",132351639,132352809,132352224,1170
"26208","chr22",19431222,19431432,19431327,210
"26209","chr17",82583672,82583878,82583775,206
"26210","chr10",131852264,131852515,131852389,251
"26211","chr16",21402327,21402572,21402449,245
"26212","chr5",70025197,70025707,70025452,510
"26213","chr4",186500880,186501090,186500985,210
"26214","chr17",22552575,22552865,22552720,290
"26215","chr16",1432550,1433200,1432875,650
"26216","chr19",8530202,8530587,8530394,385
"26217","chr1",2029503,2029709,2029606,206
"26218","chr11",69685866,69686143,69686004,277
"26219","chr6",10417151,10417609,10417380,458
"26220","chr17",18572725,18573009,18572867,284
"26221","chr17",82930038,82930418,82930228,380
"26222","chr10",102240497,102241984,102241240,1487
"26223","chr19",44448228,44448621,44448424,393
"26224","chr11",67398821,67399051,67398936,230
"26225","chr14",105141810,105142138,105141974,328
"26226","chr17",74982140,74982537,74982338,397
"26227","chr6",43181998,43182271,43182134,273
"26228","chr19",3285858,3286123,3285990,265
"26229","chr9",137809839,137810312,137810075,473
"26230","chr20",33676790,33677007,33676898,217
"26231","chr4",926818,927850,927334,1032
"26232","chr17",83032052,83032497,83032274,445
"26233","chr20",63973908,63974110,63974009,202
"26234","chr5",140875573,140875865,140875719,292
"26235","chr20",22586183,22586417,22586300,234
"26236","chr19",49127848,49128237,49128042,389
"26237","chr19",47230203,47231549,47230876,1346
"26238","chr12",121822889,121823310,121823099,421
"26239","chr11",1033084,1033356,1033220,272
"26240","chr17",7851600,7852266,7851933,666
"26241","chr19",5827887,5828394,5828140,507
"26242","chr20",34863345,34863571,34863458,226
"26243","chr10",99533258,99533481,99533369,223
"26244","chr18",33577901,33578259,33578080,358
"26245","chr9",33025084,33025799,33025441,715
"26246","chr9",128192887,128193219,128193053,332
"26247","chr9",132669656,132671075,132670365,1419
"26248","chr9",136418308,136418517,136418412,209
"26249","chr1",156388258,156388771,156388514,513
"26250","chr16",1260221,1260905,1260563,684
"26251","chr16",16357490,16358103,16357796,613
"26252","chr19",18543038,18543721,18543379,683
"26253","chr19",452130,452400,452265,270
"26254","chr19",38907236,38907660,38907448,424
"26255","chr9",42129110,42129714,42129412,604
"26256","chr6",157274370,157275177,157274773,807
"26257","chr7",158959745,158960025,158959885,280
"26258","chr2",219444915,219445171,219445043,256
"26259","chr15",78800196,78800545,78800370,349
"26260","chr1",1509208,1509469,1509338,261
"26261","chr9",136418902,136419136,136419019,234
"26262","chr22",42343279,42343831,42343555,552
"26263","chr17",9115679,9115890,9115784,211
"26264","chr1",1639975,1640670,1640322,695
"26265","chr1",148151367,148152377,148151872,1010
"26266","chr8",2480931,2481184,2481057,253
"26267","chr9",105557964,105558359,105558161,395
"26268","chr8",144270459,144270724,144270591,265
"26269","chr8",144600292,144603295,144601793,3003
"26270","chr9",87011594,87011827,87011710,233
"26271","chr22",50219051,50219508,50219279,457
"26272","chr9",33044247,33044614,33044430,367
"26273","chr19",38264206,38265059,38264632,853
"26274","chr1",228620299,228621043,228620671,744
"26275","chr19",19528743,19528979,19528861,236
"26276","chr16",1968518,1968790,1968654,272
"26277","chr21",43170502,43170716,43170609,214
"26278","chr7",891276,891578,891427,302
"26279","chr17",46361199,46362203,46361701,1004
"26280","chr19",29901706,29902045,29901875,339
"26281","chr19",18167144,18167354,18167249,210
"26282","chrY",9527680,9527996,9527838,316
"26283","chr20",62165390,62165597,62165493,207
"26284","chrY",18346304,18346566,18346435,262
"26285","chr19",40600095,40600509,40600302,414
"26286","chr10",112951119,112951608,112951363,489
"26287","chr15",27805104,27805643,27805373,539
"26288","chr9",67718705,67718908,67718806,203
"26289","chr10",43455436,43455989,43455712,553
"26290","chrX",49166068,49166733,49166400,665
"26291","chr15",30362287,30362785,30362536,498
"26292","chr22",18633760,18634938,18634349,1178
"26293","chr16",28711256,28711768,28711512,512
"26294","chr10",13473185,13473427,13473306,242
"26295","chr10",133458366,133458640,133458503,274
"26296","chr9",14349308,14349516,14349412,208
"26297","chr9",92837420,92837723,92837571,303
"26298","chr20",46174425,46175023,46174724,598
"26299","chr15",78131341,78131754,78131547,413
"26300","chr9",93516070,93516305,93516187,235
"26301","chr9",41272994,41273971,41273482,977
"26302","chr7",75422099,75422329,75422214,230
"26303","chr19",17873833,17874324,17874078,491
"26304","chr21",46412965,46413343,46413154,378
"26305","chr1",27575289,27576177,27575733,888
"26306","chr12",132442264,132442555,132442409,291
"26307","chr19",1847690,1847894,1847792,204
"26308","chr7",6754014,6754347,6754180,333
"26309","chr19",55286949,55287283,55287116,334
"26310","chr16",16319925,16320178,16320051,253
"26311","chr13",57147407,57147740,57147573,333
"26312","chr1",120942197,120942586,120942391,389
"26313","chr9",136739610,136739829,136739719,219
"26314","chr12",63821719,63822210,63821964,491
"26315","chr7",150978454,150978778,150978616,324
"26316","chrX",49541647,49542260,49541953,613
"26317","chr11",64242226,64242527,64242376,301
"26318","chr10",133325178,133326213,133325695,1035
"26319","chr17",43994580,43995076,43994828,496
"26320","chr19",676348,676582,676465,234
"26321","chr9",62800153,62800448,62800300,295
"26322","chr17",14297262,14297679,14297470,417
"26323","chr7",1930991,1931288,1931139,297
"26324","chr7",753481,754130,753805,649
"26325","chr6",169662526,169663016,169662771,490
"26326","chr11",30584457,30584696,30584576,239
"26327","chr9",97857702,97857910,97857806,208
"26328","chr9",67059045,67059542,67059293,497
"26329","chr5",168529214,168529500,168529357,286
"26330","chr2",233566415,233566980,233566697,565
"26331","chr22",25420945,25421572,25421258,627
"26332","chr19",50259085,50259295,50259190,210
"26333","chr19",55602461,55602866,55602663,405
"26334","chrY",18387413,18387674,18387543,261
"26335","chr12",31616363,31616566,31616464,203
"26336","chr19",7293329,7294636,7293982,1307
"26337","chr19",4032951,4033646,4033298,695
"26338","chr19",3228586,3228994,3228790,408
"26339","chr18",50967906,50968298,50968102,392
"26340","chr19",58516688,58516921,58516804,233
"26341","chr19",34134286,34134845,34134565,559
"26342","chr19",56103719,56104586,56104152,867
"26343","chr21",42685127,42685422,42685274,295
"26344","chrX",25007273,25007598,25007435,325
"26345","chr19",7918718,7919034,7918876,316
"26346","chr19",2128392,2129073,2128732,681
"26347","chr19",7932649,7932904,7932776,255
"26348","chr19",11422530,11422951,11422740,421
"26349","chr17",19196505,19196825,19196665,320
"26350","chr19",14070618,14070946,14070782,328
"26351","chr19",10113766,10114462,10114114,696
"26352","chr19",12656935,12657527,12657231,592
"26353","chr20",63490505,63490726,63490615,221
"26354","chr9",72960,73877,73418,917
"26355","chr9",40991852,40992735,40992293,883
"26356","chr5",1213371,1213584,1213477,213
"26357","chr1",165354249,165354574,165354411,325
"26358","chr19",46697591,46697812,46697701,221
"26359","chr14",105719404,105719659,105719531,255
"26360","chr9",136501753,136502588,136502170,835
"26361","chr10",46837719,46837942,46837830,223
"26362","chr19",53431836,53432038,53431937,202
"26363","chrX",40169672,40170062,40169867,390
"26364","chr9",105447804,105448472,105448138,668
"26365","chr9",63859168,63860062,63859615,894
"26366","chr12",42226852,42227191,42227021,339
"26367","chr13",78608724,78608969,78608846,245
"26368","chr9",16726861,16727105,16726983,244
"26369","chr14",49867950,49868490,49868220,540
"26370","chr19",1481850,1482491,1482170,641
"26371","chr11",72793620,72794082,72793851,462
"26372","chr19",8430670,8430910,8430790,240
"26373","chr11",3591420,3591655,3591537,235
"26374","chr1",46240236,46240493,46240364,257
"26375","chr17",81934874,81935185,81935029,311
"26376","chr14",105364268,105364509,105364388,241
"26377","chr19",54982861,54983167,54983014,306
"26378","chr17",82444493,82444875,82444684,382
"26379","chr7",158489522,158490690,158490106,1168
"26380","chrX",25017705,25018006,25017855,301
"26381","chr19",3192418,3192707,3192562,289
"26382","chr10",132982957,132983392,132983174,435
"26383","chr2",60555400,60555644,60555522,244
"26384","chr7",149225818,149226104,149225961,286
"26385","chrY",21534694,21534992,21534843,298
"26386","chr9",96686828,96687296,96687062,468
"26387","chr9",134053376,134053586,134053481,210
"26388","chr19",1990658,1990898,1990778,240
"26389","chr22",23973816,23974754,23974285,938
"26390","chr7",65140707,65141513,65141110,806
"26391","chr1",120844361,120845208,120844784,847
"26392","chr1",156216446,156216856,156216651,410
"26393","chr9",4792556,4793553,4793054,997
"26394","chr10",38600255,38601202,38600728,947
"26395","chr14",102314289,102314493,102314391,204
"26396","chr1",143792177,143793138,143792657,961
"26397","chr17",82599570,82599810,82599690,240
"26398","chr21",43864271,43866018,43865144,1747
"26399","chr7",102517376,102518063,102517719,687
"26400","chr1",1080679,1080980,1080829,301
"26401","chr18",50340162,50340380,50340271,218
"26402","chr2",112187234,112187445,112187339,211
"26403","chr19",36421358,36421979,36421668,621
"26404","chr19",19529093,19529333,19529213,240
"26405","chr19",39320505,39321135,39320820,630
"26406","chr19",18594222,18594619,18594420,397
"26407","chr7",102616355,102617042,102616698,687
"26408","chrX",3876395,3877113,3876754,718
"26409","chr13",21377154,21377578,21377366,424
"26410","chr3",129160980,129161280,129161130,300
"26411","chr12",112381235,112381446,112381340,211
"26412","chr3",55485061,55485595,55485328,534
"26413","chr17",81740614,81740905,81740759,291
"26414","chr7",44040118,44040969,44040543,851
"26415","chr17",63533899,63534225,63534062,326
"26416","chr19",55549903,55550150,55550026,247
"26417","chr19",36307641,36308094,36307867,453
"26418","chr12",56634609,56635156,56634882,547
"26419","chr3",198104935,198105889,198105412,954
"26420","chr21",44990423,44990746,44990584,323
"26421","chr19",5144028,5144386,5144207,358
"26422","chr10",37651494,37651746,37651620,252
"26423","chr9",88990849,88991908,88991378,1059
"26424","chr7",6503384,6503656,6503520,272
"26425","chr1",143838439,143838835,143838637,396
"26426","chr9",91117443,91118336,91117889,893
"26427","chr19",1591428,1591629,1591528,201
"26428","chr19",43594773,43595331,43595052,558
"26429","chr13",27791408,27791648,27791528,240
"26430","chr5",181223917,181224121,181224019,204
"26431","chr19",17952103,17952505,17952304,402
"26432","chr19",924788,925001,924894,213
"26433","chr21",14070635,14070839,14070737,204
"26434","chr8",143877879,143878323,143878101,444
"26435","chr4",139436208,139436456,139436332,248
"26436","chr6",26596897,26597324,26597110,427
"26437","chr9",69411987,69412512,69412249,525
"26438","chr21",43053729,43053973,43053851,244
"26439","chr1",16658282,16658558,16658420,276
"26440","chr1",120414673,120415572,120415122,899
"26441","chr19",3196190,3196395,3196292,205
"26442","chr12",57520024,57520251,57520137,227
"26443","chr19",45037399,45037797,45037598,398
"26444","chr19",648990,649467,649228,477
"26445","chr20",6040937,6042228,6041582,1291
"26446","chr17",3941008,3941305,3941156,297
"26447","chr9",100411607,100411871,100411739,264
"26448","chr9",137379011,137379494,137379252,483
"26449","chr7",62376229,62380897,62378563,4668
"26450","chr22",18577179,18578723,18577951,1544
"26451","chr12",132601240,132601469,132601354,229
"26452","chr19",13208584,13208975,13208779,391
"26453","chr19",15424648,15425042,15424845,394
"26454","chr20",62879182,62879855,62879518,673
"26455","chr21",44332499,44332715,44332607,216
"26456","chr18",14146395,14146629,14146512,234
"26457","chr1",26817249,26817462,26817355,213
"26458","chr19",1064898,1065192,1065045,294
"26459","chr19",19626576,19627114,19626845,538
"26460","chr19",37273049,37273502,37273275,453
"26461","chr19",681345,681547,681446,202
"26462","chr11",30017387,30017601,30017494,214
"26463","chr14",61751007,61751359,61751183,352
"26464","chr22",46463718,46464332,46464025,614
"26465","chr21",45276675,45276920,45276797,245
"26466","chr19",48713988,48714429,48714208,441
"26467","chr15",88741781,88742056,88741918,275
"26468","chr14",104164128,104164374,104164251,246
"26469","chr1",1517321,1517819,1517570,498
"26470","chr19",295114,295354,295234,240
"26471","chr5",140849737,140850748,140850242,1011
"26472","chr2",132037626,132038811,132038218,1185
"26473","chr17",7383879,7384621,7384250,742
"26474","chr15",20755450,20756318,20755884,868
"26475","chr18",79450989,79451213,79451101,224
"26476","chr9",62915276,62916045,62915660,769
"26477","chr1",1712154,1712372,1712263,218
"26478","chr19",2462066,2462444,2462255,378
"26479","chr13",48316821,48317413,48317117,592
"26480","chr19",13087885,13088185,13088035,300
"26481","chr9",128340171,128341019,128340595,848
"26482","chrX",49162739,49162996,49162867,257
"26483","chr12",609008,609339,609173,331
"26484","chr18",12431200,12431660,12431430,460
"26485","chr17",48541725,48541952,48541838,227
"26486","chr9",128322262,128323192,128322727,930
"26487","chr4",80203314,80203691,80203502,377
"26488","chr19",38394593,38394865,38394729,272
"26489","chr8",1103354,1103804,1103579,450
"26490","chr17",82078847,82079598,82079222,751
"26491","chr19",523165,523661,523413,496
"26492","chr19",3500418,3500842,3500630,424
"26493","chr7",75410151,75410820,75410485,669
"26494","chr19",5699048,5699272,5699160,224
"26495","chr19",5593698,5594183,5593940,485
"26496","chr18",79225514,79225929,79225721,415
"26497","chr14",105497241,105497471,105497356,230
"26498","chr18",73062,73563,73312,501
"26499","chr13",78607809,78608087,78607948,278
"26500","chr19",5536520,5536778,5536649,258
"26501","chr17",47530914,47531615,47531264,701
"26502","chr11",1022078,1022394,1022236,316
"26503","chr19",55665269,55665552,55665410,283
"26504","chr7",155377928,155378244,155378086,316
"26505","chr19",10009302,10009607,10009454,305
"26506","chr18",79733154,79733658,79733406,504
"26507","chr19",29843533,29843781,29843657,248
"26508","chr19",50357589,50358006,50357797,417
"26509","chr17",19980012,19980297,19980154,285
"26510","chr18",8659793,8660167,8659980,374
"26511","chr12",101642475,101642683,101642579,208
"26512","chr19",1324970,1325361,1325165,391
"26513","chr17",31916840,31917545,31917192,705
"26514","chr3",12796972,12797283,12797127,311
"26515","chr19",2352983,2353560,2353271,577
"26516","chr9",62837346,62838282,62837814,936
"26517","chr19",1993022,1993274,1993148,252
"26518","chr19",11483557,11484172,11483864,615
"26519","chr9",136204819,136205410,136205114,591
"26520","chr13",113560066,113560565,113560315,499
"26521","chr19",55493605,55494004,55493804,399
"26522","chr19",7294871,7295097,7294984,226
"26523","chr9",470108,470324,470216,216
"26524","chr2",105237036,105237340,105237188,304
"26525","chr18",21612182,21612633,21612407,451
"26526","chr18",33578519,33579023,33578771,504
"26527","chr9",135244204,135244448,135244326,244
"26528","chr17",46590440,46591167,46590803,727
"26529","chr15",99799616,99800215,99799915,599
"26530","chr17",19088731,19089552,19089141,821
"26531","chr18",79705403,79705674,79705538,271
"26532","chr1",148402395,148402693,148402544,298
"26533","chrX",71095646,71095886,71095766,240
"26534","chrY",6266457,6266707,6266582,250
"26535","chr1",1046772,1047131,1046951,359
"26536","chr9",35689613,35690732,35690172,1119
"26537","chr18",79770969,79771535,79771252,566
"26538","chr19",35719785,35720024,35719904,239
"26539","chr19",2790378,2790719,2790548,341
"26540","chr9",33523496,33524798,33524147,1302
"26541","chr9",78296863,78297695,78297279,832
"26542","chr19",51338874,51339099,51338986,225
"26543","chr19",2015496,2015724,2015610,228
"26544","chr1",156106460,156106680,156106570,220
"26545","chr20",63689700,63689906,63689803,206
"26546","chr12",132247639,132248060,132247849,421
"26547","chr2",306675,307167,306921,492
"26548","chr12",132837668,132837877,132837772,209
"26549","chr15",19943440,19944862,19944151,1422
"26550","chr22",23460314,23460747,23460530,433
"26551","chrX",155381856,155382988,155382422,1132
"26552","chr15",99806519,99807249,99806884,730
"26553","chr9",41778725,41779044,41778884,319
"26554","chr10",79983371,79983791,79983581,420
"26555","chr5",179138715,179138917,179138816,202
"26556","chr18",12287272,12287563,12287417,291
"26557","chr11",76211125,76211332,76211228,207
"26558","chrX",71761966,71763979,71762972,2013
"26559","chr9",133863264,133863478,133863371,214
"26560","chr11",124745493,124745748,124745620,255
"26561","chr18",76894987,76895212,76895099,225
"26562","chr9",98192004,98192311,98192157,307
"26563","chr3",75672143,75672758,75672450,615
"26564","chr5",501720,501960,501840,240
"26565","chr18",59264770,59265109,59264939,339
"26566","chr9",21968359,21968729,21968544,370
"26567","chr9",137809406,137809614,137809510,208
"26568","chr17",48617963,48618191,48618077,228
"26569","chr10",100562075,100562638,100562356,563
"26570","chr21",44161563,44161863,44161713,300
"26571","chr12",49091983,49092194,49092088,211
"26572","chr9",98943625,98944400,98944012,775
"26573","chr22",50287040,50287389,50287214,349
"26574","chr11",47400140,47400463,47400301,323
"26575","chr9",136840393,136840633,136840513,240
"26576","chr9",134408989,134409349,134409169,360
"26577","chr9",38526669,38526957,38526813,288
"26578","chr1",1481905,1482373,1482139,468
"26579","chr9",136656802,136657107,136656954,305
"26580","chr21",32477692,32477918,32477805,226
"26581","chr9",134439470,134439800,134439635,330
"26582","chr12",53499411,53499826,53499618,415
"26583","chr14",19062273,19062717,19062495,444
"26584","chr8",94641670,94642505,94642087,835
"26585","chr9",65282881,65284356,65283618,1475
"26586","chr17",39209733,39210286,39210009,553
"26587","chr20",30316173,30317179,30316676,1006
"26588","chr14",105680240,105680466,105680353,226
"26589","chr21",45405360,45406319,45405839,959
"26590","chr9",136474033,136474298,136474165,265
"26591","chr10",42477304,42477505,42477404,201
"26592","chr18",3729123,3729406,3729264,283
"26593","chr9",65675696,65675985,65675840,289
"26594","chr18",79378797,79379201,79378999,404
"26595","chr14",104174921,104175425,104175173,504
"26596","chr8",143261617,143262144,143261880,527
"26597","chr8",144520399,144520645,144520522,246
"26598","chr22",20689372,20689658,20689515,286
"26599","chr19",453728,453971,453849,243
"26600","chr10",86535448,86535835,86535641,387
"26601","chr19",36850016,36850360,36850188,344
"26602","chr9",129803037,129803754,129803395,717
"26603","chr9",133915634,133915908,133915771,274
"26604","chr18",59358833,59359537,59359185,704
"26605","chr9",40222068,40223712,40222890,1644
"26606","chr9",66772601,66772824,66772712,223
"26607","chr9",133306026,133306242,133306134,216
"26608","chr9",136251662,136252583,136252122,921
"26609","chr9",5040734,5041922,5041328,1188
"26610","chr9",110048647,110048848,110048747,201
"26611","chr19",1508410,1508611,1508510,201
"26612","chr9",135782774,135783054,135782914,280
"26613","chr9",93317831,93318048,93317939,217
"26614","chr9",135088617,135089006,135088811,389
"26615","chr9",61658846,61659077,61658961,231
"26616","chr9",136502960,136503258,136503109,298
"26617","chr9",133561002,133561268,133561135,266
"26618","chr19",7888395,7888823,7888609,428
"26619","chr9",133335967,133336410,133336188,443
"26620","chr11",1232673,1233264,1232968,591
"26621","chr9",125889711,125890017,125889864,306
"26622","chr9",15232689,15232939,15232814,250
"26623","chr9",129665629,129666530,129666079,901
"26624","chr9",37753658,37753952,37753805,294
"26625","chr19",49362213,49362514,49362363,301
"26626","chr9",136952861,136953107,136952984,246
"26627","chr9",34379543,34380019,34379781,476
"26628","chr9",178851,179249,179050,398
"26629","chr9",41953120,41953431,41953275,311
"26630","chr9",136889870,136890241,136890055,371
"26631","chr9",135487991,135488221,135488106,230
"26632","chr9",97502572,97502935,97502753,363
"26633","chr9",131828321,131828523,131828422,202
"26634","chr9",95048490,95048990,95048740,500
"26635","chr9",136336819,136337071,136336945,252
"26636","chr9",126326367,126326701,126326534,334
"26637","chr19",17333156,17333824,17333490,668
"26638","chr9",131528930,131529173,131529051,243
"26639","chr17",18677346,18677752,18677549,406
"26640","chr9",132079573,132079948,132079760,375
"26641","chr9",136533866,136534075,136533970,209
"26642","chr9",135770751,135771163,135770957,412
"26643","chr1",144418771,144419244,144419007,473
"26644","chr10",45825928,45826142,45826035,214
"26645","chr9",129720119,129720359,129720239,240
"26646","chr9",97851656,97852340,97851998,684
"26647","chr9",136695985,136696309,136696147,324
"26648","chr8",12658920,12659515,12659217,595
"26649","chr9",137441306,137441869,137441587,563
"26650","chr8",142500137,142500411,142500274,274
"26651","chr15",45188503,45188724,45188613,221
"26652","chr4",84482677,84483371,84483024,694
"26653","chr9",128787015,128787267,128787141,252
"26654","chr9",137048647,137049263,137048955,616
"26655","chr9",123367051,123367323,123367187,272
"26656","chr9",137110715,137110921,137110818,206
"26657","chr9",29213525,29213819,29213672,294
"26658","chr9",136839238,136839504,136839371,266
"26659","chr9",95316907,95317112,95317009,205
"26660","chr9",93826316,93826651,93826483,335
"26661","chr19",5229498,5229829,5229663,331
"26662","chr4",190017475,190017693,190017584,218
"26663","chr9",113875958,113876694,113876326,736
"26664","chr9",137752182,137752397,137752289,215
"26665","chr9",134154286,134154533,134154409,247
"26666","chr9",98192468,98192883,98192675,415
"26667","chr9",127613073,127613515,127613294,442
"26668","chr19",58455564,58456422,58455993,858
"26669","chr9",75892435,75892736,75892585,301
"26670","chr9",130913285,130913527,130913406,242
"26671","chr19",40380834,40381174,40381004,340
"26672","chr9",95313136,95313459,95313297,323
"26673","chr9",91681599,91681966,91681782,367
"26674","chr9",127930560,127931052,127930806,492
"26675","chr19",5335033,5335250,5335141,217
"26676","chr19",1621667,1621902,1621784,235
"26677","chr17",81956630,81956947,81956788,317
"26678","chr9",41127139,41128362,41127750,1223
"26679","chr18",79830828,79831698,79831263,870
"26680","chr9",63815012,63815679,63815345,667
"26681","chr9",136352058,136352324,136352191,266
"26682","chr9",67597424,67597695,67597559,271
"26683","chr10",101569569,101569778,101569673,209
"26684","chr9",134054021,134054254,134054137,233
"26685","chr9",135780888,135781124,135781006,236
"26686","chr17",60025409,60027032,60026220,1623
"26687","chr11",89896690,89896934,89896812,244
"26688","chr9",127809688,127810085,127809886,397
"26689","chr9",6703948,6704662,6704305,714
"26690","chr9",100427494,100427738,100427616,244
"26691","chr2",94861335,94861639,94861487,304
"26692","chr19",56098434,56098878,56098656,444
"26693","chr9",40348549,40348806,40348677,257
"26694","chr9",135252103,135252366,135252234,263
"26695","chr9",135106649,135106854,135106751,205
"26696","chrX",120159119,120159485,120159302,366
"26697","chr9",96219010,96219893,96219451,883
"26698","chr9",137022726,137023040,137022883,314
"26699","chr9",8713281,8713891,8713586,610
"26700","chr9",109534158,109534467,109534312,309
"26701","chr9",14348685,14349075,14348880,390
"26702","chr1",1088695,1089234,1088964,539
"26703","chr9",97121215,97121481,97121348,266
"26704","chr9",113073301,113073647,113073474,346
"26705","chr1",11650402,11650731,11650566,329
"26706","chr9",100473078,100474345,100473711,1267
"26707","chr9",136345259,136345505,136345382,246
"26708","chr9",28849,29515,29182,666
"26709","chr9",132173652,132174380,132174016,728
"26710","chr9",27572968,27573482,27573225,514
"26711","chr9",68356633,68357688,68357160,1055
"26712","chr21",45981781,45982396,45982088,615
"26713","chr5",141371731,141372316,141372023,585
"26714","chr9",14993165,14993394,14993279,229
"26715","chr9",136434275,136434496,136434385,221
"26716","chr5",1465959,1466342,1466150,383
"26717","chr9",37650699,37651412,37651055,713
"26718","chr9",137163596,137163980,137163788,384
"26719","chr9",826582,826800,826691,218
"26720","chrX",153774771,153774995,153774883,224
"26721","chr9",33019923,33020148,33020035,225
"26722","chr9",127789330,127789552,127789441,222
"26723","chr19",1472936,1473211,1473073,275
"26724","chr22",18715031,18715478,18715254,447
"26725","chr9",127825253,127825810,127825531,557
"26726","chr19",39826716,39826973,39826844,257
"26727","chr19",17943290,17943924,17943607,634
"26728","chr9",136511214,136511420,136511317,206
"26729","chr19",49701325,49701746,49701535,421
"26730","chr19",39905828,39906078,39905953,250
"26731","chr1",148061373,148061586,148061479,213
"26732","chr19",5076020,5076894,5076457,874
"26733","chr19",12832532,12832847,12832689,315
"26734","chr9",23850912,23851524,23851218,612
"26735","chr19",1503038,1503371,1503204,333
"26736","chr9",91714406,91714740,91714573,334
"26737","chr4",914949,915252,915100,303
"26738","chr9",129460433,129460709,129460571,276
"26739","chr9",136658495,136658817,136658656,322
"26740","chr9",113062404,113062753,113062578,349
"26741","chr2",110610236,110611000,110610618,764
"26742","chr9",74497796,74498667,74498231,871
"26743","chr10",79838795,79839115,79838955,320
"26744","chr8",144274797,144275054,144274925,257
"26745","chr1",145488246,145488459,145488352,213
"26746","chrY",10092514,10092782,10092648,268
"26747","chr9",65762371,65763627,65762999,1256
"26748","chr9",136509617,136509974,136509795,357
"26749","chr14",100826526,100826764,100826645,238
"26750","chr9",42743589,42743964,42743776,375
"26751","chr15",82445140,82446114,82445627,974
"26752","chr9",137009983,137010359,137010171,376
"26753","chr19",1625318,1625613,1625465,295
"26754","chr19",429995,430323,430159,328
"26755","chr9",113111114,113111653,113111383,539
"26756","chr4",1804761,1804969,1804865,208
"26757","chr10",133030938,133031430,133031184,492
"26758","chr2",130251996,130252612,130252304,616
"26759","chr9",63781742,63782092,63781917,350
"26760","chr9",137394201,137394580,137394390,379
"26761","chr9",113078745,113079094,113078919,349
"26762","chr9",67234114,67234373,67234243,259
"26763","chr9",41679431,41680457,41679944,1026
"26764","chr9",135487466,135487750,135487608,284
"26765","chr14",105466456,105466827,105466641,371
"26766","chr9",126222584,126223002,126222793,418
"26767","chr9",39288080,39288597,39288338,517
"26768","chr9",21031439,21031824,21031631,385
"26769","chr12",54370281,54370726,54370503,445
"26770","chr9",137262955,137263213,137263084,258
"26771","chr19",36791653,36791886,36791769,233
"26772","chr9",137381903,137382190,137382046,287
"26773","chr15",30103418,30104375,30103896,957
"26774","chr17",81433725,81434017,81433871,292
"26775","chr17",4595126,4595364,4595245,238
"26776","chr8",785901,786172,786036,271
"26777","chr19",2477136,2477379,2477257,243
"26778","chr19",55162092,55162295,55162193,203
"26779","chr7",60991773,60992708,60992240,935
"26780","chr19",12778269,12778529,12778399,260
"26781","chr19",3094644,3095057,3094850,413
"26782","chr18",13498762,13499721,13499241,959
"26783","chr18",79704324,79704945,79704634,621
"26784","chr19",56217219,56218006,56217612,787
"26785","chr22",43834261,43835179,43834720,918
"26786","chr19",4531609,4531837,4531723,228
"26787","chr19",3821061,3821448,3821254,387
"26788","chr19",311948,312224,312086,276
"26789","chr19",37303368,37303672,37303520,304
"26790","chr11",1230916,1231148,1231032,232
"26791","chr7",72969156,72970115,72969635,959
"26792","chr20",62553230,62553439,62553334,209
"26793","chr15",20506111,20506570,20506340,459
"26794","chr1",244918661,244919029,244918845,368
"26795","chr12",124518334,124518555,124518444,221
"26796","chr9",137220348,137220938,137220643,590
"26797","chr1",143905322,143905942,143905632,620
"26798","chr8",85654355,85656182,85655268,1827
"26799","chr19",1256999,1257349,1257174,350
"26800","chr4",8747478,8747870,8747674,392
"26801","chr18",79915198,79915485,79915341,287
"26802","chr19",45038944,45039453,45039198,509
"26803","chr21",45991202,45991508,45991355,306
"26804","chr22",49449876,49450106,49449991,230
"26805","chr9",93335337,93335572,93335454,235
"26806","chr3",62371098,62371640,62371369,542
"26807","chr19",2643289,2643635,2643462,346
"26808","chr19",3937325,3937969,3937647,644
"26809","chrY",21917953,21918251,21918102,298
"26810","chr19",1987373,1987688,1987530,315
"26811","chrY",21894412,21894710,21894561,298
"26812","chr18",15165110,15165343,15165226,233
"26813","chr11",49850514,49850888,49850701,374
"26814","chr16",22536096,22536341,22536218,245
"26815","chr22",49051617,49051852,49051734,235
"26816","chr9",21402502,21403059,21402780,557
"26817","chr7",56948594,56949330,56948962,736
"26818","chr16",30205417,30206530,30205973,1113
"26819","chr19",40627124,40627325,40627224,201
"26820","chr19",56642829,56643647,56643238,818
"26821","chrY",9466865,9467463,9467164,598
"26822","chr19",70343,71344,70843,1001
"26823","chr18",79549695,79552226,79550960,2531
"26824","chr7",903928,904255,904091,327
"26825","chr19",588250,588622,588436,372
"26826","chr18",76357313,76357551,76357432,238
"26827","chr19",2354291,2354562,2354426,271
"26828","chr19",45677962,45678197,45678079,235
"26829","chr22",21267887,21268214,21268050,327
"26830","chr11",31826037,31826411,31826224,374
"26831","chr1",368792,370063,369427,1271
"26832","chr15",48810534,48810741,48810637,207
"26833","chr15",52787023,52787382,52787202,359
"26834","chr1",25266786,25267187,25266986,401
"26835","chr22",21416607,21418153,21417380,1546
"26836","chr14",34546913,34547127,34547020,214
"26837","chrY",17579334,17579882,17579608,548
"26838","chr14",105566961,105567183,105567072,222
"26839","chr3",195624498,195625090,195624794,592
"26840","chr10",46635600,46635847,46635723,247
"26841","chr7",144294061,144294366,144294213,305
"26842","chr9",138150056,138150661,138150358,605
"26843","chr7",39793895,39794126,39794010,231
"26844","chr15",72636792,72637237,72637014,445
"26845","chr11",65642165,65642656,65642410,491
"26846","chr9",113086960,113088367,113087663,1407
"26847","chrY",9357597,9357913,9357755,316
"26848","chr16",21834761,21835006,21834883,245
"26849","chr15",23225731,23226496,23226113,765
"26850","chr19",49601559,49601893,49601726,334
"26851","chr19",3751111,3751570,3751340,459
"26852","chr1",149747764,149748090,149747927,326
"26853","chr19",866536,867056,866796,520
"26854","chr8",85661192,85663019,85662105,1827
"26855","chr15",43693647,43694259,43693953,612
"26856","chr2",86942050,86943180,86942615,1130
"26857","chr18",79736283,79736512,79736397,229
"26858","chr15",96352077,96352500,96352288,423
"26859","chr2",95682663,95683044,95682853,381
"26860","chr19",1325866,1326216,1326041,350
"26861","chr7",155462403,155462616,155462509,213
"26862","chr1",120952492,120953081,120952786,589
"26863","chr2",109947515,109948383,109947949,868
"26864","chr1",50417325,50417754,50417539,429
"26865","chr7",51386576,51386807,51386691,231
"26866","chr1",597839,598734,598286,895
"26867","chr15",82298557,82298898,82298727,341
"26868","chr22",11973841,11974242,11974041,401
"26869","chr17",60138935,60139144,60139039,209
"26870","chr9",61874864,61875105,61874984,241
"26871","chr21",45277057,45277299,45277178,242
"26872","chr20",63557787,63557991,63557889,204
"26873","chr15",82513080,82514094,82513587,1014
"26874","chr2",241814496,241815166,241814831,670
"26875","chr22",23960931,23961657,23961294,726
"26876","chr19",50205344,50205598,50205471,254
"26877","chr15",28454704,28455464,28455084,760
"26878","chr7",6421314,6421833,6421573,519
"26879","chr17",44179675,44180034,44179854,359
"26880","chr2",176085265,176085608,176085436,343
"26881","chr1",1521449,1521694,1521571,245
"26882","chr19",870774,871318,871046,544
"26883","chr4",131740689,131741012,131740850,323
"26884","chr21",45419177,45419427,45419302,250
"26885","chr10",133165391,133165622,133165506,231
"26886","chr17",42050378,42050886,42050632,508
"26887","chr1",152214974,152215187,152215080,213
"26888","chr5",159105286,159105494,159105390,208
"26889","chr19",1112201,1112996,1112598,795
"26890","chr19",12647459,12647940,12647699,481
"26891","chr3",198103536,198103864,198103700,328
"26892","chr19",39889576,39889826,39889701,250
"26893","chr22",21383686,21385830,21384758,2144
"26894","chr17",78995007,78995388,78995197,381
"26895","chr2",95789425,95790097,95789761,672
"26896","chr19",55503444,55503966,55503705,522
"26897","chr10",44293363,44293672,44293517,309
"26898","chr8",1401973,1402411,1402192,438
"26899","chr1",1336045,1336694,1336369,649
"26900","chr19",39891641,39892181,39891911,540
"26901","chr17",43300232,43300762,43300497,530
"26902","chr19",53873918,53874187,53874052,269
"26903","chr1",145232834,145233040,145232937,206
"26904","chr1",50416761,50416988,50416874,227
"26905","chr5",42995020,42995313,42995166,293
"26906","chr19",2038293,2038692,2038492,399
"26907","chr15",21352184,21353428,21352806,1244
"26908","chr5",171314599,171315747,171315173,1148
"26909","chr4",131730656,131730959,131730807,303
"26910","chr19",55359024,55359233,55359128,209
"26911","chr15",32434220,32435177,32434698,957
"26912","chr2",130597415,130598062,130597738,647
"26913","chr14",18626791,18627066,18626928,275
"26914","chr17",36391737,36391964,36391850,227
"26915","chr18",46969001,46969905,46969453,904
"26916","chr21",44202335,44202617,44202476,282
"26917","chr4",140151950,140152167,140152058,217
"26918","chr7",128107908,128108195,128108051,287
"26919","chr19",1495210,1495414,1495312,204
"26920","chr15",20074171,20074472,20074321,301
"26921","chr2",95427263,95427499,95427381,236
"26922","chr19",48625966,48626306,48626136,340
"26923","chrX",49156318,49156640,49156479,322
"26924","chr14",34556397,34556741,34556569,344
"26925","chr7",63752977,63753349,63753163,372
"26926","chr19",585259,585502,585380,243
"26927","chr19",58042986,58043219,58043102,233
"26928","chr19",52922825,52923136,52922980,311
"26929","chr14",105559823,105560049,105559936,226
"26930","chr10",133664428,133685058,133674743,20630
"26931","chr19",55605348,55605816,55605582,468
"26932","chrX",3919475,3921022,3920248,1547
"26933","chr19",1154024,1154487,1154255,463
"26934","chr19",17942607,17942861,17942734,254
"26935","chr18",76401540,76401861,76401700,321
"26936","chr17",19162967,19163336,19163151,369
"26937","chr18",79825913,79826856,79826384,943
"26938","chr22",50316913,50317123,50317018,210
"26939","chr2",96034483,96035155,96034819,672
"26940","chr22",15603063,15603457,15603260,394
"26941","chr9",39132862,39133148,39133005,286
"26942","chr4",131728155,131728492,131728323,337
"26943","chr1",1635670,1636108,1635889,438
"26944","chr22",21128008,21128294,21128151,286
"26945","chr9",137842499,137842711,137842605,212
"26946","chr18",48911,49655,49283,744
"26947","chr22",49983231,49984062,49983646,831
"26948","chr1",120068734,120069889,120069311,1155
"26949","chr21",44107075,44107932,44107503,857
"26950","chr9",138174943,138175739,138175341,796
"26951","chr7",5303934,5304151,5304042,217
"26952","chr19",38336179,38336488,38336333,309
"26953","chr19",47228120,47228458,47228289,338
"26954","chr21",13762231,13763016,13762623,785
"26955","chr5",486755,487015,486885,260
"26956","chr17",81824277,81824537,81824407,260
"26957","chr2",95435372,95435642,95435507,270
"26958","chr1",228269760,228270019,228269889,259
"26959","chr2",91723013,91723345,91723179,332
"26960","chr21",43172609,43173533,43173071,924
"26961","chrY",22403251,22403548,22403399,297
"26962","chr7",63627622,63628360,63627991,738
"26963","chr19",45443484,45443695,45443589,211
"26964","chr19",37293251,37293672,37293461,421
"26965","chr19",41997109,41997334,41997221,225
"26966","chr4",190040956,190041534,190041245,578
"26967","chr19",38912048,38912357,38912202,309
"26968","chr7",63754752,63755341,63755046,589
"26969","chr2",130036887,130037242,130037064,355
"26970","chr21",41815669,41816154,41815911,485
"26971","chr19",40603707,40604169,40603938,462
"26972","chrX",153272893,153273707,153273300,814
"26973","chr19",5210553,5210853,5210703,300
"26974","chr17",19110831,19111291,19111061,460
"26975","chr19",2352226,2352431,2352328,205
"26976","chr19",5043106,5043468,5043287,362
"26977","chr21",44371263,44371487,44371375,224
"26978","chr4",8630699,8630968,8630833,269
"26979","chr4",131745653,131745976,131745814,323
"26980","chr19",2436492,2436796,2436644,304
"26981","chr15",82326994,82327293,82327143,299
"26982","chr9",113070626,113072035,113071330,1409
"26983","chr19",53196857,53197182,53197019,325
"26984","chr7",150952441,150952871,150952656,430
"26985","chr15",84229266,84230280,84229773,1014
"26986","chr19",1860090,1860311,1860200,221
"26987","chr5",72996629,72997002,72996815,373
"26988","chr21",44140780,44141117,44140948,337
"26989","chr22",48641547,48641749,48641648,202
"26990","chr8",1397411,1397621,1397516,210
"26991","chr19",2351520,2352029,2351774,509
"26992","chr13",113544003,113544237,113544120,234
"26993","chrX",154345033,154345255,154345144,222
"26994","chr9",113076072,113077479,113076775,1407
"26995","chr19",18155872,18156079,18155975,207
"26996","chr7",102348344,102348601,102348472,257
"26997","chr15",43689726,43690160,43689943,434
"26998","chr19",18051840,18052206,18052023,366
"26999","chr22",23966574,23967512,23967043,938
"27000","chr18",79483364,79483636,79483500,272
"27001","chrY",11314955,11316057,11315506,1102
"27002","chr7",65123052,65123270,65123161,218
"27003","chrX",153077358,153078282,153077820,924
"27004","chr7",65554303,65555279,65554791,976
"27005","chr7",72975941,72976275,72976108,334
"27006","chr8",144270938,144271562,144271250,624
"27007","chr7",56816143,56816552,56816347,409
"27008","chr5",1272553,1272875,1272714,322
"27009","chr6",3145216,3145450,3145333,234
"27010","chr9",65258327,65259136,65258731,809
"27011","chr2",92042322,92043757,92043039,1435
"27012","chr7",5960672,5960877,5960774,205
"27013","chr19",38211243,38211621,38211432,378
"27014","chr17",61408212,61408419,61408315,207
"27015","chr16",14910949,14912243,14911596,1294
"27016","chr9",136517715,136517953,136517834,238
"27017","chr17",83103391,83103975,83103683,584
"27018","chr9",41655110,41655392,41655251,282
"27019","chr1",16748909,16749185,16749047,276
"27020","chr7",75388817,75389151,75388984,334
"27021","chrY",9337264,9337580,9337422,316
"27022","chrY",11429497,11430432,11429964,935
"27023","chr19",55347109,55347460,55347284,351
"27024","chr15",28402863,28403364,28403113,501
"27025","chr16",8589109,8590066,8589587,957
"27026","chr1",145424963,145425970,145425466,1007
"27027","chr9",68302972,68304195,68303583,1223
"27028","chr9",108900770,108900976,108900873,206
